,Year,Period,labor force,employment,unemployment,unemployment rate,County
0,2013,Jan,28744,24807,3937,13.7,"San Benito County, CA"
1,2013,Feb,28925,25117,3808,13.2,"San Benito County, CA"
2,2013,Mar,28873,25204,3669,12.7,"San Benito County, CA"
3,2013,Apr,28738,25386,3352,11.7,"San Benito County, CA"
4,2013,May,28604,25379,3225,11.3,"San Benito County, CA"
5,2013,Jun,28697,25444,3253,11.3,"San Benito County, CA"
6,2013,Jul,29281,26090,3191,10.9,"San Benito County, CA"
7,2013,Aug,29072,26099,2973,10.2,"San Benito County, CA"
8,2013,Sep,28986,26198,2788,9.6,"San Benito County, CA"
9,2013,Oct,28819,26035,2784,9.7,"San Benito County, CA"
10,2013,Nov,28498,25603,2895,10.2,"San Benito County, CA"
11,2013,Dec,28494,25525,2969,10.4,"San Benito County, CA"
12,2014,Jan,28831,25528,3303,11.5,"San Benito County, CA"
13,2014,Feb,29002,25676,3326,11.5,"San Benito County, CA"
14,2014,Mar,29268,25921,3347,11.4,"San Benito County, CA"
15,2014,Apr,29183,26288,2895,9.9,"San Benito County, CA"
16,2014,May,29162,26409,2753,9.4,"San Benito County, CA"
17,2014,Jun,29113,26440,2673,9.2,"San Benito County, CA"
18,2014,Jul,29290,26596,2694,9.2,"San Benito County, CA"
19,2014,Aug,29110,26616,2494,8.6,"San Benito County, CA"
20,2014,Sep,29050,26799,2251,7.7,"San Benito County, CA"
21,2014,Oct,29291,26986,2305,7.9,"San Benito County, CA"
22,2014,Nov,29113,26668,2445,8.4,"San Benito County, CA"
23,2014,Dec,29035,26538,2497,8.6,"San Benito County, CA"
24,2015,Jan,29582,26822,2760,9.3,"San Benito County, CA"
25,2015,Feb,29714,27009,2705,9.1,"San Benito County, CA"
26,2015,Mar,29787,27113,2674,9.0,"San Benito County, CA"
27,2015,Apr,29704,27271,2433,8.2,"San Benito County, CA"
28,2015,May,29844,27507,2337,7.8,"San Benito County, CA"
29,2015,Jun,29897,27650,2247,7.5,"San Benito County, CA"
30,2015,Jul,29937,27809,2128,7.1,"San Benito County, CA"
31,2015,Aug,29803,27843,1960,6.6,"San Benito County, CA"
32,2015,Sep,29646,27842,1804,6.1,"San Benito County, CA"
33,2015,Oct,29833,27936,1897,6.4,"San Benito County, CA"
34,2015,Nov,29680,27622,2058,6.9,"San Benito County, CA"
35,2015,Dec,29681,27521,2160,7.3,"San Benito County, CA"
36,2016,Jan,30254,27818,2436,8.1,"San Benito County, CA"
37,2016,Feb,30450,28045,2405,7.9,"San Benito County, CA"
38,2016,Mar,30656,28179,2477,8.1,"San Benito County, CA"
39,2016,Apr,30391,28248,2143,7.1,"San Benito County, CA"
40,2016,May,30401,28483,1918,6.3,"San Benito County, CA"
41,2016,Jun,30664,28655,2009,6.6,"San Benito County, CA"
42,2016,Jul,30634,28701,1933,6.3,"San Benito County, CA"
43,2016,Aug,30489,28627,1862,6.1,"San Benito County, CA"
44,2016,Sep,30404,28643,1761,5.8,"San Benito County, CA"
45,2016,Oct,30466,28722,1744,5.7,"San Benito County, CA"
46,2016,Nov,30301,28516,1785,5.9,"San Benito County, CA"
47,2016,Dec,30091,28133,1958,6.5,"San Benito County, CA"
48,2017,Jan,30100,27877,2223,7.4,"San Benito County, CA"
49,2017,Feb,30391,28118,2273,7.5,"San Benito County, CA"
50,2017,Mar,30538,28341,2197,7.2,"San Benito County, CA"
51,2017,Apr,30556,28680,1876,6.1,"San Benito County, CA"
52,2017,May,30593,28899,1694,5.5,"San Benito County, CA"
53,2017,Jun,30811,29070,1741,5.7,"San Benito County, CA"
54,2017,Jul,31163,29447,1716,5.5,"San Benito County, CA"
55,2017,Aug,30835,29222,1613,5.2,"San Benito County, CA"
56,2017,Sep,30655,29254,1401,4.6,"San Benito County, CA"
57,2017,Oct,30583,29171,1412,4.6,"San Benito County, CA"
58,2017,Nov,30500,29003,1497,4.9,"San Benito County, CA"
59,2017,Dec,30321,28645,1676,5.5,"San Benito County, CA"
60,2018,Jan,30761,28899,1862,6.1,"San Benito County, CA"
61,2018,Feb,31289,29339,1950,6.2,"San Benito County, CA"
62,2018,Mar,31272,29352,1920,6.1,"San Benito County, CA"
63,2018,Apr,31090,29457,1633,5.3,"San Benito County, CA"
64,2018,May,31137,29681,1456,4.7,"San Benito County, CA"
65,2018,Jun,31340,29743,1597,5.1,"San Benito County, CA"
66,2018,Jul,31617,30090,1527,4.8,"San Benito County, CA"
67,2018,Aug,31088,29689,1399,4.5,"San Benito County, CA"
68,2018,Sep,31081,29811,1270,4.1,"San Benito County, CA"
69,2018,Oct,31293,29980,1313,4.2,"San Benito County, CA"
70,2018,Nov,31243,29840,1403,4.5,"San Benito County, CA"
71,2018,Dec,31187,29508,1679,5.4,"San Benito County, CA"
72,2019,Jan,32254,30167,2087,6.5,"San Benito County, CA"
73,2019,Feb,32533,30471,2062,6.3,"San Benito County, CA"
74,2019,Mar,32535,30483,2052,6.3,"San Benito County, CA"
75,2019,Apr,32049,30432,1617,5.0,"San Benito County, CA"
76,2019,May,31957,30545,1412,4.4,"San Benito County, CA"
77,2019,Jun,32056,30539,1517,4.7,"San Benito County, CA"
78,2019,Jul,32597,31030,1567,4.8,"San Benito County, CA"
79,2019,Aug,32275,30865,1410,4.4,"San Benito County, CA"
80,2019,Sep,32174,30944,1230,3.8,"San Benito County, CA"
81,2019,Oct,32543,31186,1357,4.2,"San Benito County, CA"
82,2019,Nov,32530,31094,1436,4.4,"San Benito County, CA"
83,2019,Dec,32390,30777,1613,5.0,"San Benito County, CA"
84,2020,Jan,33393,31384,2009,6.0,"San Benito County, CA"
85,2020,Feb,33743,31786,1957,5.8,"San Benito County, CA"
86,2020,Mar,33723,30875,2848,8.4,"San Benito County, CA"
87,2020,Apr,33742,27455,6287,18.6,"San Benito County, CA"
88,2020,May,32199,27395,4804,14.9,"San Benito County, CA"
89,2020,Jun,32589,28580,4009,12.3,"San Benito County, CA"
90,2020,Jul,32569,28971,3598,11.0,"San Benito County, CA"
91,2020,Aug,32095,29225,2870,8.9,"San Benito County, CA"
92,2020,Sep,31883,29160,2723,8.5,"San Benito County, CA"
93,2020,Oct,31997,29552,2445,7.6,"San Benito County, CA"
94,2020,Nov,31743,29238,2505,7.9,"San Benito County, CA"
95,2020,Dec,31667,28963,2704,8.5,"San Benito County, CA"
96,2021,Jan,31713,28752,2961,9.3,"San Benito County, CA"
97,2021,Feb,31956,29012,2944,9.2,"San Benito County, CA"
98,2021,Mar,31917,29094,2823,8.8,"San Benito County, CA"
99,2021,Apr,31604,29007,2597,8.2,"San Benito County, CA"
100,2021,May,31603,29245,2358,7.5,"San Benito County, CA"
101,2021,Jun,31785,29268,2517,7.9,"San Benito County, CA"
102,2021,Jul,32032,29729,2303,7.2,"San Benito County, CA"
103,2021,Aug,31828,29685,2143,6.7,"San Benito County, CA"
104,2021,Sep,31776,29943,1833,5.8,"San Benito County, CA"
105,2021,Oct,31862,30035,1827,5.7,"San Benito County, CA"
106,2021,Nov,31973,30214,1759,5.5,"San Benito County, CA"
107,2021,Dec,31921,30090,1831,5.7,"San Benito County, CA"
108,2022,Jan,32189,29991,2198,6.8,"San Benito County, CA"
109,2022,Feb,32389,30294,2095,6.5,"San Benito County, CA"
110,2022,Mar,32507,30624,1883,5.8,"San Benito County, CA"
111,2022,Apr,32085,30456,1629,5.1,"San Benito County, CA"
112,2022,May,32188,30752,1436,4.5,"San Benito County, CA"
113,2022,Jun,32215,30750,1465,4.5,"San Benito County, CA"
114,2022,Jul,32545,31103,1442,4.4,"San Benito County, CA"
115,2022,Aug,32526,31102,1424,4.4,"San Benito County, CA"
116,2022,Sep,32530,31244,1286,4.0,"San Benito County, CA"
117,2022,Oct,32875,31443,1432,4.4,"San Benito County, CA"
118,2022,Nov,32833,31263,1570,4.8,"San Benito County, CA"
119,2022,Dec,32882,31251,1631,5.0,"San Benito County, CA"
120,2023,Jan,32593,30559,2034,6.2,"San Benito County, CA"
121,2023,Feb,33075,30895,2180,6.6,"San Benito County, CA"
122,2023,Mar,33359,31087,2272,6.8,"San Benito County, CA"
123,2023,Apr,32740,30834,1906,5.8,"San Benito County, CA"
124,2023,May,32552,30632,1920,5.9,"San Benito County, CA"
125,2023,Jun,32449,30548,1901,5.9,"San Benito County, CA"
126,2023,Jul,32738,30970,1768,5.4,"San Benito County, CA"
127,2023,Aug,32635,30809,1826,5.6,"San Benito County, CA"
128,2023,Sep,32637,30953,1684,5.2,"San Benito County, CA"
129,2023,Oct,32783,31020,1763,5.4,"San Benito County, CA"
0,2013,Jan,14010,13010,1000,7.1,"Wakulla County, FL"
1,2013,Feb,14038,13122,916,6.5,"Wakulla County, FL"
2,2013,Mar,14026,13157,869,6.2,"Wakulla County, FL"
3,2013,Apr,14077,13235,842,6.0,"Wakulla County, FL"
4,2013,May,13864,12999,865,6.2,"Wakulla County, FL"
5,2013,Jun,13898,12982,916,6.6,"Wakulla County, FL"
6,2013,Jul,13964,13050,914,6.5,"Wakulla County, FL"
7,2013,Aug,13925,13050,875,6.3,"Wakulla County, FL"
8,2013,Sep,14256,13409,847,5.9,"Wakulla County, FL"
9,2013,Oct,14233,13395,838,5.9,"Wakulla County, FL"
10,2013,Nov,14138,13309,829,5.9,"Wakulla County, FL"
11,2013,Dec,13992,13197,795,5.7,"Wakulla County, FL"
12,2014,Jan,14140,13298,842,6.0,"Wakulla County, FL"
13,2014,Feb,14355,13532,823,5.7,"Wakulla County, FL"
14,2014,Mar,14342,13548,794,5.5,"Wakulla County, FL"
15,2014,Apr,14353,13641,712,5.0,"Wakulla County, FL"
16,2014,May,14199,13437,762,5.4,"Wakulla County, FL"
17,2014,Jun,14152,13384,768,5.4,"Wakulla County, FL"
18,2014,Jul,14197,13398,799,5.6,"Wakulla County, FL"
19,2014,Aug,14170,13381,789,5.6,"Wakulla County, FL"
20,2014,Sep,14530,13794,736,5.1,"Wakulla County, FL"
21,2014,Oct,14511,13790,721,5.0,"Wakulla County, FL"
22,2014,Nov,14294,13569,725,5.1,"Wakulla County, FL"
23,2014,Dec,14131,13462,669,4.7,"Wakulla County, FL"
24,2015,Jan,14045,13309,736,5.2,"Wakulla County, FL"
25,2015,Feb,14064,13398,666,4.7,"Wakulla County, FL"
26,2015,Mar,14018,13373,645,4.6,"Wakulla County, FL"
27,2015,Apr,14053,13428,625,4.4,"Wakulla County, FL"
28,2015,May,13902,13232,670,4.8,"Wakulla County, FL"
29,2015,Jun,13910,13219,691,5.0,"Wakulla County, FL"
30,2015,Jul,13912,13214,698,5.0,"Wakulla County, FL"
31,2015,Aug,13911,13250,661,4.8,"Wakulla County, FL"
32,2015,Sep,14206,13560,646,4.5,"Wakulla County, FL"
33,2015,Oct,14207,13566,641,4.5,"Wakulla County, FL"
34,2015,Nov,13997,13363,634,4.5,"Wakulla County, FL"
35,2015,Dec,13921,13319,602,4.3,"Wakulla County, FL"
36,2016,Jan,14038,13387,651,4.6,"Wakulla County, FL"
37,2016,Feb,14227,13634,593,4.2,"Wakulla County, FL"
38,2016,Mar,14193,13623,570,4.0,"Wakulla County, FL"
39,2016,Apr,14315,13756,559,3.9,"Wakulla County, FL"
40,2016,May,14214,13662,552,3.9,"Wakulla County, FL"
41,2016,Jun,14239,13598,641,4.5,"Wakulla County, FL"
42,2016,Jul,14341,13699,642,4.5,"Wakulla County, FL"
43,2016,Aug,14330,13710,620,4.3,"Wakulla County, FL"
44,2016,Sep,14716,14105,611,4.2,"Wakulla County, FL"
45,2016,Oct,14686,14084,602,4.1,"Wakulla County, FL"
46,2016,Nov,14492,13911,581,4.0,"Wakulla County, FL"
47,2016,Dec,14312,13751,561,3.9,"Wakulla County, FL"
48,2017,Jan,14152,13552,600,4.2,"Wakulla County, FL"
49,2017,Feb,14340,13793,547,3.8,"Wakulla County, FL"
50,2017,Mar,14297,13786,511,3.6,"Wakulla County, FL"
51,2017,Apr,14462,13978,484,3.3,"Wakulla County, FL"
52,2017,May,14371,13876,495,3.4,"Wakulla County, FL"
53,2017,Jun,14271,13712,559,3.9,"Wakulla County, FL"
54,2017,Jul,14343,13774,569,4.0,"Wakulla County, FL"
55,2017,Aug,14148,13593,555,3.9,"Wakulla County, FL"
56,2017,Sep,14655,14151,504,3.4,"Wakulla County, FL"
57,2017,Oct,14597,14105,492,3.4,"Wakulla County, FL"
58,2017,Nov,14493,13981,512,3.5,"Wakulla County, FL"
59,2017,Dec,14344,13874,470,3.3,"Wakulla County, FL"
60,2018,Jan,14470,13932,538,3.7,"Wakulla County, FL"
61,2018,Feb,14631,14130,501,3.4,"Wakulla County, FL"
62,2018,Mar,14562,14080,482,3.3,"Wakulla County, FL"
63,2018,Apr,14680,14245,435,3.0,"Wakulla County, FL"
64,2018,May,14606,14173,433,3.0,"Wakulla County, FL"
65,2018,Jun,14546,14017,529,3.6,"Wakulla County, FL"
66,2018,Jul,14604,14104,500,3.4,"Wakulla County, FL"
67,2018,Aug,14442,13971,471,3.3,"Wakulla County, FL"
68,2018,Sep,14865,14432,433,2.9,"Wakulla County, FL"
69,2018,Oct,14840,14400,440,3.0,"Wakulla County, FL"
70,2018,Nov,14811,14364,447,3.0,"Wakulla County, FL"
71,2018,Dec,14682,14238,444,3.0,"Wakulla County, FL"
72,2019,Jan,15206,14667,539,3.5,"Wakulla County, FL"
73,2019,Feb,15235,14784,451,3.0,"Wakulla County, FL"
74,2019,Mar,15230,14781,449,2.9,"Wakulla County, FL"
75,2019,Apr,15297,14890,407,2.7,"Wakulla County, FL"
76,2019,May,15173,14742,431,2.8,"Wakulla County, FL"
77,2019,Jun,15116,14627,489,3.2,"Wakulla County, FL"
78,2019,Jul,15240,14728,512,3.4,"Wakulla County, FL"
79,2019,Aug,15169,14688,481,3.2,"Wakulla County, FL"
80,2019,Sep,15591,15155,436,2.8,"Wakulla County, FL"
81,2019,Oct,15606,15160,446,2.9,"Wakulla County, FL"
82,2019,Nov,15478,15061,417,2.7,"Wakulla County, FL"
83,2019,Dec,15361,14969,392,2.6,"Wakulla County, FL"
84,2020,Jan,15574,15114,460,3.0,"Wakulla County, FL"
85,2020,Feb,15667,15276,391,2.5,"Wakulla County, FL"
86,2020,Mar,15287,14737,550,3.6,"Wakulla County, FL"
87,2020,Apr,13876,12958,918,6.6,"Wakulla County, FL"
88,2020,May,14497,13485,1012,7.0,"Wakulla County, FL"
89,2020,Jun,14562,13653,909,6.2,"Wakulla County, FL"
90,2020,Jul,14847,13829,1018,6.9,"Wakulla County, FL"
91,2020,Aug,14952,14219,733,4.9,"Wakulla County, FL"
92,2020,Sep,15253,14566,687,4.5,"Wakulla County, FL"
93,2020,Oct,15449,14855,594,3.8,"Wakulla County, FL"
94,2020,Nov,15292,14705,587,3.8,"Wakulla County, FL"
95,2020,Dec,15028,14454,574,3.8,"Wakulla County, FL"
96,2021,Jan,15077,14494,583,3.9,"Wakulla County, FL"
97,2021,Feb,15168,14636,532,3.5,"Wakulla County, FL"
98,2021,Mar,15232,14723,509,3.3,"Wakulla County, FL"
99,2021,Apr,15345,14860,485,3.2,"Wakulla County, FL"
100,2021,May,15214,14743,471,3.1,"Wakulla County, FL"
101,2021,Jun,15325,14737,588,3.8,"Wakulla County, FL"
102,2021,Jul,15369,14800,569,3.7,"Wakulla County, FL"
103,2021,Aug,15342,14807,535,3.5,"Wakulla County, FL"
104,2021,Sep,15793,15324,469,3.0,"Wakulla County, FL"
105,2021,Oct,15819,15367,452,2.9,"Wakulla County, FL"
106,2021,Nov,15798,15363,435,2.8,"Wakulla County, FL"
107,2021,Dec,15632,15245,387,2.5,"Wakulla County, FL"
108,2022,Jan,15727,15235,492,3.1,"Wakulla County, FL"
109,2022,Feb,15795,15353,442,2.8,"Wakulla County, FL"
110,2022,Mar,15808,15418,390,2.5,"Wakulla County, FL"
111,2022,Apr,15960,15583,377,2.4,"Wakulla County, FL"
112,2022,May,15849,15471,378,2.4,"Wakulla County, FL"
113,2022,Jun,15913,15472,441,2.8,"Wakulla County, FL"
114,2022,Jul,15956,15529,427,2.7,"Wakulla County, FL"
115,2022,Aug,15909,15500,409,2.6,"Wakulla County, FL"
116,2022,Sep,16371,15975,396,2.4,"Wakulla County, FL"
117,2022,Oct,16347,15958,389,2.4,"Wakulla County, FL"
118,2022,Nov,16189,15819,370,2.3,"Wakulla County, FL"
119,2022,Dec,16071,15754,317,2.0,"Wakulla County, FL"
120,2023,Jan,16115,15738,377,2.3,"Wakulla County, FL"
121,2023,Feb,16277,15897,380,2.3,"Wakulla County, FL"
122,2023,Mar,16319,15938,381,2.3,"Wakulla County, FL"
123,2023,Apr,16329,15985,344,2.1,"Wakulla County, FL"
124,2023,May,16269,15876,393,2.4,"Wakulla County, FL"
125,2023,Jun,16466,15996,470,2.9,"Wakulla County, FL"
126,2023,Jul,16567,16099,468,2.8,"Wakulla County, FL"
127,2023,Aug,16674,16191,483,2.9,"Wakulla County, FL"
128,2023,Sep,17002,16532,470,2.8,"Wakulla County, FL"
129,2023,Oct,16964,16478,486,2.9,"Wakulla County, FL"
0,2013,Jan,136999,128787,8212,6.0,"Marin County, CA"
1,2013,Feb,136911,129199,7712,5.6,"Marin County, CA"
2,2013,Mar,136656,129229,7427,5.4,"Marin County, CA"
3,2013,Apr,137265,130482,6783,4.9,"Marin County, CA"
4,2013,May,138145,131309,6836,4.9,"Marin County, CA"
5,2013,Jun,139084,131347,7737,5.6,"Marin County, CA"
6,2013,Jul,140297,132525,7772,5.5,"Marin County, CA"
7,2013,Aug,139053,131714,7339,5.3,"Marin County, CA"
8,2013,Sep,137461,130488,6973,5.1,"Marin County, CA"
9,2013,Oct,136695,129701,6994,5.1,"Marin County, CA"
10,2013,Nov,137781,131139,6642,4.8,"Marin County, CA"
11,2013,Dec,137335,131180,6155,4.5,"Marin County, CA"
12,2014,Jan,136779,130216,6563,4.8,"Marin County, CA"
13,2014,Feb,137958,131282,6676,4.8,"Marin County, CA"
14,2014,Mar,138307,131708,6599,4.8,"Marin County, CA"
15,2014,Apr,136951,131470,5481,4.0,"Marin County, CA"
16,2014,May,137971,132339,5632,4.1,"Marin County, CA"
17,2014,Jun,138433,132387,6046,4.4,"Marin County, CA"
18,2014,Jul,140834,134261,6573,4.7,"Marin County, CA"
19,2014,Aug,139569,133267,6302,4.5,"Marin County, CA"
20,2014,Sep,138757,133069,5688,4.1,"Marin County, CA"
21,2014,Oct,139262,133610,5652,4.1,"Marin County, CA"
22,2014,Nov,138964,133376,5588,4.0,"Marin County, CA"
23,2014,Dec,137710,132737,4973,3.6,"Marin County, CA"
24,2015,Jan,137790,132207,5583,4.1,"Marin County, CA"
25,2015,Feb,137716,132460,5256,3.8,"Marin County, CA"
26,2015,Mar,138372,133215,5157,3.7,"Marin County, CA"
27,2015,Apr,138084,133306,4778,3.5,"Marin County, CA"
28,2015,May,139087,134337,4750,3.4,"Marin County, CA"
29,2015,Jun,139009,133911,5098,3.7,"Marin County, CA"
30,2015,Jul,140157,134751,5406,3.9,"Marin County, CA"
31,2015,Aug,139818,134749,5069,3.6,"Marin County, CA"
32,2015,Sep,138676,134034,4642,3.3,"Marin County, CA"
33,2015,Oct,139000,134243,4757,3.4,"Marin County, CA"
34,2015,Nov,138384,133776,4608,3.3,"Marin County, CA"
35,2015,Dec,138038,133629,4409,3.2,"Marin County, CA"
36,2016,Jan,138085,133415,4670,3.4,"Marin County, CA"
37,2016,Feb,139321,134659,4662,3.3,"Marin County, CA"
38,2016,Mar,139593,134838,4755,3.4,"Marin County, CA"
39,2016,Apr,138446,134031,4415,3.2,"Marin County, CA"
40,2016,May,139056,135061,3995,2.9,"Marin County, CA"
41,2016,Jun,139856,134986,4870,3.5,"Marin County, CA"
42,2016,Jul,141657,136641,5016,3.5,"Marin County, CA"
43,2016,Aug,140861,135961,4900,3.5,"Marin County, CA"
44,2016,Sep,140197,135564,4633,3.3,"Marin County, CA"
45,2016,Oct,140098,135427,4671,3.3,"Marin County, CA"
46,2016,Nov,139277,134940,4337,3.1,"Marin County, CA"
47,2016,Dec,139138,134956,4182,3.0,"Marin County, CA"
48,2017,Jan,138592,133881,4711,3.4,"Marin County, CA"
49,2017,Feb,139776,135306,4470,3.2,"Marin County, CA"
50,2017,Mar,139891,135676,4215,3.0,"Marin County, CA"
51,2017,Apr,138603,134725,3878,2.8,"Marin County, CA"
52,2017,May,139167,135428,3739,2.7,"Marin County, CA"
53,2017,Jun,140145,135819,4326,3.1,"Marin County, CA"
54,2017,Jul,141518,136961,4557,3.2,"Marin County, CA"
55,2017,Aug,140174,135737,4437,3.2,"Marin County, CA"
56,2017,Sep,140225,136429,3796,2.7,"Marin County, CA"
57,2017,Oct,139515,135860,3655,2.6,"Marin County, CA"
58,2017,Nov,139284,135819,3465,2.5,"Marin County, CA"
59,2017,Dec,138688,135364,3324,2.4,"Marin County, CA"
60,2018,Jan,138191,134464,3727,2.7,"Marin County, CA"
61,2018,Feb,139355,135774,3581,2.6,"Marin County, CA"
62,2018,Mar,139275,135877,3398,2.4,"Marin County, CA"
63,2018,Apr,138326,135192,3134,2.3,"Marin County, CA"
64,2018,May,139053,136187,2866,2.1,"Marin County, CA"
65,2018,Jun,139461,135779,3682,2.6,"Marin County, CA"
66,2018,Jul,141614,137974,3640,2.6,"Marin County, CA"
67,2018,Aug,139883,136278,3605,2.6,"Marin County, CA"
68,2018,Sep,140477,137194,3283,2.3,"Marin County, CA"
69,2018,Oct,140819,137404,3415,2.4,"Marin County, CA"
70,2018,Nov,140375,137090,3285,2.3,"Marin County, CA"
71,2018,Dec,139689,136436,3253,2.3,"Marin County, CA"
72,2019,Jan,138495,134573,3922,2.8,"Marin County, CA"
73,2019,Feb,139076,135623,3453,2.5,"Marin County, CA"
74,2019,Mar,139290,135772,3518,2.5,"Marin County, CA"
75,2019,Apr,137150,134277,2873,2.1,"Marin County, CA"
76,2019,May,137608,134868,2740,2.0,"Marin County, CA"
77,2019,Jun,138038,134676,3362,2.4,"Marin County, CA"
78,2019,Jul,140416,136825,3591,2.6,"Marin County, CA"
79,2019,Aug,139491,136043,3448,2.5,"Marin County, CA"
80,2019,Sep,139626,136697,2929,2.1,"Marin County, CA"
81,2019,Oct,139613,136545,3068,2.2,"Marin County, CA"
82,2019,Nov,139003,135949,3054,2.2,"Marin County, CA"
83,2019,Dec,138817,135919,2898,2.1,"Marin County, CA"
84,2020,Jan,138816,135385,3431,2.5,"Marin County, CA"
85,2020,Feb,139515,136241,3274,2.3,"Marin County, CA"
86,2020,Mar,136820,131993,4827,3.5,"Marin County, CA"
87,2020,Apr,124787,109523,15264,12.2,"Marin County, CA"
88,2020,May,124372,110423,13949,11.2,"Marin County, CA"
89,2020,Jun,129864,116982,12882,9.9,"Marin County, CA"
90,2020,Jul,130716,118789,11927,9.1,"Marin County, CA"
91,2020,Aug,130098,120454,9644,7.4,"Marin County, CA"
92,2020,Sep,129680,120659,9021,7.0,"Marin County, CA"
93,2020,Oct,129754,122051,7703,5.9,"Marin County, CA"
94,2020,Nov,128327,120921,7406,5.8,"Marin County, CA"
95,2020,Dec,128058,120733,7325,5.7,"Marin County, CA"
96,2021,Jan,126679,119317,7362,5.8,"Marin County, CA"
97,2021,Feb,127760,120698,7062,5.5,"Marin County, CA"
98,2021,Mar,128831,122091,6740,5.2,"Marin County, CA"
99,2021,Apr,127654,121169,6485,5.1,"Marin County, CA"
100,2021,May,127990,122056,5934,4.6,"Marin County, CA"
101,2021,Jun,129192,122560,6632,5.1,"Marin County, CA"
102,2021,Jul,131679,125346,6333,4.8,"Marin County, CA"
103,2021,Aug,130563,124522,6041,4.6,"Marin County, CA"
104,2021,Sep,130708,125710,4998,3.8,"Marin County, CA"
105,2021,Oct,131116,126288,4828,3.7,"Marin County, CA"
106,2021,Nov,131087,126739,4348,3.3,"Marin County, CA"
107,2021,Dec,130477,126566,3911,3.0,"Marin County, CA"
108,2022,Jan,129982,125528,4454,3.4,"Marin County, CA"
109,2022,Feb,131087,127037,4050,3.1,"Marin County, CA"
110,2022,Mar,131766,128132,3634,2.8,"Marin County, CA"
111,2022,Apr,130177,127018,3159,2.4,"Marin County, CA"
112,2022,May,131391,128499,2892,2.2,"Marin County, CA"
113,2022,Jun,132423,128891,3532,2.7,"Marin County, CA"
114,2022,Jul,132689,129209,3480,2.6,"Marin County, CA"
115,2022,Aug,132440,128836,3604,2.7,"Marin County, CA"
116,2022,Sep,132630,129468,3162,2.4,"Marin County, CA"
117,2022,Oct,132351,128985,3366,2.5,"Marin County, CA"
118,2022,Nov,131436,127994,3442,2.6,"Marin County, CA"
119,2022,Dec,131593,128432,3161,2.4,"Marin County, CA"
120,2023,Jan,130593,126599,3994,3.1,"Marin County, CA"
121,2023,Feb,132048,127884,4164,3.2,"Marin County, CA"
122,2023,Mar,131982,127874,4108,3.1,"Marin County, CA"
123,2023,Apr,130836,127088,3748,2.9,"Marin County, CA"
124,2023,May,131365,127395,3970,3.0,"Marin County, CA"
125,2023,Jun,131909,127375,4534,3.4,"Marin County, CA"
126,2023,Jul,133071,128622,4449,3.3,"Marin County, CA"
127,2023,Aug,132340,127416,4924,3.7,"Marin County, CA"
128,2023,Sep,133350,128665,4685,3.5,"Marin County, CA"
129,2023,Oct,132837,128112,4725,3.6,"Marin County, CA"
0,2013,Jan,7667,6551,1116,14.6,"Mariposa County, CA"
1,2013,Feb,7607,6568,1039,13.7,"Mariposa County, CA"
2,2013,Mar,7685,6680,1005,13.1,"Mariposa County, CA"
3,2013,Apr,7875,6997,878,11.1,"Mariposa County, CA"
4,2013,May,8365,7597,768,9.2,"Mariposa County, CA"
5,2013,Jun,9026,8215,811,9.0,"Mariposa County, CA"
6,2013,Jul,9048,8265,783,8.7,"Mariposa County, CA"
7,2013,Aug,8938,8202,736,8.2,"Mariposa County, CA"
8,2013,Sep,8815,8103,712,8.1,"Mariposa County, CA"
9,2013,Oct,8156,7247,909,11.1,"Mariposa County, CA"
10,2013,Nov,7635,6801,834,10.9,"Mariposa County, CA"
11,2013,Dec,7597,6711,886,11.7,"Mariposa County, CA"
12,2014,Jan,7399,6410,989,13.4,"Mariposa County, CA"
13,2014,Feb,7542,6613,929,12.3,"Mariposa County, CA"
14,2014,Mar,7594,6674,920,12.1,"Mariposa County, CA"
15,2014,Apr,7774,7062,712,9.2,"Mariposa County, CA"
16,2014,May,8164,7534,630,7.7,"Mariposa County, CA"
17,2014,Jun,8718,8077,641,7.4,"Mariposa County, CA"
18,2014,Jul,8823,8166,657,7.4,"Mariposa County, CA"
19,2014,Aug,8763,8140,623,7.1,"Mariposa County, CA"
20,2014,Sep,8660,8092,568,6.6,"Mariposa County, CA"
21,2014,Oct,8180,7601,579,7.1,"Mariposa County, CA"
22,2014,Nov,7735,7072,663,8.6,"Mariposa County, CA"
23,2014,Dec,7564,6864,700,9.3,"Mariposa County, CA"
24,2015,Jan,7538,6746,792,10.5,"Mariposa County, CA"
25,2015,Feb,7400,6615,785,10.6,"Mariposa County, CA"
26,2015,Mar,7521,6775,746,9.9,"Mariposa County, CA"
27,2015,Apr,7752,7183,569,7.3,"Mariposa County, CA"
28,2015,May,8202,7676,526,6.4,"Mariposa County, CA"
29,2015,Jun,8642,8136,506,5.9,"Mariposa County, CA"
30,2015,Jul,8709,8202,507,5.8,"Mariposa County, CA"
31,2015,Aug,8695,8235,460,5.3,"Mariposa County, CA"
32,2015,Sep,8593,8165,428,5.0,"Mariposa County, CA"
33,2015,Oct,7981,7521,460,5.8,"Mariposa County, CA"
34,2015,Nov,7628,7091,537,7.0,"Mariposa County, CA"
35,2015,Dec,7476,6891,585,7.8,"Mariposa County, CA"
36,2016,Jan,7358,6676,682,9.3,"Mariposa County, CA"
37,2016,Feb,7314,6670,644,8.8,"Mariposa County, CA"
38,2016,Mar,7129,6458,671,9.4,"Mariposa County, CA"
39,2016,Apr,7198,6657,541,7.5,"Mariposa County, CA"
40,2016,May,7467,7006,461,6.2,"Mariposa County, CA"
41,2016,Jun,8042,7569,473,5.9,"Mariposa County, CA"
42,2016,Jul,8194,7719,475,5.8,"Mariposa County, CA"
43,2016,Aug,8090,7642,448,5.5,"Mariposa County, CA"
44,2016,Sep,7934,7518,416,5.2,"Mariposa County, CA"
45,2016,Oct,7582,7151,431,5.7,"Mariposa County, CA"
46,2016,Nov,7302,6833,469,6.4,"Mariposa County, CA"
47,2016,Dec,7206,6672,534,7.4,"Mariposa County, CA"
48,2017,Jan,6981,6383,598,8.6,"Mariposa County, CA"
49,2017,Feb,7060,6450,610,8.6,"Mariposa County, CA"
50,2017,Mar,7122,6567,555,7.8,"Mariposa County, CA"
51,2017,Apr,7422,6961,461,6.2,"Mariposa County, CA"
52,2017,May,7734,7332,402,5.2,"Mariposa County, CA"
53,2017,Jun,8156,7748,408,5.0,"Mariposa County, CA"
54,2017,Jul,8344,7935,409,4.9,"Mariposa County, CA"
55,2017,Aug,8306,7909,397,4.8,"Mariposa County, CA"
56,2017,Sep,8156,7812,344,4.2,"Mariposa County, CA"
57,2017,Oct,7897,7536,361,4.6,"Mariposa County, CA"
58,2017,Nov,7399,7003,396,5.4,"Mariposa County, CA"
59,2017,Dec,7259,6802,457,6.3,"Mariposa County, CA"
60,2018,Jan,7322,6819,503,6.9,"Mariposa County, CA"
61,2018,Feb,7355,6815,540,7.3,"Mariposa County, CA"
62,2018,Mar,7419,6908,511,6.9,"Mariposa County, CA"
63,2018,Apr,7538,7127,411,5.5,"Mariposa County, CA"
64,2018,May,7786,7441,345,4.4,"Mariposa County, CA"
65,2018,Jun,8089,7708,381,4.7,"Mariposa County, CA"
66,2018,Jul,8031,7666,365,4.5,"Mariposa County, CA"
67,2018,Aug,7882,7446,436,5.5,"Mariposa County, CA"
68,2018,Sep,7962,7655,307,3.9,"Mariposa County, CA"
69,2018,Oct,7791,7454,337,4.3,"Mariposa County, CA"
70,2018,Nov,7417,7058,359,4.8,"Mariposa County, CA"
71,2018,Dec,7208,6794,414,5.7,"Mariposa County, CA"
72,2019,Jan,7137,6617,520,7.3,"Mariposa County, CA"
73,2019,Feb,7343,6844,499,6.8,"Mariposa County, CA"
74,2019,Mar,7379,6911,468,6.3,"Mariposa County, CA"
75,2019,Apr,7366,7012,354,4.8,"Mariposa County, CA"
76,2019,May,7674,7388,286,3.7,"Mariposa County, CA"
77,2019,Jun,7779,7465,314,4.0,"Mariposa County, CA"
78,2019,Jul,8138,7821,317,3.9,"Mariposa County, CA"
79,2019,Aug,8065,7772,293,3.6,"Mariposa County, CA"
80,2019,Sep,8052,7798,254,3.2,"Mariposa County, CA"
81,2019,Oct,7861,7584,277,3.5,"Mariposa County, CA"
82,2019,Nov,7583,7276,307,4.0,"Mariposa County, CA"
83,2019,Dec,7274,6947,327,4.5,"Mariposa County, CA"
84,2020,Jan,7490,7044,446,6.0,"Mariposa County, CA"
85,2020,Feb,7570,7126,444,5.9,"Mariposa County, CA"
86,2020,Mar,7608,6974,634,8.3,"Mariposa County, CA"
87,2020,Apr,7214,5722,1492,20.7,"Mariposa County, CA"
88,2020,May,7083,5707,1376,19.4,"Mariposa County, CA"
89,2020,Jun,7522,6471,1051,14.0,"Mariposa County, CA"
90,2020,Jul,7475,6630,845,11.3,"Mariposa County, CA"
91,2020,Aug,7361,6668,693,9.4,"Mariposa County, CA"
92,2020,Sep,7196,6523,673,9.4,"Mariposa County, CA"
93,2020,Oct,7011,6406,605,8.6,"Mariposa County, CA"
94,2020,Nov,6622,5977,645,9.7,"Mariposa County, CA"
95,2020,Dec,6444,5714,730,11.3,"Mariposa County, CA"
96,2021,Jan,6188,5322,866,14.0,"Mariposa County, CA"
97,2021,Feb,6367,5623,744,11.7,"Mariposa County, CA"
98,2021,Mar,6528,5841,687,10.5,"Mariposa County, CA"
99,2021,Apr,6853,6244,609,8.9,"Mariposa County, CA"
100,2021,May,7156,6616,540,7.5,"Mariposa County, CA"
101,2021,Jun,7624,7045,579,7.6,"Mariposa County, CA"
102,2021,Jul,7707,7169,538,7.0,"Mariposa County, CA"
103,2021,Aug,7659,7154,505,6.6,"Mariposa County, CA"
104,2021,Sep,7517,7091,426,5.7,"Mariposa County, CA"
105,2021,Oct,7251,6842,409,5.6,"Mariposa County, CA"
106,2021,Nov,6980,6573,407,5.8,"Mariposa County, CA"
107,2021,Dec,6795,6404,391,5.8,"Mariposa County, CA"
108,2022,Jan,6653,6171,482,7.2,"Mariposa County, CA"
109,2022,Feb,6693,6267,426,6.4,"Mariposa County, CA"
110,2022,Mar,6743,6362,381,5.7,"Mariposa County, CA"
111,2022,Apr,7021,6714,307,4.4,"Mariposa County, CA"
112,2022,May,7449,7185,264,3.5,"Mariposa County, CA"
113,2022,Jun,7789,7491,298,3.8,"Mariposa County, CA"
114,2022,Jul,7751,7462,289,3.7,"Mariposa County, CA"
115,2022,Aug,7845,7549,296,3.8,"Mariposa County, CA"
116,2022,Sep,7724,7458,266,3.4,"Mariposa County, CA"
117,2022,Oct,7530,7250,280,3.7,"Mariposa County, CA"
118,2022,Nov,7221,6911,310,4.3,"Mariposa County, CA"
119,2022,Dec,7077,6760,317,4.5,"Mariposa County, CA"
120,2023,Jan,6953,6543,410,5.9,"Mariposa County, CA"
121,2023,Feb,7224,6711,513,7.1,"Mariposa County, CA"
122,2023,Mar,7335,6834,501,6.8,"Mariposa County, CA"
123,2023,Apr,7141,6775,366,5.1,"Mariposa County, CA"
124,2023,May,7601,7257,344,4.5,"Mariposa County, CA"
125,2023,Jun,7729,7380,349,4.5,"Mariposa County, CA"
126,2023,Jul,7699,7346,353,4.6,"Mariposa County, CA"
127,2023,Aug,7711,7335,376,4.9,"Mariposa County, CA"
128,2023,Sep,7976,7637,339,4.3,"Mariposa County, CA"
129,2023,Oct,7998,7646,352,4.4,"Mariposa County, CA"
0,2013,Jan,231204,208314,22890,9.9,"Volusia County, FL"
1,2013,Feb,231605,210622,20983,9.1,"Volusia County, FL"
2,2013,Mar,233199,213186,20013,8.6,"Volusia County, FL"
3,2013,Apr,233521,214098,19423,8.3,"Volusia County, FL"
4,2013,May,236729,216607,20122,8.5,"Volusia County, FL"
5,2013,Jun,237431,216203,21228,8.9,"Volusia County, FL"
6,2013,Jul,238223,217380,20843,8.7,"Volusia County, FL"
7,2013,Aug,237450,217011,20439,8.6,"Volusia County, FL"
8,2013,Sep,238284,218588,19696,8.3,"Volusia County, FL"
9,2013,Oct,237030,217551,19479,8.2,"Volusia County, FL"
10,2013,Nov,234584,216009,18575,7.9,"Volusia County, FL"
11,2013,Dec,232523,214912,17611,7.6,"Volusia County, FL"
12,2014,Jan,234057,215528,18529,7.9,"Volusia County, FL"
13,2014,Feb,237161,219323,17838,7.5,"Volusia County, FL"
14,2014,Mar,238560,221128,17432,7.3,"Volusia County, FL"
15,2014,Apr,236142,220407,15735,6.7,"Volusia County, FL"
16,2014,May,238886,222253,16633,7.0,"Volusia County, FL"
17,2014,Jun,238300,221228,17072,7.2,"Volusia County, FL"
18,2014,Jul,239701,221974,17727,7.4,"Volusia County, FL"
19,2014,Aug,238697,221500,17197,7.2,"Volusia County, FL"
20,2014,Sep,239179,223083,16096,6.7,"Volusia County, FL"
21,2014,Oct,238689,222933,15756,6.6,"Volusia County, FL"
22,2014,Nov,236077,220406,15671,6.6,"Volusia County, FL"
23,2014,Dec,234600,219825,14775,6.3,"Volusia County, FL"
24,2015,Jan,235759,219821,15938,6.8,"Volusia County, FL"
25,2015,Feb,236811,222189,14622,6.2,"Volusia County, FL"
26,2015,Mar,237721,223758,13963,5.9,"Volusia County, FL"
27,2015,Apr,238433,224747,13686,5.7,"Volusia County, FL"
28,2015,May,241505,226906,14599,6.0,"Volusia County, FL"
29,2015,Jun,241112,226246,14866,6.2,"Volusia County, FL"
30,2015,Jul,241604,226611,14993,6.2,"Volusia County, FL"
31,2015,Aug,240923,226557,14366,6.0,"Volusia County, FL"
32,2015,Sep,241564,228024,13540,5.6,"Volusia County, FL"
33,2015,Oct,241369,227992,13377,5.5,"Volusia County, FL"
34,2015,Nov,239400,226184,13216,5.5,"Volusia County, FL"
35,2015,Dec,239049,226350,12699,5.3,"Volusia County, FL"
36,2016,Jan,240183,226835,13348,5.6,"Volusia County, FL"
37,2016,Feb,243750,231359,12391,5.1,"Volusia County, FL"
38,2016,Mar,244312,232081,12231,5.0,"Volusia County, FL"
39,2016,Apr,244332,232531,11801,4.8,"Volusia County, FL"
40,2016,May,247092,235300,11792,4.8,"Volusia County, FL"
41,2016,Jun,247669,234634,13035,5.3,"Volusia County, FL"
42,2016,Jul,249479,236189,13290,5.3,"Volusia County, FL"
43,2016,Aug,248673,235570,13103,5.3,"Volusia County, FL"
44,2016,Sep,250452,237434,13018,5.2,"Volusia County, FL"
45,2016,Oct,247785,235139,12646,5.1,"Volusia County, FL"
46,2016,Nov,246226,233888,12338,5.0,"Volusia County, FL"
47,2016,Dec,245469,233448,12021,4.9,"Volusia County, FL"
48,2017,Jan,244072,231066,13006,5.3,"Volusia County, FL"
49,2017,Feb,245808,234011,11797,4.8,"Volusia County, FL"
50,2017,Mar,248090,237011,11079,4.5,"Volusia County, FL"
51,2017,Apr,248030,237501,10529,4.2,"Volusia County, FL"
52,2017,May,249140,238301,10839,4.4,"Volusia County, FL"
53,2017,Jun,249796,238211,11585,4.6,"Volusia County, FL"
54,2017,Jul,249939,238185,11754,4.7,"Volusia County, FL"
55,2017,Aug,248592,236841,11751,4.7,"Volusia County, FL"
56,2017,Sep,249428,238653,10775,4.3,"Volusia County, FL"
57,2017,Oct,247652,237101,10551,4.3,"Volusia County, FL"
58,2017,Nov,246710,236120,10590,4.3,"Volusia County, FL"
59,2017,Dec,246090,236069,10021,4.1,"Volusia County, FL"
60,2018,Jan,246819,235869,10950,4.4,"Volusia County, FL"
61,2018,Feb,250009,239878,10131,4.1,"Volusia County, FL"
62,2018,Mar,250512,240759,9753,3.9,"Volusia County, FL"
63,2018,Apr,250219,241150,9069,3.6,"Volusia County, FL"
64,2018,May,251364,242251,9113,3.6,"Volusia County, FL"
65,2018,Jun,252816,242307,10509,4.2,"Volusia County, FL"
66,2018,Jul,253749,243519,10230,4.0,"Volusia County, FL"
67,2018,Aug,251741,241821,9920,3.9,"Volusia County, FL"
68,2018,Sep,253301,244074,9227,3.6,"Volusia County, FL"
69,2018,Oct,252911,243505,9406,3.7,"Volusia County, FL"
70,2018,Nov,250846,241872,8974,3.6,"Volusia County, FL"
71,2018,Dec,249266,240360,8906,3.6,"Volusia County, FL"
72,2019,Jan,248076,237732,10344,4.2,"Volusia County, FL"
73,2019,Feb,250733,241651,9082,3.6,"Volusia County, FL"
74,2019,Mar,250484,241620,8864,3.5,"Volusia County, FL"
75,2019,Apr,250309,242287,8022,3.2,"Volusia County, FL"
76,2019,May,252281,243757,8524,3.4,"Volusia County, FL"
77,2019,Jun,253526,243836,9690,3.8,"Volusia County, FL"
78,2019,Jul,254391,244594,9797,3.9,"Volusia County, FL"
79,2019,Aug,254214,244696,9518,3.7,"Volusia County, FL"
80,2019,Sep,255455,246787,8668,3.4,"Volusia County, FL"
81,2019,Oct,254956,246281,8675,3.4,"Volusia County, FL"
82,2019,Nov,253048,244651,8397,3.3,"Volusia County, FL"
83,2019,Dec,252315,244504,7811,3.1,"Volusia County, FL"
84,2020,Jan,254231,245156,9075,3.6,"Volusia County, FL"
85,2020,Feb,255332,247434,7898,3.1,"Volusia County, FL"
86,2020,Mar,252138,240294,11844,4.7,"Volusia County, FL"
87,2020,Apr,231792,199701,32091,13.8,"Volusia County, FL"
88,2020,May,246825,212251,34574,14.0,"Volusia County, FL"
89,2020,Jun,246501,219110,27391,11.1,"Volusia County, FL"
90,2020,Jul,253150,223371,29779,11.8,"Volusia County, FL"
91,2020,Aug,251064,230188,20876,8.3,"Volusia County, FL"
92,2020,Sep,251215,231842,19373,7.7,"Volusia County, FL"
93,2020,Oct,250871,234354,16517,6.6,"Volusia County, FL"
94,2020,Nov,248019,232673,15346,6.2,"Volusia County, FL"
95,2020,Dec,246864,232237,14627,5.9,"Volusia County, FL"
96,2021,Jan,248810,234139,14671,5.9,"Volusia County, FL"
97,2021,Feb,251004,237645,13359,5.3,"Volusia County, FL"
98,2021,Mar,252443,239663,12780,5.1,"Volusia County, FL"
99,2021,Apr,253579,241347,12232,4.8,"Volusia County, FL"
100,2021,May,254613,242666,11947,4.7,"Volusia County, FL"
101,2021,Jun,256887,243328,13559,5.3,"Volusia County, FL"
102,2021,Jul,257965,245167,12798,5.0,"Volusia County, FL"
103,2021,Aug,258700,246465,12235,4.7,"Volusia County, FL"
104,2021,Sep,260885,249804,11081,4.2,"Volusia County, FL"
105,2021,Oct,261534,250931,10603,4.1,"Volusia County, FL"
106,2021,Nov,260461,250408,10053,3.9,"Volusia County, FL"
107,2021,Dec,259658,250820,8838,3.4,"Volusia County, FL"
108,2022,Jan,260872,250148,10724,4.1,"Volusia County, FL"
109,2022,Feb,262770,253419,9351,3.6,"Volusia County, FL"
110,2022,Mar,263909,255547,8362,3.2,"Volusia County, FL"
111,2022,Apr,262856,255276,7580,2.9,"Volusia County, FL"
112,2022,May,264735,256961,7774,2.9,"Volusia County, FL"
113,2022,Jun,266627,257629,8998,3.4,"Volusia County, FL"
114,2022,Jul,266360,257855,8505,3.2,"Volusia County, FL"
115,2022,Aug,268408,259774,8634,3.2,"Volusia County, FL"
116,2022,Sep,269897,262075,7822,2.9,"Volusia County, FL"
117,2022,Oct,269876,261761,8115,3.0,"Volusia County, FL"
118,2022,Nov,267724,259935,7789,2.9,"Volusia County, FL"
119,2022,Dec,268696,261800,6896,2.6,"Volusia County, FL"
120,2023,Jan,269344,261527,7817,2.9,"Volusia County, FL"
121,2023,Feb,271714,264043,7671,2.8,"Volusia County, FL"
122,2023,Mar,274628,266797,7831,2.9,"Volusia County, FL"
123,2023,Apr,274136,267287,6849,2.5,"Volusia County, FL"
124,2023,May,274679,266629,8050,2.9,"Volusia County, FL"
125,2023,Jun,278168,269165,9003,3.2,"Volusia County, FL"
126,2023,Jul,279885,270548,9337,3.3,"Volusia County, FL"
127,2023,Aug,281365,271749,9616,3.4,"Volusia County, FL"
128,2023,Sep,280379,270934,9445,3.4,"Volusia County, FL"
129,2023,Oct,279362,269751,9611,3.4,"Volusia County, FL"
0,2013,Jan,66973,61374,5599,8.4,"Martin County, FL"
1,2013,Feb,66837,61755,5082,7.6,"Martin County, FL"
2,2013,Mar,66737,61894,4843,7.3,"Martin County, FL"
3,2013,Apr,66726,62011,4715,7.1,"Martin County, FL"
4,2013,May,67604,62655,4949,7.3,"Martin County, FL"
5,2013,Jun,67592,62151,5441,8.0,"Martin County, FL"
6,2013,Jul,67482,62024,5458,8.1,"Martin County, FL"
7,2013,Aug,67767,62389,5378,7.9,"Martin County, FL"
8,2013,Sep,68051,62900,5151,7.6,"Martin County, FL"
9,2013,Oct,67422,62437,4985,7.4,"Martin County, FL"
10,2013,Nov,67368,62646,4722,7.0,"Martin County, FL"
11,2013,Dec,67240,62838,4402,6.5,"Martin County, FL"
12,2014,Jan,67420,62854,4566,6.8,"Martin County, FL"
13,2014,Feb,67922,63517,4405,6.5,"Martin County, FL"
14,2014,Mar,68373,64026,4347,6.4,"Martin County, FL"
15,2014,Apr,67812,63932,3880,5.7,"Martin County, FL"
16,2014,May,68627,64414,4213,6.1,"Martin County, FL"
17,2014,Jun,68552,64160,4392,6.4,"Martin County, FL"
18,2014,Jul,68483,63817,4666,6.8,"Martin County, FL"
19,2014,Aug,68759,64126,4633,6.7,"Martin County, FL"
20,2014,Sep,69281,64967,4314,6.2,"Martin County, FL"
21,2014,Oct,69573,65456,4117,5.9,"Martin County, FL"
22,2014,Nov,69187,65141,4046,5.8,"Martin County, FL"
23,2014,Dec,68881,65143,3738,5.4,"Martin County, FL"
24,2015,Jan,69247,65173,4074,5.9,"Martin County, FL"
25,2015,Feb,68944,65162,3782,5.5,"Martin County, FL"
26,2015,Mar,69216,65623,3593,5.2,"Martin County, FL"
27,2015,Apr,69322,65850,3472,5.0,"Martin County, FL"
28,2015,May,70100,66314,3786,5.4,"Martin County, FL"
29,2015,Jun,69811,65829,3982,5.7,"Martin County, FL"
30,2015,Jul,69535,65377,4158,6.0,"Martin County, FL"
31,2015,Aug,69970,65993,3977,5.7,"Martin County, FL"
32,2015,Sep,70160,66416,3744,5.3,"Martin County, FL"
33,2015,Oct,70355,66675,3680,5.2,"Martin County, FL"
34,2015,Nov,70299,66654,3645,5.2,"Martin County, FL"
35,2015,Dec,70262,66777,3485,5.0,"Martin County, FL"
36,2016,Jan,70323,66693,3630,5.2,"Martin County, FL"
37,2016,Feb,70650,67255,3395,4.8,"Martin County, FL"
38,2016,Mar,70983,67598,3385,4.8,"Martin County, FL"
39,2016,Apr,70776,67537,3239,4.6,"Martin County, FL"
40,2016,May,71259,68032,3227,4.5,"Martin County, FL"
41,2016,Jun,71025,67404,3621,5.1,"Martin County, FL"
42,2016,Jul,70963,67202,3761,5.3,"Martin County, FL"
43,2016,Aug,71091,67357,3734,5.3,"Martin County, FL"
44,2016,Sep,71779,68114,3665,5.1,"Martin County, FL"
45,2016,Oct,71792,68260,3532,4.9,"Martin County, FL"
46,2016,Nov,71428,68085,3343,4.7,"Martin County, FL"
47,2016,Dec,71426,68209,3217,4.5,"Martin County, FL"
48,2017,Jan,70818,67369,3449,4.9,"Martin County, FL"
49,2017,Feb,71032,67868,3164,4.5,"Martin County, FL"
50,2017,Mar,71563,68593,2970,4.2,"Martin County, FL"
51,2017,Apr,71467,68599,2868,4.0,"Martin County, FL"
52,2017,May,71822,68877,2945,4.1,"Martin County, FL"
53,2017,Jun,71727,68576,3151,4.4,"Martin County, FL"
54,2017,Jul,71536,68256,3280,4.6,"Martin County, FL"
55,2017,Aug,71531,68252,3279,4.6,"Martin County, FL"
56,2017,Sep,71196,68181,3015,4.2,"Martin County, FL"
57,2017,Oct,71714,68878,2836,4.0,"Martin County, FL"
58,2017,Nov,71829,68970,2859,4.0,"Martin County, FL"
59,2017,Dec,71777,69086,2691,3.7,"Martin County, FL"
60,2018,Jan,71350,68437,2913,4.1,"Martin County, FL"
61,2018,Feb,71905,69205,2700,3.8,"Martin County, FL"
62,2018,Mar,72269,69689,2580,3.6,"Martin County, FL"
63,2018,Apr,72275,69843,2432,3.4,"Martin County, FL"
64,2018,May,72723,70261,2462,3.4,"Martin County, FL"
65,2018,Jun,72537,69625,2912,4.0,"Martin County, FL"
66,2018,Jul,72269,69425,2844,3.9,"Martin County, FL"
67,2018,Aug,72018,69197,2821,3.9,"Martin County, FL"
68,2018,Sep,72589,70060,2529,3.5,"Martin County, FL"
69,2018,Oct,73133,70617,2516,3.4,"Martin County, FL"
70,2018,Nov,72886,70453,2433,3.3,"Martin County, FL"
71,2018,Dec,72739,70327,2412,3.3,"Martin County, FL"
72,2019,Jan,72035,69289,2746,3.8,"Martin County, FL"
73,2019,Feb,72171,69745,2426,3.4,"Martin County, FL"
74,2019,Mar,72385,70034,2351,3.2,"Martin County, FL"
75,2019,Apr,72353,70253,2100,2.9,"Martin County, FL"
76,2019,May,72917,70708,2209,3.0,"Martin County, FL"
77,2019,Jun,72894,70307,2587,3.5,"Martin County, FL"
78,2019,Jul,72839,70179,2660,3.7,"Martin County, FL"
79,2019,Aug,73026,70420,2606,3.6,"Martin County, FL"
80,2019,Sep,73335,71012,2323,3.2,"Martin County, FL"
81,2019,Oct,73700,71492,2208,3.0,"Martin County, FL"
82,2019,Nov,73591,71438,2153,2.9,"Martin County, FL"
83,2019,Dec,73745,71743,2002,2.7,"Martin County, FL"
84,2020,Jan,73131,70809,2322,3.2,"Martin County, FL"
85,2020,Feb,73322,71325,1997,2.7,"Martin County, FL"
86,2020,Mar,72193,69333,2860,4.0,"Martin County, FL"
87,2020,Apr,65730,58322,7408,11.3,"Martin County, FL"
88,2020,May,70710,62917,7793,11.0,"Martin County, FL"
89,2020,Jun,71185,64683,6502,9.1,"Martin County, FL"
90,2020,Jul,72067,65215,6852,9.5,"Martin County, FL"
91,2020,Aug,70933,66338,4595,6.5,"Martin County, FL"
92,2020,Sep,71881,67582,4299,6.0,"Martin County, FL"
93,2020,Oct,72564,69001,3563,4.9,"Martin County, FL"
94,2020,Nov,71922,68576,3346,4.7,"Martin County, FL"
95,2020,Dec,71979,68778,3201,4.4,"Martin County, FL"
96,2021,Jan,72232,68978,3254,4.5,"Martin County, FL"
97,2021,Feb,72544,69598,2946,4.1,"Martin County, FL"
98,2021,Mar,73120,70259,2861,3.9,"Martin County, FL"
99,2021,Apr,73034,70444,2590,3.5,"Martin County, FL"
100,2021,May,73552,71067,2485,3.4,"Martin County, FL"
101,2021,Jun,73838,70843,2995,4.1,"Martin County, FL"
102,2021,Jul,73883,70962,2921,4.0,"Martin County, FL"
103,2021,Aug,73907,71015,2892,3.9,"Martin County, FL"
104,2021,Sep,74203,71670,2533,3.4,"Martin County, FL"
105,2021,Oct,74467,72057,2410,3.2,"Martin County, FL"
106,2021,Nov,74517,72205,2312,3.1,"Martin County, FL"
107,2021,Dec,74775,72743,2032,2.7,"Martin County, FL"
108,2022,Jan,75018,72452,2566,3.4,"Martin County, FL"
109,2022,Feb,75077,72865,2212,2.9,"Martin County, FL"
110,2022,Mar,75582,73564,2018,2.7,"Martin County, FL"
111,2022,Apr,75567,73753,1814,2.4,"Martin County, FL"
112,2022,May,76345,74438,1907,2.5,"Martin County, FL"
113,2022,Jun,76140,73829,2311,3.0,"Martin County, FL"
114,2022,Jul,76081,73908,2173,2.9,"Martin County, FL"
115,2022,Aug,76515,74303,2212,2.9,"Martin County, FL"
116,2022,Sep,76887,74885,2002,2.6,"Martin County, FL"
117,2022,Oct,76918,74999,1919,2.5,"Martin County, FL"
118,2022,Nov,76254,74394,1860,2.4,"Martin County, FL"
119,2022,Dec,76825,75193,1632,2.1,"Martin County, FL"
120,2023,Jan,76419,74491,1928,2.5,"Martin County, FL"
121,2023,Feb,77112,75184,1928,2.5,"Martin County, FL"
122,2023,Mar,77887,75981,1906,2.4,"Martin County, FL"
123,2023,Apr,78030,76338,1692,2.2,"Martin County, FL"
124,2023,May,78497,76489,2008,2.6,"Martin County, FL"
125,2023,Jun,78807,76496,2311,2.9,"Martin County, FL"
126,2023,Jul,79063,76647,2416,3.1,"Martin County, FL"
127,2023,Aug,79633,77086,2547,3.2,"Martin County, FL"
128,2023,Sep,79605,77076,2529,3.2,"Martin County, FL"
129,2023,Oct,79491,77070,2421,3.0,"Martin County, FL"
0,2013,Jan,412950,387809,25141,6.1,"San Mateo County, CA"
1,2013,Feb,414611,390871,23740,5.7,"San Mateo County, CA"
2,2013,Mar,414250,391352,22898,5.5,"San Mateo County, CA"
3,2013,Apr,412775,391823,20952,5.1,"San Mateo County, CA"
4,2013,May,414630,393450,21180,5.1,"San Mateo County, CA"
5,2013,Jun,415447,391750,23697,5.7,"San Mateo County, CA"
6,2013,Jul,420080,396299,23781,5.7,"San Mateo County, CA"
7,2013,Aug,418122,395652,22470,5.4,"San Mateo County, CA"
8,2013,Sep,419185,397640,21545,5.1,"San Mateo County, CA"
9,2013,Oct,416096,394561,21535,5.2,"San Mateo County, CA"
10,2013,Nov,419276,398835,20441,4.9,"San Mateo County, CA"
11,2013,Dec,419360,400465,18895,4.5,"San Mateo County, CA"
12,2014,Jan,418090,398130,19960,4.8,"San Mateo County, CA"
13,2014,Feb,422143,401769,20374,4.8,"San Mateo County, CA"
14,2014,Mar,423512,403254,20258,4.8,"San Mateo County, CA"
15,2014,Apr,419349,402490,16859,4.0,"San Mateo County, CA"
16,2014,May,422111,404915,17196,4.1,"San Mateo County, CA"
17,2014,Jun,422859,404450,18409,4.4,"San Mateo County, CA"
18,2014,Jul,429638,409775,19863,4.6,"San Mateo County, CA"
19,2014,Aug,428452,409509,18943,4.4,"San Mateo County, CA"
20,2014,Sep,429832,412459,17373,4.0,"San Mateo County, CA"
21,2014,Oct,431873,414790,17083,4.0,"San Mateo County, CA"
22,2014,Nov,431518,414751,16767,3.9,"San Mateo County, CA"
23,2014,Dec,430985,416015,14970,3.5,"San Mateo County, CA"
24,2015,Jan,428646,411828,16818,3.9,"San Mateo County, CA"
25,2015,Feb,430536,414636,15900,3.7,"San Mateo County, CA"
26,2015,Mar,431707,415964,15743,3.6,"San Mateo County, CA"
27,2015,Apr,429503,415006,14497,3.4,"San Mateo County, CA"
28,2015,May,432349,417857,14492,3.4,"San Mateo County, CA"
29,2015,Jun,432012,416489,15523,3.6,"San Mateo County, CA"
30,2015,Jul,437757,421668,16089,3.7,"San Mateo County, CA"
31,2015,Aug,437420,422472,14948,3.4,"San Mateo County, CA"
32,2015,Sep,436966,423101,13865,3.2,"San Mateo County, CA"
33,2015,Oct,437585,423358,14227,3.3,"San Mateo County, CA"
34,2015,Nov,437814,423957,13857,3.2,"San Mateo County, CA"
35,2015,Dec,438511,425386,13125,3.0,"San Mateo County, CA"
36,2016,Jan,437079,423243,13836,3.2,"San Mateo County, CA"
37,2016,Feb,440622,426776,13846,3.1,"San Mateo County, CA"
38,2016,Mar,442333,428223,14110,3.2,"San Mateo County, CA"
39,2016,Apr,437743,424743,13000,3.0,"San Mateo County, CA"
40,2016,May,438236,426354,11882,2.7,"San Mateo County, CA"
41,2016,Jun,439864,425666,14198,3.2,"San Mateo County, CA"
42,2016,Jul,445694,430982,14712,3.3,"San Mateo County, CA"
43,2016,Aug,444568,430310,14258,3.2,"San Mateo County, CA"
44,2016,Sep,445106,431474,13632,3.1,"San Mateo County, CA"
45,2016,Oct,443996,430306,13690,3.1,"San Mateo County, CA"
46,2016,Nov,443666,430950,12716,2.9,"San Mateo County, CA"
47,2016,Dec,442600,430355,12245,2.8,"San Mateo County, CA"
48,2017,Jan,442546,428654,13892,3.1,"San Mateo County, CA"
49,2017,Feb,445746,432556,13190,3.0,"San Mateo County, CA"
50,2017,Mar,445618,433092,12526,2.8,"San Mateo County, CA"
51,2017,Apr,441326,429832,11494,2.6,"San Mateo County, CA"
52,2017,May,441502,430300,11202,2.5,"San Mateo County, CA"
53,2017,Jun,442534,429419,13115,3.0,"San Mateo County, CA"
54,2017,Jul,449009,435216,13793,3.1,"San Mateo County, CA"
55,2017,Aug,446254,432852,13402,3.0,"San Mateo County, CA"
56,2017,Sep,448129,436546,11583,2.6,"San Mateo County, CA"
57,2017,Oct,445450,434266,11184,2.5,"San Mateo County, CA"
58,2017,Nov,446055,435416,10639,2.4,"San Mateo County, CA"
59,2017,Dec,444735,434594,10141,2.3,"San Mateo County, CA"
60,2018,Jan,440991,429761,11230,2.5,"San Mateo County, CA"
61,2018,Feb,446182,435357,10825,2.4,"San Mateo County, CA"
62,2018,Mar,447096,436871,10225,2.3,"San Mateo County, CA"
63,2018,Apr,443555,434291,9264,2.1,"San Mateo County, CA"
64,2018,May,445259,436656,8603,1.9,"San Mateo County, CA"
65,2018,Jun,446804,435906,10898,2.4,"San Mateo County, CA"
66,2018,Jul,453277,442524,10753,2.4,"San Mateo County, CA"
67,2018,Aug,450482,439821,10661,2.4,"San Mateo County, CA"
68,2018,Sep,452031,442309,9722,2.2,"San Mateo County, CA"
69,2018,Oct,453726,443859,9867,2.2,"San Mateo County, CA"
70,2018,Nov,454413,444864,9549,2.1,"San Mateo County, CA"
71,2018,Dec,454296,444681,9615,2.1,"San Mateo County, CA"
72,2019,Jan,452382,440984,11398,2.5,"San Mateo County, CA"
73,2019,Feb,456840,446759,10081,2.2,"San Mateo County, CA"
74,2019,Mar,456906,446642,10264,2.2,"San Mateo County, CA"
75,2019,Apr,451963,443631,8332,1.8,"San Mateo County, CA"
76,2019,May,452637,444519,8118,1.8,"San Mateo County, CA"
77,2019,Jun,453486,443610,9876,2.2,"San Mateo County, CA"
78,2019,Jul,461704,451204,10500,2.3,"San Mateo County, CA"
79,2019,Aug,460026,450044,9982,2.2,"San Mateo County, CA"
80,2019,Sep,461177,452652,8525,1.8,"San Mateo County, CA"
81,2019,Oct,460968,451967,9001,2.0,"San Mateo County, CA"
82,2019,Nov,460114,451088,9026,2.0,"San Mateo County, CA"
83,2019,Dec,460482,451964,8518,1.8,"San Mateo County, CA"
84,2020,Jan,463193,453228,9965,2.2,"San Mateo County, CA"
85,2020,Feb,467675,458053,9622,2.1,"San Mateo County, CA"
86,2020,Mar,458671,444344,14327,3.1,"San Mateo County, CA"
87,2020,Apr,434772,383295,51477,11.8,"San Mateo County, CA"
88,2020,May,427120,378435,48685,11.4,"San Mateo County, CA"
89,2020,Jun,438028,393000,45028,10.3,"San Mateo County, CA"
90,2020,Jul,437887,397113,40774,9.3,"San Mateo County, CA"
91,2020,Aug,434222,400455,33767,7.8,"San Mateo County, CA"
92,2020,Sep,432165,400005,32160,7.4,"San Mateo County, CA"
93,2020,Oct,429167,401459,27708,6.5,"San Mateo County, CA"
94,2020,Nov,425344,399144,26200,6.2,"San Mateo County, CA"
95,2020,Dec,425205,399943,25262,5.9,"San Mateo County, CA"
96,2021,Jan,422542,397435,25107,5.9,"San Mateo County, CA"
97,2021,Feb,425340,401381,23959,5.6,"San Mateo County, CA"
98,2021,Mar,426554,403638,22916,5.4,"San Mateo County, CA"
99,2021,Apr,423253,400793,22460,5.3,"San Mateo County, CA"
100,2021,May,425639,405044,20595,4.8,"San Mateo County, CA"
101,2021,Jun,429920,407024,22896,5.3,"San Mateo County, CA"
102,2021,Jul,437766,416201,21565,4.9,"San Mateo County, CA"
103,2021,Aug,437902,417485,20417,4.7,"San Mateo County, CA"
104,2021,Sep,439824,422761,17063,3.9,"San Mateo County, CA"
105,2021,Oct,442463,426192,16271,3.7,"San Mateo County, CA"
106,2021,Nov,443692,429183,14509,3.3,"San Mateo County, CA"
107,2021,Dec,445750,432676,13074,2.9,"San Mateo County, CA"
108,2022,Jan,445988,431382,14606,3.3,"San Mateo County, CA"
109,2022,Feb,449125,436052,13073,2.9,"San Mateo County, CA"
110,2022,Mar,451579,439884,11695,2.6,"San Mateo County, CA"
111,2022,Apr,447158,437145,10013,2.2,"San Mateo County, CA"
112,2022,May,450751,441575,9176,2.0,"San Mateo County, CA"
113,2022,Jun,453665,442722,10943,2.4,"San Mateo County, CA"
114,2022,Jul,456940,446250,10690,2.3,"San Mateo County, CA"
115,2022,Aug,456010,444910,11100,2.4,"San Mateo County, CA"
116,2022,Sep,456775,446973,9802,2.1,"San Mateo County, CA"
117,2022,Oct,457861,447588,10273,2.2,"San Mateo County, CA"
118,2022,Nov,456452,445890,10562,2.3,"San Mateo County, CA"
119,2022,Dec,458245,448611,9634,2.1,"San Mateo County, CA"
120,2023,Jan,456437,444411,12026,2.6,"San Mateo County, CA"
121,2023,Feb,458784,446034,12750,2.8,"San Mateo County, CA"
122,2023,Mar,460172,447392,12780,2.8,"San Mateo County, CA"
123,2023,Apr,455041,443510,11531,2.5,"San Mateo County, CA"
124,2023,May,455628,443210,12418,2.7,"San Mateo County, CA"
125,2023,Jun,456186,442152,14034,3.1,"San Mateo County, CA"
126,2023,Jul,461080,447212,13868,3.0,"San Mateo County, CA"
127,2023,Aug,456523,441289,15234,3.3,"San Mateo County, CA"
128,2023,Sep,456373,441950,14423,3.2,"San Mateo County, CA"
129,2023,Oct,455864,441391,14473,3.2,"San Mateo County, CA"
0,2013,Jan,213565,194295,19270,9.0,"Santa Barbara County, CA"
1,2013,Feb,213976,195969,18007,8.4,"Santa Barbara County, CA"
2,2013,Mar,216808,199693,17115,7.9,"Santa Barbara County, CA"
3,2013,Apr,218213,203463,14750,6.8,"Santa Barbara County, CA"
4,2013,May,219802,205500,14302,6.5,"Santa Barbara County, CA"
5,2013,Jun,220095,203919,16176,7.3,"Santa Barbara County, CA"
6,2013,Jul,217966,201759,16207,7.4,"Santa Barbara County, CA"
7,2013,Aug,216062,200805,15257,7.1,"Santa Barbara County, CA"
8,2013,Sep,215733,201226,14507,6.7,"Santa Barbara County, CA"
9,2013,Oct,216332,201569,14763,6.8,"Santa Barbara County, CA"
10,2013,Nov,216670,201928,14742,6.8,"Santa Barbara County, CA"
11,2013,Dec,213145,198510,14635,6.9,"Santa Barbara County, CA"
12,2014,Jan,212507,196391,16116,7.6,"Santa Barbara County, CA"
13,2014,Feb,215699,199770,15929,7.4,"Santa Barbara County, CA"
14,2014,Mar,220199,204944,15255,6.9,"Santa Barbara County, CA"
15,2014,Apr,218225,206043,12182,5.6,"Santa Barbara County, CA"
16,2014,May,219215,207332,11883,5.4,"Santa Barbara County, CA"
17,2014,Jun,219124,206265,12859,5.9,"Santa Barbara County, CA"
18,2014,Jul,218277,204468,13809,6.3,"Santa Barbara County, CA"
19,2014,Aug,217359,204162,13197,6.1,"Santa Barbara County, CA"
20,2014,Sep,216180,204006,12174,5.6,"Santa Barbara County, CA"
21,2014,Oct,218091,205825,12266,5.6,"Santa Barbara County, CA"
22,2014,Nov,218284,205428,12856,5.9,"Santa Barbara County, CA"
23,2014,Dec,214809,201946,12863,6.0,"Santa Barbara County, CA"
24,2015,Jan,214385,200000,14385,6.7,"Santa Barbara County, CA"
25,2015,Feb,217004,203519,13485,6.2,"Santa Barbara County, CA"
26,2015,Mar,218620,206056,12564,5.7,"Santa Barbara County, CA"
27,2015,Apr,218925,208100,10825,4.9,"Santa Barbara County, CA"
28,2015,May,220287,209814,10473,4.8,"Santa Barbara County, CA"
29,2015,Jun,219163,208044,11119,5.1,"Santa Barbara County, CA"
30,2015,Jul,218794,207325,11469,5.2,"Santa Barbara County, CA"
31,2015,Aug,217299,206501,10798,5.0,"Santa Barbara County, CA"
32,2015,Sep,216531,206653,9878,4.6,"Santa Barbara County, CA"
33,2015,Oct,215988,205412,10576,4.9,"Santa Barbara County, CA"
34,2015,Nov,215244,203874,11370,5.3,"Santa Barbara County, CA"
35,2015,Dec,213651,201788,11863,5.6,"Santa Barbara County, CA"
36,2016,Jan,213022,200103,12919,6.1,"Santa Barbara County, CA"
37,2016,Feb,214822,202165,12657,5.9,"Santa Barbara County, CA"
38,2016,Mar,217542,205232,12310,5.7,"Santa Barbara County, CA"
39,2016,Apr,216166,205958,10208,4.7,"Santa Barbara County, CA"
40,2016,May,216267,207301,8966,4.1,"Santa Barbara County, CA"
41,2016,Jun,217077,206398,10679,4.9,"Santa Barbara County, CA"
42,2016,Jul,217119,206348,10771,5.0,"Santa Barbara County, CA"
43,2016,Aug,215535,205112,10423,4.8,"Santa Barbara County, CA"
44,2016,Sep,214767,204827,9940,4.6,"Santa Barbara County, CA"
45,2016,Oct,214724,204654,10070,4.7,"Santa Barbara County, CA"
46,2016,Nov,214715,204366,10349,4.8,"Santa Barbara County, CA"
47,2016,Dec,211316,199482,11834,5.6,"Santa Barbara County, CA"
48,2017,Jan,211208,198117,13091,6.2,"Santa Barbara County, CA"
49,2017,Feb,212822,200238,12584,5.9,"Santa Barbara County, CA"
50,2017,Mar,214526,202943,11583,5.4,"Santa Barbara County, CA"
51,2017,Apr,216503,207239,9264,4.3,"Santa Barbara County, CA"
52,2017,May,216526,208308,8218,3.8,"Santa Barbara County, CA"
53,2017,Jun,217288,207855,9433,4.3,"Santa Barbara County, CA"
54,2017,Jul,217361,207592,9769,4.5,"Santa Barbara County, CA"
55,2017,Aug,215331,205993,9338,4.3,"Santa Barbara County, CA"
56,2017,Sep,216349,208070,8279,3.8,"Santa Barbara County, CA"
57,2017,Oct,215774,207533,8241,3.8,"Santa Barbara County, CA"
58,2017,Nov,215358,206763,8595,4.0,"Santa Barbara County, CA"
59,2017,Dec,210322,201085,9237,4.4,"Santa Barbara County, CA"
60,2018,Jan,209273,198120,11153,5.3,"Santa Barbara County, CA"
61,2018,Feb,214740,204103,10637,5.0,"Santa Barbara County, CA"
62,2018,Mar,214934,204996,9938,4.6,"Santa Barbara County, CA"
63,2018,Apr,215059,206985,8074,3.8,"Santa Barbara County, CA"
64,2018,May,217195,210366,6829,3.1,"Santa Barbara County, CA"
65,2018,Jun,218024,209695,8329,3.8,"Santa Barbara County, CA"
66,2018,Jul,217195,208958,8237,3.8,"Santa Barbara County, CA"
67,2018,Aug,215082,207136,7946,3.7,"Santa Barbara County, CA"
68,2018,Sep,215487,208271,7216,3.3,"Santa Barbara County, CA"
69,2018,Oct,217316,209891,7425,3.4,"Santa Barbara County, CA"
70,2018,Nov,215616,208042,7574,3.5,"Santa Barbara County, CA"
71,2018,Dec,212976,204004,8972,4.2,"Santa Barbara County, CA"
72,2019,Jan,218287,206841,11446,5.2,"Santa Barbara County, CA"
73,2019,Feb,220499,210178,10321,4.7,"Santa Barbara County, CA"
74,2019,Mar,222479,212414,10065,4.5,"Santa Barbara County, CA"
75,2019,Apr,223217,215771,7446,3.3,"Santa Barbara County, CA"
76,2019,May,223061,216619,6442,2.9,"Santa Barbara County, CA"
77,2019,Jun,224422,216917,7505,3.3,"Santa Barbara County, CA"
78,2019,Jul,224497,216572,7925,3.5,"Santa Barbara County, CA"
79,2019,Aug,221985,214616,7369,3.3,"Santa Barbara County, CA"
80,2019,Sep,222527,215992,6535,2.9,"Santa Barbara County, CA"
81,2019,Oct,225272,218328,6944,3.1,"Santa Barbara County, CA"
82,2019,Nov,224221,216992,7229,3.2,"Santa Barbara County, CA"
83,2019,Dec,222764,214742,8022,3.6,"Santa Barbara County, CA"
84,2020,Jan,220494,210332,10162,4.6,"Santa Barbara County, CA"
85,2020,Feb,224191,214395,9796,4.4,"Santa Barbara County, CA"
86,2020,Mar,224041,210281,13760,6.1,"Santa Barbara County, CA"
87,2020,Apr,216166,185490,30676,14.2,"Santa Barbara County, CA"
88,2020,May,214954,187754,27200,12.7,"Santa Barbara County, CA"
89,2020,Jun,219836,196647,23189,10.5,"Santa Barbara County, CA"
90,2020,Jul,221650,200336,21314,9.6,"Santa Barbara County, CA"
91,2020,Aug,218659,201462,17197,7.9,"Santa Barbara County, CA"
92,2020,Sep,219058,202920,16138,7.4,"Santa Barbara County, CA"
93,2020,Oct,219419,205158,14261,6.5,"Santa Barbara County, CA"
94,2020,Nov,216574,202222,14352,6.6,"Santa Barbara County, CA"
95,2020,Dec,212169,196336,15833,7.5,"Santa Barbara County, CA"
96,2021,Jan,208960,191656,17304,8.3,"Santa Barbara County, CA"
97,2021,Feb,212482,195856,16626,7.8,"Santa Barbara County, CA"
98,2021,Mar,216486,201040,15446,7.1,"Santa Barbara County, CA"
99,2021,Apr,219201,205270,13931,6.4,"Santa Barbara County, CA"
100,2021,May,221931,209548,12383,5.6,"Santa Barbara County, CA"
101,2021,Jun,223723,210005,13718,6.1,"Santa Barbara County, CA"
102,2021,Jul,225312,212411,12901,5.7,"Santa Barbara County, CA"
103,2021,Aug,222047,209961,12086,5.4,"Santa Barbara County, CA"
104,2021,Sep,223677,213530,10147,4.5,"Santa Barbara County, CA"
105,2021,Oct,224918,215098,9820,4.4,"Santa Barbara County, CA"
106,2021,Nov,223320,214247,9073,4.1,"Santa Barbara County, CA"
107,2021,Dec,216391,207340,9051,4.2,"Santa Barbara County, CA"
108,2022,Jan,215764,204641,11123,5.2,"Santa Barbara County, CA"
109,2022,Feb,218530,208279,10251,4.7,"Santa Barbara County, CA"
110,2022,Mar,222455,213532,8923,4.0,"Santa Barbara County, CA"
111,2022,Apr,224599,217460,7139,3.2,"Santa Barbara County, CA"
112,2022,May,227066,220794,6272,2.8,"Santa Barbara County, CA"
113,2022,Jun,227116,219786,7330,3.2,"Santa Barbara County, CA"
114,2022,Jul,226347,219150,7197,3.2,"Santa Barbara County, CA"
115,2022,Aug,223939,216749,7190,3.2,"Santa Barbara County, CA"
116,2022,Sep,225769,219332,6437,2.9,"Santa Barbara County, CA"
117,2022,Oct,227103,220155,6948,3.1,"Santa Barbara County, CA"
118,2022,Nov,224645,217108,7537,3.4,"Santa Barbara County, CA"
119,2022,Dec,221269,213668,7601,3.4,"Santa Barbara County, CA"
120,2023,Jan,220755,210793,9962,4.5,"Santa Barbara County, CA"
121,2023,Feb,224413,214042,10371,4.6,"Santa Barbara County, CA"
122,2023,Mar,228144,217889,10255,4.5,"Santa Barbara County, CA"
123,2023,Apr,228951,220465,8486,3.7,"Santa Barbara County, CA"
124,2023,May,229534,221660,7874,3.4,"Santa Barbara County, CA"
125,2023,Jun,229102,220447,8655,3.8,"Santa Barbara County, CA"
126,2023,Jul,229441,221301,8140,3.5,"Santa Barbara County, CA"
127,2023,Aug,226660,217877,8783,3.9,"Santa Barbara County, CA"
128,2023,Sep,229417,221133,8284,3.6,"Santa Barbara County, CA"
129,2023,Oct,229679,221112,8567,3.7,"Santa Barbara County, CA"
0,2013,Jan,63550,54097,9453,14.9,"Madera County, CA"
1,2013,Feb,63483,54411,9072,14.3,"Madera County, CA"
2,2013,Mar,61342,52363,8979,14.6,"Madera County, CA"
3,2013,Apr,61185,52953,8232,13.5,"Madera County, CA"
4,2013,May,63935,56346,7589,11.9,"Madera County, CA"
5,2013,Jun,63216,55226,7990,12.6,"Madera County, CA"
6,2013,Jul,61213,53383,7830,12.8,"Madera County, CA"
7,2013,Aug,63186,55995,7191,11.4,"Madera County, CA"
8,2013,Sep,62803,56022,6781,10.8,"Madera County, CA"
9,2013,Oct,61115,54093,7022,11.5,"Madera County, CA"
10,2013,Nov,59153,51850,7303,12.3,"Madera County, CA"
11,2013,Dec,60693,53276,7417,12.2,"Madera County, CA"
12,2014,Jan,63503,55417,8086,12.7,"Madera County, CA"
13,2014,Feb,63566,55470,8096,12.7,"Madera County, CA"
14,2014,Mar,62105,53756,8349,13.4,"Madera County, CA"
15,2014,Apr,61624,54399,7225,11.7,"Madera County, CA"
16,2014,May,62793,56065,6728,10.7,"Madera County, CA"
17,2014,Jun,62058,55276,6782,10.9,"Madera County, CA"
18,2014,Jul,61296,54410,6886,11.2,"Madera County, CA"
19,2014,Aug,62310,55996,6314,10.1,"Madera County, CA"
20,2014,Sep,62697,56990,5707,9.1,"Madera County, CA"
21,2014,Oct,60636,54740,5896,9.7,"Madera County, CA"
22,2014,Nov,58789,51972,6817,11.6,"Madera County, CA"
23,2014,Dec,59166,52145,7021,11.9,"Madera County, CA"
24,2015,Jan,60861,53244,7617,12.5,"Madera County, CA"
25,2015,Feb,61621,54268,7353,11.9,"Madera County, CA"
26,2015,Mar,59606,52116,7490,12.6,"Madera County, CA"
27,2015,Apr,59167,52558,6609,11.2,"Madera County, CA"
28,2015,May,60024,53752,6272,10.4,"Madera County, CA"
29,2015,Jun,60226,53921,6305,10.5,"Madera County, CA"
30,2015,Jul,59302,53117,6185,10.4,"Madera County, CA"
31,2015,Aug,60165,54607,5558,9.2,"Madera County, CA"
32,2015,Sep,60157,55124,5033,8.4,"Madera County, CA"
33,2015,Oct,58785,53354,5431,9.2,"Madera County, CA"
34,2015,Nov,58165,52201,5964,10.3,"Madera County, CA"
35,2015,Dec,59601,53498,6103,10.2,"Madera County, CA"
36,2016,Jan,61701,55208,6493,10.5,"Madera County, CA"
37,2016,Feb,62651,56288,6363,10.2,"Madera County, CA"
38,2016,Mar,61209,54476,6733,11.0,"Madera County, CA"
39,2016,Apr,61050,55077,5973,9.8,"Madera County, CA"
40,2016,May,61324,56078,5246,8.6,"Madera County, CA"
41,2016,Jun,60487,54852,5635,9.3,"Madera County, CA"
42,2016,Jul,60030,54472,5558,9.3,"Madera County, CA"
43,2016,Aug,61028,55971,5057,8.3,"Madera County, CA"
44,2016,Sep,61872,57159,4713,7.6,"Madera County, CA"
45,2016,Oct,60937,55951,4986,8.2,"Madera County, CA"
46,2016,Nov,59926,54594,5332,8.9,"Madera County, CA"
47,2016,Dec,60398,54588,5810,9.6,"Madera County, CA"
48,2017,Jan,62028,55672,6356,10.2,"Madera County, CA"
49,2017,Feb,62163,55913,6250,10.1,"Madera County, CA"
50,2017,Mar,61024,54958,6066,9.9,"Madera County, CA"
51,2017,Apr,60298,54888,5410,9.0,"Madera County, CA"
52,2017,May,61185,56406,4779,7.8,"Madera County, CA"
53,2017,Jun,61171,56220,4951,8.1,"Madera County, CA"
54,2017,Jul,60423,55551,4872,8.1,"Madera County, CA"
55,2017,Aug,60726,56228,4498,7.4,"Madera County, CA"
56,2017,Sep,61703,57826,3877,6.3,"Madera County, CA"
57,2017,Oct,60086,56236,3850,6.4,"Madera County, CA"
58,2017,Nov,59771,55598,4173,7.0,"Madera County, CA"
59,2017,Dec,60329,55687,4642,7.7,"Madera County, CA"
60,2018,Jan,61834,56578,5256,8.5,"Madera County, CA"
61,2018,Feb,63644,58413,5231,8.2,"Madera County, CA"
62,2018,Mar,61451,56249,5202,8.5,"Madera County, CA"
63,2018,Apr,59726,55082,4644,7.8,"Madera County, CA"
64,2018,May,61495,57470,4025,6.5,"Madera County, CA"
65,2018,Jun,61308,56933,4375,7.1,"Madera County, CA"
66,2018,Jul,60345,56054,4291,7.1,"Madera County, CA"
67,2018,Aug,60323,56448,3875,6.4,"Madera County, CA"
68,2018,Sep,61874,58466,3408,5.5,"Madera County, CA"
69,2018,Oct,61136,57526,3610,5.9,"Madera County, CA"
70,2018,Nov,60123,56285,3838,6.4,"Madera County, CA"
71,2018,Dec,61801,57316,4485,7.3,"Madera County, CA"
72,2019,Jan,63284,57780,5504,8.7,"Madera County, CA"
73,2019,Feb,63850,58680,5170,8.1,"Madera County, CA"
74,2019,Mar,62303,57071,5232,8.4,"Madera County, CA"
75,2019,Apr,60979,56505,4474,7.3,"Madera County, CA"
76,2019,May,62496,58633,3863,6.2,"Madera County, CA"
77,2019,Jun,62197,57957,4240,6.8,"Madera County, CA"
78,2019,Jul,61484,57124,4360,7.1,"Madera County, CA"
79,2019,Aug,62197,58277,3920,6.3,"Madera County, CA"
80,2019,Sep,62710,59379,3331,5.3,"Madera County, CA"
81,2019,Oct,60774,57288,3486,5.7,"Madera County, CA"
82,2019,Nov,61359,57481,3878,6.3,"Madera County, CA"
83,2019,Dec,62879,58536,4343,6.9,"Madera County, CA"
84,2020,Jan,63659,58448,5211,8.2,"Madera County, CA"
85,2020,Feb,64909,59803,5106,7.9,"Madera County, CA"
86,2020,Mar,64075,56500,7575,11.8,"Madera County, CA"
87,2020,Apr,60452,49757,10695,17.7,"Madera County, CA"
88,2020,May,61539,52195,9344,15.2,"Madera County, CA"
89,2020,Jun,62649,54617,8032,12.8,"Madera County, CA"
90,2020,Jul,61497,53850,7647,12.4,"Madera County, CA"
91,2020,Aug,62757,56492,6265,10.0,"Madera County, CA"
92,2020,Sep,61715,55803,5912,9.6,"Madera County, CA"
93,2020,Oct,60421,55057,5364,8.9,"Madera County, CA"
94,2020,Nov,60031,54403,5628,9.4,"Madera County, CA"
95,2020,Dec,61097,55070,6027,9.9,"Madera County, CA"
96,2021,Jan,62441,55923,6518,10.4,"Madera County, CA"
97,2021,Feb,62856,56279,6577,10.5,"Madera County, CA"
98,2021,Mar,61445,54978,6467,10.5,"Madera County, CA"
99,2021,Apr,60641,54437,6204,10.2,"Madera County, CA"
100,2021,May,62493,56877,5616,9.0,"Madera County, CA"
101,2021,Jun,63227,57050,6177,9.8,"Madera County, CA"
102,2021,Jul,61795,56065,5730,9.3,"Madera County, CA"
103,2021,Aug,63602,58406,5196,8.2,"Madera County, CA"
104,2021,Sep,62443,58000,4443,7.1,"Madera County, CA"
105,2021,Oct,61240,56870,4370,7.1,"Madera County, CA"
106,2021,Nov,61835,57646,4189,6.8,"Madera County, CA"
107,2021,Dec,62730,58535,4195,6.7,"Madera County, CA"
108,2022,Jan,64180,59213,4967,7.7,"Madera County, CA"
109,2022,Feb,64656,59952,4704,7.3,"Madera County, CA"
110,2022,Mar,62771,58424,4347,6.9,"Madera County, CA"
111,2022,Apr,62277,58488,3789,6.1,"Madera County, CA"
112,2022,May,62967,59548,3419,5.4,"Madera County, CA"
113,2022,Jun,62592,58846,3746,6.0,"Madera County, CA"
114,2022,Jul,62195,58519,3676,5.9,"Madera County, CA"
115,2022,Aug,64318,60813,3505,5.4,"Madera County, CA"
116,2022,Sep,63855,60683,3172,5.0,"Madera County, CA"
117,2022,Oct,62962,59487,3475,5.5,"Madera County, CA"
118,2022,Nov,63621,59765,3856,6.1,"Madera County, CA"
119,2022,Dec,64970,60966,4004,6.2,"Madera County, CA"
120,2023,Jan,65803,60836,4967,7.5,"Madera County, CA"
121,2023,Feb,67230,61705,5525,8.2,"Madera County, CA"
122,2023,Mar,65770,59983,5787,8.8,"Madera County, CA"
123,2023,Apr,63751,58862,4889,7.7,"Madera County, CA"
124,2023,May,64668,59809,4859,7.5,"Madera County, CA"
125,2023,Jun,64056,59152,4904,7.7,"Madera County, CA"
126,2023,Jul,63204,58632,4572,7.2,"Madera County, CA"
127,2023,Aug,64722,60181,4541,7.0,"Madera County, CA"
128,2023,Sep,64328,60312,4016,6.2,"Madera County, CA"
129,2023,Oct,63427,59138,4289,6.8,"Madera County, CA"
0,2013,Jan,4803,4450,353,7.3,"Franklin County, FL"
1,2013,Feb,4843,4527,316,6.5,"Franklin County, FL"
2,2013,Mar,4893,4609,284,5.8,"Franklin County, FL"
3,2013,Apr,4996,4725,271,5.4,"Franklin County, FL"
4,2013,May,5093,4814,279,5.5,"Franklin County, FL"
5,2013,Jun,5124,4831,293,5.7,"Franklin County, FL"
6,2013,Jul,5213,4925,288,5.5,"Franklin County, FL"
7,2013,Aug,5163,4887,276,5.3,"Franklin County, FL"
8,2013,Sep,5109,4845,264,5.2,"Franklin County, FL"
9,2013,Oct,4909,4647,262,5.3,"Franklin County, FL"
10,2013,Nov,4841,4560,281,5.8,"Franklin County, FL"
11,2013,Dec,4711,4432,279,5.9,"Franklin County, FL"
12,2014,Jan,4779,4462,317,6.6,"Franklin County, FL"
13,2014,Feb,4808,4506,302,6.3,"Franklin County, FL"
14,2014,Mar,4913,4624,289,5.9,"Franklin County, FL"
15,2014,Apr,4953,4677,276,5.6,"Franklin County, FL"
16,2014,May,5108,4821,287,5.6,"Franklin County, FL"
17,2014,Jun,5179,4885,294,5.7,"Franklin County, FL"
18,2014,Jul,5176,4871,305,5.9,"Franklin County, FL"
19,2014,Aug,5072,4782,290,5.7,"Franklin County, FL"
20,2014,Sep,4973,4702,271,5.4,"Franklin County, FL"
21,2014,Oct,4858,4596,262,5.4,"Franklin County, FL"
22,2014,Nov,4731,4460,271,5.7,"Franklin County, FL"
23,2014,Dec,4674,4411,263,5.6,"Franklin County, FL"
24,2015,Jan,4767,4480,287,6.0,"Franklin County, FL"
25,2015,Feb,4708,4453,255,5.4,"Franklin County, FL"
26,2015,Mar,4742,4509,233,4.9,"Franklin County, FL"
27,2015,Apr,4792,4572,220,4.6,"Franklin County, FL"
28,2015,May,4892,4670,222,4.5,"Franklin County, FL"
29,2015,Jun,4905,4678,227,4.6,"Franklin County, FL"
30,2015,Jul,4858,4637,221,4.5,"Franklin County, FL"
31,2015,Aug,4890,4671,219,4.5,"Franklin County, FL"
32,2015,Sep,4812,4601,211,4.4,"Franklin County, FL"
33,2015,Oct,4759,4546,213,4.5,"Franklin County, FL"
34,2015,Nov,4711,4495,216,4.6,"Franklin County, FL"
35,2015,Dec,4649,4442,207,4.5,"Franklin County, FL"
36,2016,Jan,4665,4433,232,5.0,"Franklin County, FL"
37,2016,Feb,4716,4503,213,4.5,"Franklin County, FL"
38,2016,Mar,4766,4554,212,4.4,"Franklin County, FL"
39,2016,Apr,4812,4611,201,4.2,"Franklin County, FL"
40,2016,May,4884,4686,198,4.1,"Franklin County, FL"
41,2016,Jun,4931,4717,214,4.3,"Franklin County, FL"
42,2016,Jul,4805,4584,221,4.6,"Franklin County, FL"
43,2016,Aug,4790,4577,213,4.4,"Franklin County, FL"
44,2016,Sep,4725,4526,199,4.2,"Franklin County, FL"
45,2016,Oct,4701,4501,200,4.3,"Franklin County, FL"
46,2016,Nov,4635,4444,191,4.1,"Franklin County, FL"
47,2016,Dec,4584,4388,196,4.3,"Franklin County, FL"
48,2017,Jan,4467,4251,216,4.8,"Franklin County, FL"
49,2017,Feb,4499,4296,203,4.5,"Franklin County, FL"
50,2017,Mar,4589,4414,175,3.8,"Franklin County, FL"
51,2017,Apr,4675,4514,161,3.4,"Franklin County, FL"
52,2017,May,4765,4598,167,3.5,"Franklin County, FL"
53,2017,Jun,4803,4635,168,3.5,"Franklin County, FL"
54,2017,Jul,4821,4653,168,3.5,"Franklin County, FL"
55,2017,Aug,4790,4617,173,3.6,"Franklin County, FL"
56,2017,Sep,4768,4612,156,3.3,"Franklin County, FL"
57,2017,Oct,4639,4490,149,3.2,"Franklin County, FL"
58,2017,Nov,4635,4475,160,3.5,"Franklin County, FL"
59,2017,Dec,4506,4348,158,3.5,"Franklin County, FL"
60,2018,Jan,4550,4381,169,3.7,"Franklin County, FL"
61,2018,Feb,4606,4448,158,3.4,"Franklin County, FL"
62,2018,Mar,4743,4601,142,3.0,"Franklin County, FL"
63,2018,Apr,4771,4639,132,2.8,"Franklin County, FL"
64,2018,May,4832,4696,136,2.8,"Franklin County, FL"
65,2018,Jun,5003,4840,163,3.3,"Franklin County, FL"
66,2018,Jul,4874,4715,159,3.3,"Franklin County, FL"
67,2018,Aug,4801,4637,164,3.4,"Franklin County, FL"
68,2018,Sep,4769,4624,145,3.0,"Franklin County, FL"
69,2018,Oct,4406,4257,149,3.4,"Franklin County, FL"
70,2018,Nov,4504,4241,263,5.8,"Franklin County, FL"
71,2018,Dec,4483,4253,230,5.1,"Franklin County, FL"
72,2019,Jan,4459,4219,240,5.4,"Franklin County, FL"
73,2019,Feb,4446,4240,206,4.6,"Franklin County, FL"
74,2019,Mar,4576,4386,190,4.2,"Franklin County, FL"
75,2019,Apr,4631,4469,162,3.5,"Franklin County, FL"
76,2019,May,4750,4585,165,3.5,"Franklin County, FL"
77,2019,Jun,4867,4693,174,3.6,"Franklin County, FL"
78,2019,Jul,4704,4529,175,3.7,"Franklin County, FL"
79,2019,Aug,4702,4525,177,3.8,"Franklin County, FL"
80,2019,Sep,4668,4521,147,3.1,"Franklin County, FL"
81,2019,Oct,4667,4524,143,3.1,"Franklin County, FL"
82,2019,Nov,4630,4490,140,3.0,"Franklin County, FL"
83,2019,Dec,4543,4413,130,2.9,"Franklin County, FL"
84,2020,Jan,4582,4439,143,3.1,"Franklin County, FL"
85,2020,Feb,4666,4538,128,2.7,"Franklin County, FL"
86,2020,Mar,4685,4508,177,3.8,"Franklin County, FL"
87,2020,Apr,4192,3749,443,10.6,"Franklin County, FL"
88,2020,May,4629,4194,435,9.4,"Franklin County, FL"
89,2020,Jun,4786,4460,326,6.8,"Franklin County, FL"
90,2020,Jul,4767,4429,338,7.1,"Franklin County, FL"
91,2020,Aug,4801,4548,253,5.3,"Franklin County, FL"
92,2020,Sep,4804,4565,239,5.0,"Franklin County, FL"
93,2020,Oct,4764,4533,231,4.8,"Franklin County, FL"
94,2020,Nov,4641,4406,235,5.1,"Franklin County, FL"
95,2020,Dec,4583,4366,217,4.7,"Franklin County, FL"
96,2021,Jan,4522,4296,226,5.0,"Franklin County, FL"
97,2021,Feb,4522,4315,207,4.6,"Franklin County, FL"
98,2021,Mar,4663,4471,192,4.1,"Franklin County, FL"
99,2021,Apr,4792,4618,174,3.6,"Franklin County, FL"
100,2021,May,4843,4680,163,3.4,"Franklin County, FL"
101,2021,Jun,4940,4739,201,4.1,"Franklin County, FL"
102,2021,Jul,4863,4663,200,4.1,"Franklin County, FL"
103,2021,Aug,4763,4566,197,4.1,"Franklin County, FL"
104,2021,Sep,4703,4533,170,3.6,"Franklin County, FL"
105,2021,Oct,4742,4575,167,3.5,"Franklin County, FL"
106,2021,Nov,4628,4471,157,3.4,"Franklin County, FL"
107,2021,Dec,4584,4443,141,3.1,"Franklin County, FL"
108,2022,Jan,4691,4503,188,4.0,"Franklin County, FL"
109,2022,Feb,4687,4521,166,3.5,"Franklin County, FL"
110,2022,Mar,4812,4671,141,2.9,"Franklin County, FL"
111,2022,Apr,4865,4744,121,2.5,"Franklin County, FL"
112,2022,May,4934,4817,117,2.4,"Franklin County, FL"
113,2022,Jun,4983,4844,139,2.8,"Franklin County, FL"
114,2022,Jul,4923,4798,125,2.5,"Franklin County, FL"
115,2022,Aug,4868,4743,125,2.6,"Franklin County, FL"
116,2022,Sep,4888,4769,119,2.4,"Franklin County, FL"
117,2022,Oct,4810,4687,123,2.6,"Franklin County, FL"
118,2022,Nov,4723,4607,116,2.5,"Franklin County, FL"
119,2022,Dec,4709,4599,110,2.3,"Franklin County, FL"
120,2023,Jan,4743,4619,124,2.6,"Franklin County, FL"
121,2023,Feb,4798,4677,121,2.5,"Franklin County, FL"
122,2023,Mar,4939,4809,130,2.6,"Franklin County, FL"
123,2023,Apr,5015,4911,104,2.1,"Franklin County, FL"
124,2023,May,5002,4878,124,2.5,"Franklin County, FL"
125,2023,Jun,5098,4970,128,2.5,"Franklin County, FL"
126,2023,Jul,5097,4942,155,3.0,"Franklin County, FL"
127,2023,Aug,5084,4930,154,3.0,"Franklin County, FL"
128,2023,Sep,5042,4899,143,2.8,"Franklin County, FL"
129,2023,Oct,5040,4895,145,2.9,"Franklin County, FL"
0,2013,Jan,101788,90441,11347,11.1,"Yolo County, CA"
1,2013,Feb,102105,91336,10769,10.5,"Yolo County, CA"
2,2013,Mar,102208,92057,10151,9.9,"Yolo County, CA"
3,2013,Apr,101140,92066,9074,9.0,"Yolo County, CA"
4,2013,May,101605,93010,8595,8.5,"Yolo County, CA"
5,2013,Jun,102285,92889,9396,9.2,"Yolo County, CA"
6,2013,Jul,102427,93158,9269,9.0,"Yolo County, CA"
7,2013,Aug,101463,92763,8700,8.6,"Yolo County, CA"
8,2013,Sep,101090,92924,8166,8.1,"Yolo County, CA"
9,2013,Oct,100554,92094,8460,8.4,"Yolo County, CA"
10,2013,Nov,100713,92080,8633,8.6,"Yolo County, CA"
11,2013,Dec,100331,91803,8528,8.5,"Yolo County, CA"
12,2014,Jan,101185,91874,9311,9.2,"Yolo County, CA"
13,2014,Feb,101533,92228,9305,9.2,"Yolo County, CA"
14,2014,Mar,102117,92918,9199,9.0,"Yolo County, CA"
15,2014,Apr,101287,93717,7570,7.5,"Yolo County, CA"
16,2014,May,102097,94990,7107,7.0,"Yolo County, CA"
17,2014,Jun,102836,95349,7487,7.3,"Yolo County, CA"
18,2014,Jul,103465,95663,7802,7.5,"Yolo County, CA"
19,2014,Aug,102289,94891,7398,7.2,"Yolo County, CA"
20,2014,Sep,101756,95052,6704,6.6,"Yolo County, CA"
21,2014,Oct,102118,95301,6817,6.7,"Yolo County, CA"
22,2014,Nov,102039,94759,7280,7.1,"Yolo County, CA"
23,2014,Dec,101614,94358,7256,7.1,"Yolo County, CA"
24,2015,Jan,103852,95608,8244,7.9,"Yolo County, CA"
25,2015,Feb,103994,96067,7927,7.6,"Yolo County, CA"
26,2015,Mar,104338,96748,7590,7.3,"Yolo County, CA"
27,2015,Apr,103611,97080,6531,6.3,"Yolo County, CA"
28,2015,May,103891,97559,6332,6.1,"Yolo County, CA"
29,2015,Jun,104544,97865,6679,6.4,"Yolo County, CA"
30,2015,Jul,105007,98308,6699,6.4,"Yolo County, CA"
31,2015,Aug,104175,97906,6269,6.0,"Yolo County, CA"
32,2015,Sep,103461,97728,5733,5.5,"Yolo County, CA"
33,2015,Oct,103960,97831,6129,5.9,"Yolo County, CA"
34,2015,Nov,104228,97733,6495,6.2,"Yolo County, CA"
35,2015,Dec,104782,98173,6609,6.3,"Yolo County, CA"
36,2016,Jan,105658,98322,7336,6.9,"Yolo County, CA"
37,2016,Feb,106453,99211,7242,6.8,"Yolo County, CA"
38,2016,Mar,106521,99271,7250,6.8,"Yolo County, CA"
39,2016,Apr,105407,99346,6061,5.8,"Yolo County, CA"
40,2016,May,105272,99949,5323,5.1,"Yolo County, CA"
41,2016,Jun,106691,100441,6250,5.9,"Yolo County, CA"
42,2016,Jul,107854,101596,6258,5.8,"Yolo County, CA"
43,2016,Aug,106796,100884,5912,5.5,"Yolo County, CA"
44,2016,Sep,106230,100703,5527,5.2,"Yolo County, CA"
45,2016,Oct,105685,99922,5763,5.5,"Yolo County, CA"
46,2016,Nov,105330,99382,5948,5.6,"Yolo County, CA"
47,2016,Dec,105043,98721,6322,6.0,"Yolo County, CA"
48,2017,Jan,106113,98947,7166,6.8,"Yolo County, CA"
49,2017,Feb,106444,99454,6990,6.6,"Yolo County, CA"
50,2017,Mar,106919,100474,6445,6.0,"Yolo County, CA"
51,2017,Apr,106202,100636,5566,5.2,"Yolo County, CA"
52,2017,May,106249,101494,4755,4.5,"Yolo County, CA"
53,2017,Jun,107045,101609,5436,5.1,"Yolo County, CA"
54,2017,Jul,107906,102356,5550,5.1,"Yolo County, CA"
55,2017,Aug,106882,101653,5229,4.9,"Yolo County, CA"
56,2017,Sep,106552,102040,4512,4.2,"Yolo County, CA"
57,2017,Oct,106095,101661,4434,4.2,"Yolo County, CA"
58,2017,Nov,106091,101357,4734,4.5,"Yolo County, CA"
59,2017,Dec,106271,101314,4957,4.7,"Yolo County, CA"
60,2018,Jan,106217,100555,5662,5.3,"Yolo County, CA"
61,2018,Feb,107510,101855,5655,5.3,"Yolo County, CA"
62,2018,Mar,107385,102002,5383,5.0,"Yolo County, CA"
63,2018,Apr,106760,102244,4516,4.2,"Yolo County, CA"
64,2018,May,107211,103382,3829,3.6,"Yolo County, CA"
65,2018,Jun,107926,103304,4622,4.3,"Yolo County, CA"
66,2018,Jul,109014,104452,4562,4.2,"Yolo County, CA"
67,2018,Aug,108122,103842,4280,4.0,"Yolo County, CA"
68,2018,Sep,107709,103896,3813,3.5,"Yolo County, CA"
69,2018,Oct,107540,103567,3973,3.7,"Yolo County, CA"
70,2018,Nov,107338,103027,4311,4.0,"Yolo County, CA"
71,2018,Dec,107814,102936,4878,4.5,"Yolo County, CA"
72,2019,Jan,108083,102049,6034,5.6,"Yolo County, CA"
73,2019,Feb,108718,103118,5600,5.2,"Yolo County, CA"
74,2019,Mar,108602,103146,5456,5.0,"Yolo County, CA"
75,2019,Apr,107080,102887,4193,3.9,"Yolo County, CA"
76,2019,May,107384,103687,3697,3.4,"Yolo County, CA"
77,2019,Jun,107778,103459,4319,4.0,"Yolo County, CA"
78,2019,Jul,109323,104717,4606,4.2,"Yolo County, CA"
79,2019,Aug,108804,104630,4174,3.8,"Yolo County, CA"
80,2019,Sep,108367,104782,3585,3.3,"Yolo County, CA"
81,2019,Oct,108429,104692,3737,3.4,"Yolo County, CA"
82,2019,Nov,107605,103466,4139,3.8,"Yolo County, CA"
83,2019,Dec,107771,103323,4448,4.1,"Yolo County, CA"
84,2020,Jan,107752,102243,5509,5.1,"Yolo County, CA"
85,2020,Feb,108764,103487,5277,4.9,"Yolo County, CA"
86,2020,Mar,108560,101228,7332,6.8,"Yolo County, CA"
87,2020,Apr,101962,89674,12288,12.1,"Yolo County, CA"
88,2020,May,100496,89642,10854,10.8,"Yolo County, CA"
89,2020,Jun,104654,94410,10244,9.8,"Yolo County, CA"
90,2020,Jul,105653,95907,9746,9.2,"Yolo County, CA"
91,2020,Aug,104779,96844,7935,7.6,"Yolo County, CA"
92,2020,Sep,104544,97015,7529,7.2,"Yolo County, CA"
93,2020,Oct,104667,97891,6776,6.5,"Yolo County, CA"
94,2020,Nov,104046,96969,7077,6.8,"Yolo County, CA"
95,2020,Dec,104461,97096,7365,7.1,"Yolo County, CA"
96,2021,Jan,104967,97146,7821,7.5,"Yolo County, CA"
97,2021,Feb,106099,98194,7905,7.5,"Yolo County, CA"
98,2021,Mar,106226,98780,7446,7.0,"Yolo County, CA"
99,2021,Apr,105858,98997,6861,6.5,"Yolo County, CA"
100,2021,May,105889,99712,6177,5.8,"Yolo County, CA"
101,2021,Jun,106628,99695,6933,6.5,"Yolo County, CA"
102,2021,Jul,108343,101788,6555,6.1,"Yolo County, CA"
103,2021,Aug,107580,101483,6097,5.7,"Yolo County, CA"
104,2021,Sep,107042,101873,5169,4.8,"Yolo County, CA"
105,2021,Oct,107054,101954,5100,4.8,"Yolo County, CA"
106,2021,Nov,107057,102052,5005,4.7,"Yolo County, CA"
107,2021,Dec,107199,102297,4902,4.6,"Yolo County, CA"
108,2022,Jan,107563,101698,5865,5.5,"Yolo County, CA"
109,2022,Feb,108500,103032,5468,5.0,"Yolo County, CA"
110,2022,Mar,109085,104313,4772,4.4,"Yolo County, CA"
111,2022,Apr,108264,104155,4109,3.8,"Yolo County, CA"
112,2022,May,108538,104833,3705,3.4,"Yolo County, CA"
113,2022,Jun,108443,104079,4364,4.0,"Yolo County, CA"
114,2022,Jul,109897,105671,4226,3.8,"Yolo County, CA"
115,2022,Aug,109909,105752,4157,3.8,"Yolo County, CA"
116,2022,Sep,109372,105749,3623,3.3,"Yolo County, CA"
117,2022,Oct,109557,105645,3912,3.6,"Yolo County, CA"
118,2022,Nov,109313,104923,4390,4.0,"Yolo County, CA"
119,2022,Dec,109374,105067,4307,3.9,"Yolo County, CA"
120,2023,Jan,109200,103727,5473,5.0,"Yolo County, CA"
121,2023,Feb,110374,104744,5630,5.1,"Yolo County, CA"
122,2023,Mar,110989,105268,5721,5.2,"Yolo County, CA"
123,2023,Apr,110100,105318,4782,4.3,"Yolo County, CA"
124,2023,May,109863,105223,4640,4.2,"Yolo County, CA"
125,2023,Jun,109655,104393,5262,4.8,"Yolo County, CA"
126,2023,Jul,110806,105899,4907,4.4,"Yolo County, CA"
127,2023,Aug,110065,104918,5147,4.7,"Yolo County, CA"
128,2023,Sep,110436,105734,4702,4.3,"Yolo County, CA"
129,2023,Oct,110470,105560,4910,4.4,"Yolo County, CA"
0,2013,Jan,70112,63774,6338,9.0,"Napa County, CA"
1,2013,Feb,70888,65214,5674,8.0,"Napa County, CA"
2,2013,Mar,70871,65430,5441,7.7,"Napa County, CA"
3,2013,Apr,71521,66566,4955,6.9,"Napa County, CA"
4,2013,May,73721,69013,4708,6.4,"Napa County, CA"
5,2013,Jun,74136,69003,5133,6.9,"Napa County, CA"
6,2013,Jul,73925,68799,5126,6.9,"Napa County, CA"
7,2013,Aug,74125,69260,4865,6.6,"Napa County, CA"
8,2013,Sep,75152,70549,4603,6.1,"Napa County, CA"
9,2013,Oct,74462,69839,4623,6.2,"Napa County, CA"
10,2013,Nov,71402,66523,4879,6.8,"Napa County, CA"
11,2013,Dec,70150,65353,4797,6.8,"Napa County, CA"
12,2014,Jan,71285,66181,5104,7.2,"Napa County, CA"
13,2014,Feb,72228,67343,4885,6.8,"Napa County, CA"
14,2014,Mar,72935,68175,4760,6.5,"Napa County, CA"
15,2014,Apr,72982,69021,3961,5.4,"Napa County, CA"
16,2014,May,73912,70091,3821,5.2,"Napa County, CA"
17,2014,Jun,74348,70305,4043,5.4,"Napa County, CA"
18,2014,Jul,74189,69898,4291,5.8,"Napa County, CA"
19,2014,Aug,73945,69881,4064,5.5,"Napa County, CA"
20,2014,Sep,74917,71187,3730,5.0,"Napa County, CA"
21,2014,Oct,75659,71941,3718,4.9,"Napa County, CA"
22,2014,Nov,72022,67874,4148,5.8,"Napa County, CA"
23,2014,Dec,70680,66661,4019,5.7,"Napa County, CA"
24,2015,Jan,71986,67770,4216,5.9,"Napa County, CA"
25,2015,Feb,72849,69028,3821,5.2,"Napa County, CA"
26,2015,Mar,73087,69443,3644,5.0,"Napa County, CA"
27,2015,Apr,73956,70758,3198,4.3,"Napa County, CA"
28,2015,May,74970,71818,3152,4.2,"Napa County, CA"
29,2015,Jun,74882,71616,3266,4.4,"Napa County, CA"
30,2015,Jul,74759,71373,3386,4.5,"Napa County, CA"
31,2015,Aug,74950,71752,3198,4.3,"Napa County, CA"
32,2015,Sep,75447,72550,2897,3.8,"Napa County, CA"
33,2015,Oct,74223,71028,3195,4.3,"Napa County, CA"
34,2015,Nov,72362,68798,3564,4.9,"Napa County, CA"
35,2015,Dec,71132,67543,3589,5.0,"Napa County, CA"
36,2016,Jan,71016,67361,3655,5.1,"Napa County, CA"
37,2016,Feb,72537,69082,3455,4.8,"Napa County, CA"
38,2016,Mar,72496,69043,3453,4.8,"Napa County, CA"
39,2016,Apr,73038,70048,2990,4.1,"Napa County, CA"
40,2016,May,73581,70955,2626,3.6,"Napa County, CA"
41,2016,Jun,73838,70760,3078,4.2,"Napa County, CA"
42,2016,Jul,74333,71260,3073,4.1,"Napa County, CA"
43,2016,Aug,73863,70814,3049,4.1,"Napa County, CA"
44,2016,Sep,74329,71411,2918,3.9,"Napa County, CA"
45,2016,Oct,73982,71086,2896,3.9,"Napa County, CA"
46,2016,Nov,71611,68459,3152,4.4,"Napa County, CA"
47,2016,Dec,70657,67303,3354,4.7,"Napa County, CA"
48,2017,Jan,71224,67699,3525,4.9,"Napa County, CA"
49,2017,Feb,72595,69431,3164,4.4,"Napa County, CA"
50,2017,Mar,73197,70271,2926,4.0,"Napa County, CA"
51,2017,Apr,72909,70317,2592,3.6,"Napa County, CA"
52,2017,May,73962,71600,2362,3.2,"Napa County, CA"
53,2017,Jun,74534,71899,2635,3.5,"Napa County, CA"
54,2017,Jul,75329,72594,2735,3.6,"Napa County, CA"
55,2017,Aug,74489,71867,2622,3.5,"Napa County, CA"
56,2017,Sep,75485,73189,2296,3.0,"Napa County, CA"
57,2017,Oct,72974,70620,2354,3.2,"Napa County, CA"
58,2017,Nov,71546,69107,2439,3.4,"Napa County, CA"
59,2017,Dec,70592,67990,2602,3.7,"Napa County, CA"
60,2018,Jan,71445,68622,2823,4.0,"Napa County, CA"
61,2018,Feb,73531,71026,2505,3.4,"Napa County, CA"
62,2018,Mar,73355,70993,2362,3.2,"Napa County, CA"
63,2018,Apr,73292,71183,2109,2.9,"Napa County, CA"
64,2018,May,74724,72913,1811,2.4,"Napa County, CA"
65,2018,Jun,75038,72847,2191,2.9,"Napa County, CA"
66,2018,Jul,75518,73342,2176,2.9,"Napa County, CA"
67,2018,Aug,74490,72434,2056,2.8,"Napa County, CA"
68,2018,Sep,75364,73467,1897,2.5,"Napa County, CA"
69,2018,Oct,75057,73124,1933,2.6,"Napa County, CA"
70,2018,Nov,72609,70630,1979,2.7,"Napa County, CA"
71,2018,Dec,70958,68576,2382,3.4,"Napa County, CA"
72,2019,Jan,71148,68229,2919,4.1,"Napa County, CA"
73,2019,Feb,72887,70437,2450,3.4,"Napa County, CA"
74,2019,Mar,73199,70802,2397,3.3,"Napa County, CA"
75,2019,Apr,72294,70368,1926,2.7,"Napa County, CA"
76,2019,May,74083,72363,1720,2.3,"Napa County, CA"
77,2019,Jun,74642,72594,2048,2.7,"Napa County, CA"
78,2019,Jul,75527,73329,2198,2.9,"Napa County, CA"
79,2019,Aug,74793,72791,2002,2.7,"Napa County, CA"
80,2019,Sep,75044,73313,1731,2.3,"Napa County, CA"
81,2019,Oct,74823,72992,1831,2.4,"Napa County, CA"
82,2019,Nov,71750,69764,1986,2.8,"Napa County, CA"
83,2019,Dec,70345,68191,2154,3.1,"Napa County, CA"
84,2020,Jan,70855,68285,2570,3.6,"Napa County, CA"
85,2020,Feb,73157,70825,2332,3.2,"Napa County, CA"
86,2020,Mar,71847,68506,3341,4.7,"Napa County, CA"
87,2020,Apr,66896,54816,12080,18.1,"Napa County, CA"
88,2020,May,68156,57583,10573,15.5,"Napa County, CA"
89,2020,Jun,70936,62252,8684,12.2,"Napa County, CA"
90,2020,Jul,70389,62843,7546,10.7,"Napa County, CA"
91,2020,Aug,69176,63045,6131,8.9,"Napa County, CA"
92,2020,Sep,68972,63307,5665,8.2,"Napa County, CA"
93,2020,Oct,67565,62541,5024,7.4,"Napa County, CA"
94,2020,Nov,65663,60679,4984,7.6,"Napa County, CA"
95,2020,Dec,64686,59535,5151,8.0,"Napa County, CA"
96,2021,Jan,64943,58674,6269,9.7,"Napa County, CA"
97,2021,Feb,67172,61873,5299,7.9,"Napa County, CA"
98,2021,Mar,67986,63134,4852,7.1,"Napa County, CA"
99,2021,Apr,68117,63491,4626,6.8,"Napa County, CA"
100,2021,May,69543,65402,4141,6.0,"Napa County, CA"
101,2021,Jun,70113,65595,4518,6.4,"Napa County, CA"
102,2021,Jul,70268,66118,4150,5.9,"Napa County, CA"
103,2021,Aug,69858,66008,3850,5.5,"Napa County, CA"
104,2021,Sep,70557,67334,3223,4.6,"Napa County, CA"
105,2021,Oct,69883,66760,3123,4.5,"Napa County, CA"
106,2021,Nov,67531,64543,2988,4.4,"Napa County, CA"
107,2021,Dec,66689,63797,2892,4.3,"Napa County, CA"
108,2022,Jan,67967,64709,3258,4.8,"Napa County, CA"
109,2022,Feb,69471,66659,2812,4.0,"Napa County, CA"
110,2022,Mar,70097,67622,2475,3.5,"Napa County, CA"
111,2022,Apr,70309,68227,2082,3.0,"Napa County, CA"
112,2022,May,71825,69975,1850,2.6,"Napa County, CA"
113,2022,Jun,72142,69982,2160,3.0,"Napa County, CA"
114,2022,Jul,72435,70352,2083,2.9,"Napa County, CA"
115,2022,Aug,71999,69856,2143,3.0,"Napa County, CA"
116,2022,Sep,73217,71276,1941,2.7,"Napa County, CA"
117,2022,Oct,72278,70189,2089,2.9,"Napa County, CA"
118,2022,Nov,70289,68052,2237,3.2,"Napa County, CA"
119,2022,Dec,69987,67789,2198,3.1,"Napa County, CA"
120,2023,Jan,70663,67896,2767,3.9,"Napa County, CA"
121,2023,Feb,71827,69093,2734,3.8,"Napa County, CA"
122,2023,Mar,72169,69516,2653,3.7,"Napa County, CA"
123,2023,Apr,71420,69127,2293,3.2,"Napa County, CA"
124,2023,May,72098,69827,2271,3.1,"Napa County, CA"
125,2023,Jun,72142,69620,2522,3.5,"Napa County, CA"
126,2023,Jul,72600,70181,2419,3.3,"Napa County, CA"
127,2023,Aug,71543,68939,2604,3.6,"Napa County, CA"
128,2023,Sep,72151,69659,2492,3.5,"Napa County, CA"
129,2023,Oct,71476,68983,2493,3.5,"Napa County, CA"
0,2013,Jan,444320,422943,21377,4.8,"Honolulu County/city, HI"
1,2013,Feb,447022,427343,19679,4.4,"Honolulu County/city, HI"
2,2013,Mar,446484,427745,18739,4.2,"Honolulu County/city, HI"
3,2013,Apr,447073,429160,17913,4.0,"Honolulu County/city, HI"
4,2013,May,449242,430805,18437,4.1,"Honolulu County/city, HI"
5,2013,Jun,449869,427862,22007,4.9,"Honolulu County/city, HI"
6,2013,Jul,448298,428977,19321,4.3,"Honolulu County/city, HI"
7,2013,Aug,445147,426366,18781,4.2,"Honolulu County/city, HI"
8,2013,Sep,447966,427728,20238,4.5,"Honolulu County/city, HI"
9,2013,Oct,449070,428723,20347,4.5,"Honolulu County/city, HI"
10,2013,Nov,454750,435185,19565,4.3,"Honolulu County/city, HI"
11,2013,Dec,455345,437632,17713,3.9,"Honolulu County/city, HI"
12,2014,Jan,456515,437120,19395,4.2,"Honolulu County/city, HI"
13,2014,Feb,456166,437245,18921,4.1,"Honolulu County/city, HI"
14,2014,Mar,458925,440336,18589,4.1,"Honolulu County/city, HI"
15,2014,Apr,457471,440118,17353,3.8,"Honolulu County/city, HI"
16,2014,May,457508,439428,18080,4.0,"Honolulu County/city, HI"
17,2014,Jun,457344,436538,20806,4.5,"Honolulu County/city, HI"
18,2014,Jul,456687,437899,18788,4.1,"Honolulu County/city, HI"
19,2014,Aug,453217,435213,18004,4.0,"Honolulu County/city, HI"
20,2014,Sep,454358,436113,18245,4.0,"Honolulu County/city, HI"
21,2014,Oct,456632,439427,17205,3.8,"Honolulu County/city, HI"
22,2014,Nov,460924,443637,17287,3.8,"Honolulu County/city, HI"
23,2014,Dec,459089,443552,15537,3.4,"Honolulu County/city, HI"
24,2015,Jan,461814,444263,17551,3.8,"Honolulu County/city, HI"
25,2015,Feb,460907,445005,15902,3.5,"Honolulu County/city, HI"
26,2015,Mar,461532,446469,15063,3.3,"Honolulu County/city, HI"
27,2015,Apr,462196,447410,14786,3.2,"Honolulu County/city, HI"
28,2015,May,462420,446994,15426,3.3,"Honolulu County/city, HI"
29,2015,Jun,460028,442577,17451,3.8,"Honolulu County/city, HI"
30,2015,Jul,456927,442733,14194,3.1,"Honolulu County/city, HI"
31,2015,Aug,457616,443469,14147,3.1,"Honolulu County/city, HI"
32,2015,Sep,456591,441565,15026,3.3,"Honolulu County/city, HI"
33,2015,Oct,458973,445292,13681,3.0,"Honolulu County/city, HI"
34,2015,Nov,463809,450204,13605,2.9,"Honolulu County/city, HI"
35,2015,Dec,464452,452172,12280,2.6,"Honolulu County/city, HI"
36,2016,Jan,463473,450165,13308,2.9,"Honolulu County/city, HI"
37,2016,Feb,463800,451203,12597,2.7,"Honolulu County/city, HI"
38,2016,Mar,465666,452974,12692,2.7,"Honolulu County/city, HI"
39,2016,Apr,463229,450654,12575,2.7,"Honolulu County/city, HI"
40,2016,May,462273,450112,12161,2.6,"Honolulu County/city, HI"
41,2016,Jun,462527,446895,15632,3.4,"Honolulu County/city, HI"
42,2016,Jul,462116,449394,12722,2.8,"Honolulu County/city, HI"
43,2016,Aug,459966,447842,12124,2.6,"Honolulu County/city, HI"
44,2016,Sep,463826,450566,13260,2.9,"Honolulu County/city, HI"
45,2016,Oct,463449,451227,12222,2.6,"Honolulu County/city, HI"
46,2016,Nov,466339,454866,11473,2.5,"Honolulu County/city, HI"
47,2016,Dec,463769,453039,10730,2.3,"Honolulu County/city, HI"
48,2017,Jan,477423,464900,12523,2.6,"Honolulu County/city, HI"
49,2017,Feb,477489,466022,11467,2.4,"Honolulu County/city, HI"
50,2017,Mar,479067,468366,10701,2.2,"Honolulu County/city, HI"
51,2017,Apr,477371,467236,10135,2.1,"Honolulu County/city, HI"
52,2017,May,473014,462957,10057,2.1,"Honolulu County/city, HI"
53,2017,Jun,472317,459789,12528,2.7,"Honolulu County/city, HI"
54,2017,Jul,472250,462380,9870,2.1,"Honolulu County/city, HI"
55,2017,Aug,466477,456998,9479,2.0,"Honolulu County/city, HI"
56,2017,Sep,470240,460989,9251,2.0,"Honolulu County/city, HI"
57,2017,Oct,466048,457959,8089,1.7,"Honolulu County/city, HI"
58,2017,Nov,470392,461570,8822,1.9,"Honolulu County/city, HI"
59,2017,Dec,469011,461205,7806,1.7,"Honolulu County/city, HI"
60,2018,Jan,471867,462075,9792,2.1,"Honolulu County/city, HI"
61,2018,Feb,474063,464589,9474,2.0,"Honolulu County/city, HI"
62,2018,Mar,474176,464469,9707,2.0,"Honolulu County/city, HI"
63,2018,Apr,473904,464205,9699,2.0,"Honolulu County/city, HI"
64,2018,May,471027,461520,9507,2.0,"Honolulu County/city, HI"
65,2018,Jun,471379,457902,13477,2.9,"Honolulu County/city, HI"
66,2018,Jul,469077,458343,10734,2.3,"Honolulu County/city, HI"
67,2018,Aug,464593,453443,11150,2.4,"Honolulu County/city, HI"
68,2018,Sep,465133,453132,12001,2.6,"Honolulu County/city, HI"
69,2018,Oct,465478,453979,11499,2.5,"Honolulu County/city, HI"
70,2018,Nov,469483,457642,11841,2.5,"Honolulu County/city, HI"
71,2018,Dec,467263,456067,11196,2.4,"Honolulu County/city, HI"
72,2019,Jan,466445,453419,13026,2.8,"Honolulu County/city, HI"
73,2019,Feb,466481,455144,11337,2.4,"Honolulu County/city, HI"
74,2019,Mar,467101,455467,11634,2.5,"Honolulu County/city, HI"
75,2019,Apr,463500,452819,10681,2.3,"Honolulu County/city, HI"
76,2019,May,460276,449788,10488,2.3,"Honolulu County/city, HI"
77,2019,Jun,462437,448707,13730,3.0,"Honolulu County/city, HI"
78,2019,Jul,463254,451743,11511,2.5,"Honolulu County/city, HI"
79,2019,Aug,462660,451585,11075,2.4,"Honolulu County/city, HI"
80,2019,Sep,463340,452064,11276,2.4,"Honolulu County/city, HI"
81,2019,Oct,466712,456362,10350,2.2,"Honolulu County/city, HI"
82,2019,Nov,468541,458324,10217,2.2,"Honolulu County/city, HI"
83,2019,Dec,467414,458500,8914,1.9,"Honolulu County/city, HI"
84,2020,Jan,471179,460838,10341,2.2,"Honolulu County/city, HI"
85,2020,Feb,471854,463108,8746,1.9,"Honolulu County/city, HI"
86,2020,Mar,466101,456810,9291,2.0,"Honolulu County/city, HI"
87,2020,Apr,436923,353189,83734,19.2,"Honolulu County/city, HI"
88,2020,May,440875,359009,81866,18.6,"Honolulu County/city, HI"
89,2020,Jun,448712,378408,70304,15.7,"Honolulu County/city, HI"
90,2020,Jul,456708,394826,61882,13.5,"Honolulu County/city, HI"
91,2020,Aug,457491,406621,50870,11.1,"Honolulu County/city, HI"
92,2020,Sep,420172,368078,52094,12.4,"Honolulu County/city, HI"
93,2020,Oct,437930,394227,43703,10.0,"Honolulu County/city, HI"
94,2020,Nov,447167,405485,41682,9.3,"Honolulu County/city, HI"
95,2020,Dec,452718,411501,41217,9.1,"Honolulu County/city, HI"
96,2021,Jan,455505,415914,39591,8.7,"Honolulu County/city, HI"
97,2021,Feb,459194,421818,37376,8.1,"Honolulu County/city, HI"
98,2021,Mar,459292,424951,34341,7.5,"Honolulu County/city, HI"
99,2021,Apr,457500,425862,31638,6.9,"Honolulu County/city, HI"
100,2021,May,452757,425164,27593,6.1,"Honolulu County/city, HI"
101,2021,Jun,454991,425536,29455,6.5,"Honolulu County/city, HI"
102,2021,Jul,453044,429542,23502,5.2,"Honolulu County/city, HI"
103,2021,Aug,448393,427601,20792,4.6,"Honolulu County/city, HI"
104,2021,Sep,446681,428491,18190,4.1,"Honolulu County/city, HI"
105,2021,Oct,444843,430115,14728,3.3,"Honolulu County/city, HI"
106,2021,Nov,448912,435131,13781,3.1,"Honolulu County/city, HI"
107,2021,Dec,449822,437594,12228,2.7,"Honolulu County/city, HI"
108,2022,Jan,452394,438066,14328,3.2,"Honolulu County/city, HI"
109,2022,Feb,453922,440042,13880,3.1,"Honolulu County/city, HI"
110,2022,Mar,455050,441503,13547,3.0,"Honolulu County/city, HI"
111,2022,Apr,456729,442563,14166,3.1,"Honolulu County/city, HI"
112,2022,May,456871,442258,14613,3.2,"Honolulu County/city, HI"
113,2022,Jun,458953,440657,18296,4.0,"Honolulu County/city, HI"
114,2022,Jul,460747,444555,16192,3.5,"Honolulu County/city, HI"
115,2022,Aug,460437,443266,17171,3.7,"Honolulu County/city, HI"
116,2022,Sep,459637,442729,16908,3.7,"Honolulu County/city, HI"
117,2022,Oct,460380,442995,17385,3.8,"Honolulu County/city, HI"
118,2022,Nov,460910,443133,17777,3.9,"Honolulu County/city, HI"
119,2022,Dec,461503,445727,15776,3.4,"Honolulu County/city, HI"
120,2023,Jan,458068,443991,14077,3.1,"Honolulu County/city, HI"
121,2023,Feb,459022,444769,14253,3.1,"Honolulu County/city, HI"
122,2023,Mar,460336,446951,13385,2.9,"Honolulu County/city, HI"
123,2023,Apr,460911,448852,12059,2.6,"Honolulu County/city, HI"
124,2023,May,455560,443906,11654,2.6,"Honolulu County/city, HI"
125,2023,Jun,458450,443464,14986,3.3,"Honolulu County/city, HI"
126,2023,Jul,455782,443870,11912,2.6,"Honolulu County/city, HI"
127,2023,Aug,453545,440744,12801,2.8,"Honolulu County/city, HI"
128,2023,Sep,455174,443482,11692,2.6,"Honolulu County/city, HI"
129,2023,Oct,455651,444328,11323,2.5,"Honolulu County/city, HI"
0,2013,Jan,71993,66399,5594,7.8,"Santa Rosa County, FL"
1,2013,Feb,71568,66496,5072,7.1,"Santa Rosa County, FL"
2,2013,Mar,72027,67190,4837,6.7,"Santa Rosa County, FL"
3,2013,Apr,72132,67569,4563,6.3,"Santa Rosa County, FL"
4,2013,May,73128,68412,4716,6.4,"Santa Rosa County, FL"
5,2013,Jun,73940,68620,5320,7.2,"Santa Rosa County, FL"
6,2013,Jul,74537,69267,5270,7.1,"Santa Rosa County, FL"
7,2013,Aug,74302,69343,4959,6.7,"Santa Rosa County, FL"
8,2013,Sep,73951,69205,4746,6.4,"Santa Rosa County, FL"
9,2013,Oct,72767,68203,4564,6.3,"Santa Rosa County, FL"
10,2013,Nov,71893,67420,4473,6.2,"Santa Rosa County, FL"
11,2013,Dec,71756,67489,4267,5.9,"Santa Rosa County, FL"
12,2014,Jan,71868,67277,4591,6.4,"Santa Rosa County, FL"
13,2014,Feb,71988,67576,4412,6.1,"Santa Rosa County, FL"
14,2014,Mar,72587,68292,4295,5.9,"Santa Rosa County, FL"
15,2014,Apr,72505,68714,3791,5.2,"Santa Rosa County, FL"
16,2014,May,73486,69415,4071,5.5,"Santa Rosa County, FL"
17,2014,Jun,73739,69370,4369,5.9,"Santa Rosa County, FL"
18,2014,Jul,74377,69808,4569,6.1,"Santa Rosa County, FL"
19,2014,Aug,74106,69840,4266,5.8,"Santa Rosa County, FL"
20,2014,Sep,73862,69930,3932,5.3,"Santa Rosa County, FL"
21,2014,Oct,73398,69625,3773,5.1,"Santa Rosa County, FL"
22,2014,Nov,72210,68467,3743,5.2,"Santa Rosa County, FL"
23,2014,Dec,71764,68256,3508,4.9,"Santa Rosa County, FL"
24,2015,Jan,72759,68817,3942,5.4,"Santa Rosa County, FL"
25,2015,Feb,72576,68961,3615,5.0,"Santa Rosa County, FL"
26,2015,Mar,72990,69549,3441,4.7,"Santa Rosa County, FL"
27,2015,Apr,74005,70599,3406,4.6,"Santa Rosa County, FL"
28,2015,May,75015,71406,3609,4.8,"Santa Rosa County, FL"
29,2015,Jun,75271,71407,3864,5.1,"Santa Rosa County, FL"
30,2015,Jul,75596,71611,3985,5.3,"Santa Rosa County, FL"
31,2015,Aug,75634,71885,3749,5.0,"Santa Rosa County, FL"
32,2015,Sep,75106,71577,3529,4.7,"Santa Rosa County, FL"
33,2015,Oct,74636,71164,3472,4.7,"Santa Rosa County, FL"
34,2015,Nov,73760,70265,3495,4.7,"Santa Rosa County, FL"
35,2015,Dec,73599,70220,3379,4.6,"Santa Rosa County, FL"
36,2016,Jan,74405,70751,3654,4.9,"Santa Rosa County, FL"
37,2016,Feb,74775,71444,3331,4.5,"Santa Rosa County, FL"
38,2016,Mar,75610,72272,3338,4.4,"Santa Rosa County, FL"
39,2016,Apr,75551,72349,3202,4.2,"Santa Rosa County, FL"
40,2016,May,76557,73380,3177,4.1,"Santa Rosa County, FL"
41,2016,Jun,77019,73310,3709,4.8,"Santa Rosa County, FL"
42,2016,Jul,77499,73683,3816,4.9,"Santa Rosa County, FL"
43,2016,Aug,77797,74120,3677,4.7,"Santa Rosa County, FL"
44,2016,Sep,77889,74248,3641,4.7,"Santa Rosa County, FL"
45,2016,Oct,77365,73854,3511,4.5,"Santa Rosa County, FL"
46,2016,Nov,76340,72922,3418,4.5,"Santa Rosa County, FL"
47,2016,Dec,75647,72376,3271,4.3,"Santa Rosa County, FL"
48,2017,Jan,76959,73331,3628,4.7,"Santa Rosa County, FL"
49,2017,Feb,77312,74037,3275,4.2,"Santa Rosa County, FL"
50,2017,Mar,77852,74792,3060,3.9,"Santa Rosa County, FL"
51,2017,Apr,78087,75216,2871,3.7,"Santa Rosa County, FL"
52,2017,May,78401,75463,2938,3.7,"Santa Rosa County, FL"
53,2017,Jun,79254,75919,3335,4.2,"Santa Rosa County, FL"
54,2017,Jul,79358,75983,3375,4.3,"Santa Rosa County, FL"
55,2017,Aug,79151,75844,3307,4.2,"Santa Rosa County, FL"
56,2017,Sep,80356,77409,2947,3.7,"Santa Rosa County, FL"
57,2017,Oct,78822,75939,2883,3.7,"Santa Rosa County, FL"
58,2017,Nov,78104,75186,2918,3.7,"Santa Rosa County, FL"
59,2017,Dec,77381,74658,2723,3.5,"Santa Rosa County, FL"
60,2018,Jan,78983,75722,3261,4.1,"Santa Rosa County, FL"
61,2018,Feb,79460,76577,2883,3.6,"Santa Rosa County, FL"
62,2018,Mar,79738,77017,2721,3.4,"Santa Rosa County, FL"
63,2018,Apr,80340,77788,2552,3.2,"Santa Rosa County, FL"
64,2018,May,80981,78471,2510,3.1,"Santa Rosa County, FL"
65,2018,Jun,81916,78841,3075,3.8,"Santa Rosa County, FL"
66,2018,Jul,82515,79464,3051,3.7,"Santa Rosa County, FL"
67,2018,Aug,81966,79144,2822,3.4,"Santa Rosa County, FL"
68,2018,Sep,81886,79316,2570,3.1,"Santa Rosa County, FL"
69,2018,Oct,81309,78730,2579,3.2,"Santa Rosa County, FL"
70,2018,Nov,80610,78116,2494,3.1,"Santa Rosa County, FL"
71,2018,Dec,80035,77494,2541,3.2,"Santa Rosa County, FL"
72,2019,Jan,81543,78541,3002,3.7,"Santa Rosa County, FL"
73,2019,Feb,81687,79144,2543,3.1,"Santa Rosa County, FL"
74,2019,Mar,82225,79708,2517,3.1,"Santa Rosa County, FL"
75,2019,Apr,82451,80218,2233,2.7,"Santa Rosa County, FL"
76,2019,May,83226,80908,2318,2.8,"Santa Rosa County, FL"
77,2019,Jun,83888,81094,2794,3.3,"Santa Rosa County, FL"
78,2019,Jul,84756,81846,2910,3.4,"Santa Rosa County, FL"
79,2019,Aug,84356,81651,2705,3.2,"Santa Rosa County, FL"
80,2019,Sep,84406,82021,2385,2.8,"Santa Rosa County, FL"
81,2019,Oct,84360,81958,2402,2.8,"Santa Rosa County, FL"
82,2019,Nov,83691,81355,2336,2.8,"Santa Rosa County, FL"
83,2019,Dec,83137,80944,2193,2.6,"Santa Rosa County, FL"
84,2020,Jan,84125,81517,2608,3.1,"Santa Rosa County, FL"
85,2020,Feb,84511,82340,2171,2.6,"Santa Rosa County, FL"
86,2020,Mar,83641,80503,3138,3.8,"Santa Rosa County, FL"
87,2020,Apr,77075,69867,7208,9.4,"Santa Rosa County, FL"
88,2020,May,81917,74903,7014,8.6,"Santa Rosa County, FL"
89,2020,Jun,82860,77032,5828,7.0,"Santa Rosa County, FL"
90,2020,Jul,84629,77950,6679,7.9,"Santa Rosa County, FL"
91,2020,Aug,84274,79701,4573,5.4,"Santa Rosa County, FL"
92,2020,Sep,83918,79778,4140,4.9,"Santa Rosa County, FL"
93,2020,Oct,83529,79835,3694,4.4,"Santa Rosa County, FL"
94,2020,Nov,83011,79414,3597,4.3,"Santa Rosa County, FL"
95,2020,Dec,82674,79088,3586,4.3,"Santa Rosa County, FL"
96,2021,Jan,83085,79438,3647,4.4,"Santa Rosa County, FL"
97,2021,Feb,83459,80150,3309,4.0,"Santa Rosa County, FL"
98,2021,Mar,83976,80820,3156,3.8,"Santa Rosa County, FL"
99,2021,Apr,84347,81477,2870,3.4,"Santa Rosa County, FL"
100,2021,May,84662,81894,2768,3.3,"Santa Rosa County, FL"
101,2021,Jun,84964,81545,3419,4.0,"Santa Rosa County, FL"
102,2021,Jul,86483,83045,3438,4.0,"Santa Rosa County, FL"
103,2021,Aug,86206,82998,3208,3.7,"Santa Rosa County, FL"
104,2021,Sep,86097,83295,2802,3.3,"Santa Rosa County, FL"
105,2021,Oct,85780,83086,2694,3.1,"Santa Rosa County, FL"
106,2021,Nov,85251,82654,2597,3.0,"Santa Rosa County, FL"
107,2021,Dec,85104,82758,2346,2.8,"Santa Rosa County, FL"
108,2022,Jan,85706,82756,2950,3.4,"Santa Rosa County, FL"
109,2022,Feb,85501,82957,2544,3.0,"Santa Rosa County, FL"
110,2022,Mar,86350,84023,2327,2.7,"Santa Rosa County, FL"
111,2022,Apr,86874,84810,2064,2.4,"Santa Rosa County, FL"
112,2022,May,87705,85540,2165,2.5,"Santa Rosa County, FL"
113,2022,Jun,88205,85573,2632,3.0,"Santa Rosa County, FL"
114,2022,Jul,88846,86302,2544,2.9,"Santa Rosa County, FL"
115,2022,Aug,88352,85976,2376,2.7,"Santa Rosa County, FL"
116,2022,Sep,88848,86633,2215,2.5,"Santa Rosa County, FL"
117,2022,Oct,88269,86035,2234,2.5,"Santa Rosa County, FL"
118,2022,Nov,87919,85730,2189,2.5,"Santa Rosa County, FL"
119,2022,Dec,87577,85625,1952,2.2,"Santa Rosa County, FL"
120,2023,Jan,87635,85439,2196,2.5,"Santa Rosa County, FL"
121,2023,Feb,88347,86176,2171,2.5,"Santa Rosa County, FL"
122,2023,Mar,89476,87245,2231,2.5,"Santa Rosa County, FL"
123,2023,Apr,89176,87242,1934,2.2,"Santa Rosa County, FL"
124,2023,May,89644,87327,2317,2.6,"Santa Rosa County, FL"
125,2023,Jun,90998,88265,2733,3.0,"Santa Rosa County, FL"
126,2023,Jul,91399,88567,2832,3.1,"Santa Rosa County, FL"
127,2023,Aug,91617,88829,2788,3.0,"Santa Rosa County, FL"
128,2023,Sep,91585,88876,2709,3.0,"Santa Rosa County, FL"
129,2023,Oct,91253,88454,2799,3.1,"Santa Rosa County, FL"
0,2013,Jan,18389,15132,3257,17.7,"Siskiyou County, CA"
1,2013,Feb,18148,15063,3085,17.0,"Siskiyou County, CA"
2,2013,Mar,18096,15219,2877,15.9,"Siskiyou County, CA"
3,2013,Apr,18094,15625,2469,13.6,"Siskiyou County, CA"
4,2013,May,18388,16153,2235,12.2,"Siskiyou County, CA"
5,2013,Jun,18770,16467,2303,12.3,"Siskiyou County, CA"
6,2013,Jul,18482,16235,2247,12.2,"Siskiyou County, CA"
7,2013,Aug,18447,16332,2115,11.5,"Siskiyou County, CA"
8,2013,Sep,18327,16320,2007,11.0,"Siskiyou County, CA"
9,2013,Oct,18308,16301,2007,11.0,"Siskiyou County, CA"
10,2013,Nov,17727,15516,2211,12.5,"Siskiyou County, CA"
11,2013,Dec,17687,15382,2305,13.0,"Siskiyou County, CA"
12,2014,Jan,17729,15039,2690,15.2,"Siskiyou County, CA"
13,2014,Feb,17668,14954,2714,15.4,"Siskiyou County, CA"
14,2014,Mar,17822,15179,2643,14.8,"Siskiyou County, CA"
15,2014,Apr,17657,15633,2024,11.5,"Siskiyou County, CA"
16,2014,May,17920,16133,1787,10.0,"Siskiyou County, CA"
17,2014,Jun,18343,16530,1813,9.9,"Siskiyou County, CA"
18,2014,Jul,18456,16616,1840,10.0,"Siskiyou County, CA"
19,2014,Aug,18265,16529,1736,9.5,"Siskiyou County, CA"
20,2014,Sep,18286,16707,1579,8.6,"Siskiyou County, CA"
21,2014,Oct,18263,16683,1580,8.7,"Siskiyou County, CA"
22,2014,Nov,17796,16000,1796,10.1,"Siskiyou County, CA"
23,2014,Dec,17512,15524,1988,11.4,"Siskiyou County, CA"
24,2015,Jan,17759,15488,2271,12.8,"Siskiyou County, CA"
25,2015,Feb,17732,15506,2226,12.6,"Siskiyou County, CA"
26,2015,Mar,17742,15676,2066,11.6,"Siskiyou County, CA"
27,2015,Apr,17573,15918,1655,9.4,"Siskiyou County, CA"
28,2015,May,17951,16422,1529,8.5,"Siskiyou County, CA"
29,2015,Jun,18382,16829,1553,8.4,"Siskiyou County, CA"
30,2015,Jul,18124,16603,1521,8.4,"Siskiyou County, CA"
31,2015,Aug,18334,16925,1409,7.7,"Siskiyou County, CA"
32,2015,Sep,18085,16790,1295,7.2,"Siskiyou County, CA"
33,2015,Oct,17991,16651,1340,7.4,"Siskiyou County, CA"
34,2015,Nov,17530,15988,1542,8.8,"Siskiyou County, CA"
35,2015,Dec,17399,15589,1810,10.4,"Siskiyou County, CA"
36,2016,Jan,17669,15555,2114,12.0,"Siskiyou County, CA"
37,2016,Feb,17666,15622,2044,11.6,"Siskiyou County, CA"
38,2016,Mar,17799,15800,1999,11.2,"Siskiyou County, CA"
39,2016,Apr,17542,16019,1523,8.7,"Siskiyou County, CA"
40,2016,May,17531,16289,1242,7.1,"Siskiyou County, CA"
41,2016,Jun,18118,16802,1316,7.3,"Siskiyou County, CA"
42,2016,Jul,18312,16975,1337,7.3,"Siskiyou County, CA"
43,2016,Aug,18283,17008,1275,7.0,"Siskiyou County, CA"
44,2016,Sep,18128,16923,1205,6.6,"Siskiyou County, CA"
45,2016,Oct,18187,16955,1232,6.8,"Siskiyou County, CA"
46,2016,Nov,17957,16581,1376,7.7,"Siskiyou County, CA"
47,2016,Dec,17555,15908,1647,9.4,"Siskiyou County, CA"
48,2017,Jan,17481,15738,1743,10.0,"Siskiyou County, CA"
49,2017,Feb,17619,15775,1844,10.5,"Siskiyou County, CA"
50,2017,Mar,17660,15953,1707,9.7,"Siskiyou County, CA"
51,2017,Apr,17650,16319,1331,7.5,"Siskiyou County, CA"
52,2017,May,17804,16677,1127,6.3,"Siskiyou County, CA"
53,2017,Jun,18276,17118,1158,6.3,"Siskiyou County, CA"
54,2017,Jul,18092,16905,1187,6.6,"Siskiyou County, CA"
55,2017,Aug,18059,16918,1141,6.3,"Siskiyou County, CA"
56,2017,Sep,18198,17208,990,5.4,"Siskiyou County, CA"
57,2017,Oct,18067,17073,994,5.5,"Siskiyou County, CA"
58,2017,Nov,17440,16359,1081,6.2,"Siskiyou County, CA"
59,2017,Dec,17076,15770,1306,7.6,"Siskiyou County, CA"
60,2018,Jan,16891,15388,1503,8.9,"Siskiyou County, CA"
61,2018,Feb,17169,15575,1594,9.3,"Siskiyou County, CA"
62,2018,Mar,17251,15711,1540,8.9,"Siskiyou County, CA"
63,2018,Apr,17140,15921,1219,7.1,"Siskiyou County, CA"
64,2018,May,17269,16297,972,5.6,"Siskiyou County, CA"
65,2018,Jun,17847,16773,1074,6.0,"Siskiyou County, CA"
66,2018,Jul,17764,16707,1057,6.0,"Siskiyou County, CA"
67,2018,Aug,17700,16703,997,5.6,"Siskiyou County, CA"
68,2018,Sep,17439,16531,908,5.2,"Siskiyou County, CA"
69,2018,Oct,17950,17008,942,5.2,"Siskiyou County, CA"
70,2018,Nov,17229,16215,1014,5.9,"Siskiyou County, CA"
71,2018,Dec,16697,15450,1247,7.5,"Siskiyou County, CA"
72,2019,Jan,16990,15400,1590,9.4,"Siskiyou County, CA"
73,2019,Feb,16964,15357,1607,9.5,"Siskiyou County, CA"
74,2019,Mar,16907,15349,1558,9.2,"Siskiyou County, CA"
75,2019,Apr,16804,15595,1209,7.2,"Siskiyou County, CA"
76,2019,May,17012,16086,926,5.4,"Siskiyou County, CA"
77,2019,Jun,17474,16476,998,5.7,"Siskiyou County, CA"
78,2019,Jul,17939,16919,1020,5.7,"Siskiyou County, CA"
79,2019,Aug,17601,16665,936,5.3,"Siskiyou County, CA"
80,2019,Sep,17533,16737,796,4.5,"Siskiyou County, CA"
81,2019,Oct,17623,16798,825,4.7,"Siskiyou County, CA"
82,2019,Nov,16905,16010,895,5.3,"Siskiyou County, CA"
83,2019,Dec,16540,15427,1113,6.7,"Siskiyou County, CA"
84,2020,Jan,17046,15608,1438,8.4,"Siskiyou County, CA"
85,2020,Feb,17137,15701,1436,8.4,"Siskiyou County, CA"
86,2020,Mar,17385,15416,1969,11.3,"Siskiyou County, CA"
87,2020,Apr,16826,14155,2671,15.9,"Siskiyou County, CA"
88,2020,May,16459,14331,2128,12.9,"Siskiyou County, CA"
89,2020,Jun,17365,15479,1886,10.9,"Siskiyou County, CA"
90,2020,Jul,16953,15164,1789,10.6,"Siskiyou County, CA"
91,2020,Aug,16961,15475,1486,8.8,"Siskiyou County, CA"
92,2020,Sep,17226,15846,1380,8.0,"Siskiyou County, CA"
93,2020,Oct,17771,16518,1253,7.1,"Siskiyou County, CA"
94,2020,Nov,16763,15403,1360,8.1,"Siskiyou County, CA"
95,2020,Dec,16108,14472,1636,10.2,"Siskiyou County, CA"
96,2021,Jan,16356,14609,1747,10.7,"Siskiyou County, CA"
97,2021,Feb,16476,14694,1782,10.8,"Siskiyou County, CA"
98,2021,Mar,16672,14966,1706,10.2,"Siskiyou County, CA"
99,2021,Apr,16663,15186,1477,8.9,"Siskiyou County, CA"
100,2021,May,16638,15365,1273,7.7,"Siskiyou County, CA"
101,2021,Jun,16461,15068,1393,8.5,"Siskiyou County, CA"
102,2021,Jul,16887,15548,1339,7.9,"Siskiyou County, CA"
103,2021,Aug,16979,15717,1262,7.4,"Siskiyou County, CA"
104,2021,Sep,17041,15965,1076,6.3,"Siskiyou County, CA"
105,2021,Oct,17696,16642,1054,6.0,"Siskiyou County, CA"
106,2021,Nov,16386,15348,1038,6.3,"Siskiyou County, CA"
107,2021,Dec,16196,15082,1114,6.9,"Siskiyou County, CA"
108,2022,Jan,16535,15156,1379,8.3,"Siskiyou County, CA"
109,2022,Feb,16483,15149,1334,8.1,"Siskiyou County, CA"
110,2022,Mar,16635,15467,1168,7.0,"Siskiyou County, CA"
111,2022,Apr,16215,15294,921,5.7,"Siskiyou County, CA"
112,2022,May,16551,15766,785,4.7,"Siskiyou County, CA"
113,2022,Jun,16327,15484,843,5.2,"Siskiyou County, CA"
114,2022,Jul,16479,15657,822,5.0,"Siskiyou County, CA"
115,2022,Aug,16799,15988,811,4.8,"Siskiyou County, CA"
116,2022,Sep,17177,16443,734,4.3,"Siskiyou County, CA"
117,2022,Oct,17503,16732,771,4.4,"Siskiyou County, CA"
118,2022,Nov,16716,15848,868,5.2,"Siskiyou County, CA"
119,2022,Dec,16163,15199,964,6.0,"Siskiyou County, CA"
120,2023,Jan,16362,15125,1237,7.6,"Siskiyou County, CA"
121,2023,Feb,16533,15225,1308,7.9,"Siskiyou County, CA"
122,2023,Mar,16707,15375,1332,8.0,"Siskiyou County, CA"
123,2023,Apr,16243,15226,1017,6.3,"Siskiyou County, CA"
124,2023,May,16483,15499,984,6.0,"Siskiyou County, CA"
125,2023,Jun,16777,15782,995,5.9,"Siskiyou County, CA"
126,2023,Jul,16687,15738,949,5.7,"Siskiyou County, CA"
127,2023,Aug,17250,16254,996,5.8,"Siskiyou County, CA"
128,2023,Sep,17126,16216,910,5.3,"Siskiyou County, CA"
129,2023,Oct,17624,16696,928,5.3,"Siskiyou County, CA"
0,2013,Jan,9402,8500,902,9.6,"Inyo County, CA"
1,2013,Feb,9249,8387,862,9.3,"Inyo County, CA"
2,2013,Mar,9358,8540,818,8.7,"Inyo County, CA"
3,2013,Apr,9330,8614,716,7.7,"Inyo County, CA"
4,2013,May,9463,8759,704,7.4,"Inyo County, CA"
5,2013,Jun,9460,8705,755,8.0,"Inyo County, CA"
6,2013,Jul,9531,8787,744,7.8,"Inyo County, CA"
7,2013,Aug,9562,8847,715,7.5,"Inyo County, CA"
8,2013,Sep,9380,8717,663,7.1,"Inyo County, CA"
9,2013,Oct,9238,8548,690,7.5,"Inyo County, CA"
10,2013,Nov,9202,8517,685,7.4,"Inyo County, CA"
11,2013,Dec,9091,8434,657,7.2,"Inyo County, CA"
12,2014,Jan,9061,8340,721,8.0,"Inyo County, CA"
13,2014,Feb,9139,8405,734,8.0,"Inyo County, CA"
14,2014,Mar,9220,8473,747,8.1,"Inyo County, CA"
15,2014,Apr,9089,8457,632,7.0,"Inyo County, CA"
16,2014,May,9217,8606,611,6.6,"Inyo County, CA"
17,2014,Jun,9384,8761,623,6.6,"Inyo County, CA"
18,2014,Jul,9356,8689,667,7.1,"Inyo County, CA"
19,2014,Aug,9401,8779,622,6.6,"Inyo County, CA"
20,2014,Sep,9301,8745,556,6.0,"Inyo County, CA"
21,2014,Oct,9127,8570,557,6.1,"Inyo County, CA"
22,2014,Nov,8973,8399,574,6.4,"Inyo County, CA"
23,2014,Dec,9045,8476,569,6.3,"Inyo County, CA"
24,2015,Jan,9070,8428,642,7.1,"Inyo County, CA"
25,2015,Feb,9040,8419,621,6.9,"Inyo County, CA"
26,2015,Mar,9076,8481,595,6.6,"Inyo County, CA"
27,2015,Apr,9050,8530,520,5.7,"Inyo County, CA"
28,2015,May,9167,8675,492,5.4,"Inyo County, CA"
29,2015,Jun,9278,8770,508,5.5,"Inyo County, CA"
30,2015,Jul,9286,8753,533,5.7,"Inyo County, CA"
31,2015,Aug,9206,8716,490,5.3,"Inyo County, CA"
32,2015,Sep,9150,8695,455,5.0,"Inyo County, CA"
33,2015,Oct,8934,8458,476,5.3,"Inyo County, CA"
34,2015,Nov,8859,8346,513,5.8,"Inyo County, CA"
35,2015,Dec,8858,8352,506,5.7,"Inyo County, CA"
36,2016,Jan,8842,8279,563,6.4,"Inyo County, CA"
37,2016,Feb,8902,8352,550,6.2,"Inyo County, CA"
38,2016,Mar,8945,8412,533,6.0,"Inyo County, CA"
39,2016,Apr,8791,8324,467,5.3,"Inyo County, CA"
40,2016,May,8856,8437,419,4.7,"Inyo County, CA"
41,2016,Jun,8962,8493,469,5.2,"Inyo County, CA"
42,2016,Jul,9044,8570,474,5.2,"Inyo County, CA"
43,2016,Aug,8977,8537,440,4.9,"Inyo County, CA"
44,2016,Sep,8915,8486,429,4.8,"Inyo County, CA"
45,2016,Oct,8759,8339,420,4.8,"Inyo County, CA"
46,2016,Nov,8723,8295,428,4.9,"Inyo County, CA"
47,2016,Dec,8595,8153,442,5.1,"Inyo County, CA"
48,2017,Jan,8627,8167,460,5.3,"Inyo County, CA"
49,2017,Feb,8669,8203,466,5.4,"Inyo County, CA"
50,2017,Mar,8645,8211,434,5.0,"Inyo County, CA"
51,2017,Apr,8503,8111,392,4.6,"Inyo County, CA"
52,2017,May,8538,8199,339,4.0,"Inyo County, CA"
53,2017,Jun,8613,8253,360,4.2,"Inyo County, CA"
54,2017,Jul,8786,8392,394,4.5,"Inyo County, CA"
55,2017,Aug,8706,8338,368,4.2,"Inyo County, CA"
56,2017,Sep,8715,8386,329,3.8,"Inyo County, CA"
57,2017,Oct,8600,8271,329,3.8,"Inyo County, CA"
58,2017,Nov,8418,8087,331,3.9,"Inyo County, CA"
59,2017,Dec,8435,8097,338,4.0,"Inyo County, CA"
60,2018,Jan,8536,8159,377,4.4,"Inyo County, CA"
61,2018,Feb,8621,8231,390,4.5,"Inyo County, CA"
62,2018,Mar,8644,8264,380,4.4,"Inyo County, CA"
63,2018,Apr,8560,8232,328,3.8,"Inyo County, CA"
64,2018,May,8636,8343,293,3.4,"Inyo County, CA"
65,2018,Jun,8839,8502,337,3.8,"Inyo County, CA"
66,2018,Jul,8884,8544,340,3.8,"Inyo County, CA"
67,2018,Aug,8838,8514,324,3.7,"Inyo County, CA"
68,2018,Sep,8793,8489,304,3.5,"Inyo County, CA"
69,2018,Oct,8755,8446,309,3.5,"Inyo County, CA"
70,2018,Nov,8676,8342,334,3.8,"Inyo County, CA"
71,2018,Dec,8666,8295,371,4.3,"Inyo County, CA"
72,2019,Jan,8668,8235,433,5.0,"Inyo County, CA"
73,2019,Feb,8711,8316,395,4.5,"Inyo County, CA"
74,2019,Mar,8702,8313,389,4.5,"Inyo County, CA"
75,2019,Apr,8602,8295,307,3.6,"Inyo County, CA"
76,2019,May,8672,8413,259,3.0,"Inyo County, CA"
77,2019,Jun,8784,8479,305,3.5,"Inyo County, CA"
78,2019,Jul,8942,8628,314,3.5,"Inyo County, CA"
79,2019,Aug,8930,8640,290,3.2,"Inyo County, CA"
80,2019,Sep,8861,8613,248,2.8,"Inyo County, CA"
81,2019,Oct,8843,8587,256,2.9,"Inyo County, CA"
82,2019,Nov,8817,8539,278,3.2,"Inyo County, CA"
83,2019,Dec,8727,8449,278,3.2,"Inyo County, CA"
84,2020,Jan,8671,8326,345,4.0,"Inyo County, CA"
85,2020,Feb,8700,8360,340,3.9,"Inyo County, CA"
86,2020,Mar,8622,8146,476,5.5,"Inyo County, CA"
87,2020,Apr,7952,6747,1205,15.2,"Inyo County, CA"
88,2020,May,7955,6934,1021,12.8,"Inyo County, CA"
89,2020,Jun,8546,7664,882,10.3,"Inyo County, CA"
90,2020,Jul,8467,7680,787,9.3,"Inyo County, CA"
91,2020,Aug,8342,7710,632,7.6,"Inyo County, CA"
92,2020,Sep,8266,7649,617,7.5,"Inyo County, CA"
93,2020,Oct,8194,7636,558,6.8,"Inyo County, CA"
94,2020,Nov,8218,7660,558,6.8,"Inyo County, CA"
95,2020,Dec,8096,7533,563,7.0,"Inyo County, CA"
96,2021,Jan,7989,7381,608,7.6,"Inyo County, CA"
97,2021,Feb,8126,7526,600,7.4,"Inyo County, CA"
98,2021,Mar,8237,7647,590,7.2,"Inyo County, CA"
99,2021,Apr,8231,7691,540,6.6,"Inyo County, CA"
100,2021,May,8280,7804,476,5.7,"Inyo County, CA"
101,2021,Jun,8401,7869,532,6.3,"Inyo County, CA"
102,2021,Jul,8454,7938,516,6.1,"Inyo County, CA"
103,2021,Aug,8344,7855,489,5.9,"Inyo County, CA"
104,2021,Sep,8308,7900,408,4.9,"Inyo County, CA"
105,2021,Oct,8240,7837,403,4.9,"Inyo County, CA"
106,2021,Nov,8370,7992,378,4.5,"Inyo County, CA"
107,2021,Dec,8124,7765,359,4.4,"Inyo County, CA"
108,2022,Jan,8188,7762,426,5.2,"Inyo County, CA"
109,2022,Feb,8289,7904,385,4.6,"Inyo County, CA"
110,2022,Mar,8218,7870,348,4.2,"Inyo County, CA"
111,2022,Apr,8063,7771,292,3.6,"Inyo County, CA"
112,2022,May,8132,7869,263,3.2,"Inyo County, CA"
113,2022,Jun,8181,7891,290,3.5,"Inyo County, CA"
114,2022,Jul,8345,8054,291,3.5,"Inyo County, CA"
115,2022,Aug,8296,8008,288,3.5,"Inyo County, CA"
116,2022,Sep,8350,8103,247,3.0,"Inyo County, CA"
117,2022,Oct,8338,8075,263,3.2,"Inyo County, CA"
118,2022,Nov,8381,8089,292,3.5,"Inyo County, CA"
119,2022,Dec,8344,8060,284,3.4,"Inyo County, CA"
120,2023,Jan,8231,7881,350,4.3,"Inyo County, CA"
121,2023,Feb,8337,7985,352,4.2,"Inyo County, CA"
122,2023,Mar,8381,8056,325,3.9,"Inyo County, CA"
123,2023,Apr,8203,7914,289,3.5,"Inyo County, CA"
124,2023,May,8260,7971,289,3.5,"Inyo County, CA"
125,2023,Jun,8293,7976,317,3.8,"Inyo County, CA"
126,2023,Jul,8440,8135,305,3.6,"Inyo County, CA"
127,2023,Aug,8371,8052,319,3.8,"Inyo County, CA"
128,2023,Sep,8389,8085,304,3.6,"Inyo County, CA"
129,2023,Oct,8348,8045,303,3.6,"Inyo County, CA"
0,2013,Jan,140068,120909,19159,13.7,"Santa Cruz County, CA"
1,2013,Feb,140541,122130,18411,13.1,"Santa Cruz County, CA"
2,2013,Mar,140702,123003,17699,12.6,"Santa Cruz County, CA"
3,2013,Apr,141316,125680,15636,11.1,"Santa Cruz County, CA"
4,2013,May,142964,129454,13510,9.4,"Santa Cruz County, CA"
5,2013,Jun,145761,131772,13989,9.6,"Santa Cruz County, CA"
6,2013,Jul,145021,131345,13676,9.4,"Santa Cruz County, CA"
7,2013,Aug,142974,130099,12875,9.0,"Santa Cruz County, CA"
8,2013,Sep,140862,128955,11907,8.5,"Santa Cruz County, CA"
9,2013,Oct,141180,129033,12147,8.6,"Santa Cruz County, CA"
10,2013,Nov,140516,127120,13396,9.5,"Santa Cruz County, CA"
11,2013,Dec,137184,122820,14364,10.5,"Santa Cruz County, CA"
12,2014,Jan,139489,123064,16425,11.8,"Santa Cruz County, CA"
13,2014,Feb,140942,124521,16421,11.7,"Santa Cruz County, CA"
14,2014,Mar,142672,126268,16404,11.5,"Santa Cruz County, CA"
15,2014,Apr,141321,127880,13441,9.5,"Santa Cruz County, CA"
16,2014,May,143508,132251,11257,7.8,"Santa Cruz County, CA"
17,2014,Jun,145777,134488,11289,7.7,"Santa Cruz County, CA"
18,2014,Jul,145156,133664,11492,7.9,"Santa Cruz County, CA"
19,2014,Aug,143104,132354,10750,7.5,"Santa Cruz County, CA"
20,2014,Sep,140154,130514,9640,6.9,"Santa Cruz County, CA"
21,2014,Oct,142079,132211,9868,6.9,"Santa Cruz County, CA"
22,2014,Nov,141333,129895,11438,8.1,"Santa Cruz County, CA"
23,2014,Dec,139039,126516,12523,9.0,"Santa Cruz County, CA"
24,2015,Jan,141843,127261,14582,10.3,"Santa Cruz County, CA"
25,2015,Feb,142139,127972,14167,10.0,"Santa Cruz County, CA"
26,2015,Mar,143431,129599,13832,9.6,"Santa Cruz County, CA"
27,2015,Apr,143311,131830,11481,8.0,"Santa Cruz County, CA"
28,2015,May,145245,135306,9939,6.8,"Santa Cruz County, CA"
29,2015,Jun,146548,136857,9691,6.6,"Santa Cruz County, CA"
30,2015,Jul,145835,136241,9594,6.6,"Santa Cruz County, CA"
31,2015,Aug,144294,135477,8817,6.1,"Santa Cruz County, CA"
32,2015,Sep,141340,133426,7914,5.6,"Santa Cruz County, CA"
33,2015,Oct,142943,134740,8203,5.7,"Santa Cruz County, CA"
34,2015,Nov,141749,131790,9959,7.0,"Santa Cruz County, CA"
35,2015,Dec,140046,128709,11337,8.1,"Santa Cruz County, CA"
36,2016,Jan,142001,128853,13148,9.3,"Santa Cruz County, CA"
37,2016,Feb,143358,130321,13037,9.1,"Santa Cruz County, CA"
38,2016,Mar,144211,131001,13210,9.2,"Santa Cruz County, CA"
39,2016,Apr,144069,133011,11058,7.7,"Santa Cruz County, CA"
40,2016,May,144854,136153,8701,6.0,"Santa Cruz County, CA"
41,2016,Jun,147070,138070,9000,6.1,"Santa Cruz County, CA"
42,2016,Jul,146040,137202,8838,6.1,"Santa Cruz County, CA"
43,2016,Aug,144605,136291,8314,5.7,"Santa Cruz County, CA"
44,2016,Sep,142901,135286,7615,5.3,"Santa Cruz County, CA"
45,2016,Oct,143437,135750,7687,5.4,"Santa Cruz County, CA"
46,2016,Nov,142152,133277,8875,6.2,"Santa Cruz County, CA"
47,2016,Dec,140466,129539,10927,7.8,"Santa Cruz County, CA"
48,2017,Jan,139660,128659,11001,7.9,"Santa Cruz County, CA"
49,2017,Feb,142076,130800,11276,7.9,"Santa Cruz County, CA"
50,2017,Mar,143039,132097,10942,7.6,"Santa Cruz County, CA"
51,2017,Apr,142842,133594,9248,6.5,"Santa Cruz County, CA"
52,2017,May,144090,136734,7356,5.1,"Santa Cruz County, CA"
53,2017,Jun,146740,139406,7334,5.0,"Santa Cruz County, CA"
54,2017,Jul,145585,138211,7374,5.1,"Santa Cruz County, CA"
55,2017,Aug,143418,136518,6900,4.8,"Santa Cruz County, CA"
56,2017,Sep,142547,136602,5945,4.2,"Santa Cruz County, CA"
57,2017,Oct,142309,136418,5891,4.1,"Santa Cruz County, CA"
58,2017,Nov,140514,133659,6855,4.9,"Santa Cruz County, CA"
59,2017,Dec,138392,130373,8019,5.8,"Santa Cruz County, CA"
60,2018,Jan,138586,129678,8908,6.4,"Santa Cruz County, CA"
61,2018,Feb,141269,131712,9557,6.8,"Santa Cruz County, CA"
62,2018,Mar,141418,132108,9310,6.6,"Santa Cruz County, CA"
63,2018,Apr,140827,132782,8045,5.7,"Santa Cruz County, CA"
64,2018,May,142291,136043,6248,4.4,"Santa Cruz County, CA"
65,2018,Jun,144271,137803,6468,4.5,"Santa Cruz County, CA"
66,2018,Jul,144154,137930,6224,4.3,"Santa Cruz County, CA"
67,2018,Aug,141904,136116,5788,4.1,"Santa Cruz County, CA"
68,2018,Sep,141158,136061,5097,3.6,"Santa Cruz County, CA"
69,2018,Oct,141151,135921,5230,3.7,"Santa Cruz County, CA"
70,2018,Nov,139867,133846,6021,4.3,"Santa Cruz County, CA"
71,2018,Dec,138392,130665,7727,5.6,"Santa Cruz County, CA"
72,2019,Jan,138408,128942,9466,6.8,"Santa Cruz County, CA"
73,2019,Feb,141050,131467,9583,6.8,"Santa Cruz County, CA"
74,2019,Mar,141397,131852,9545,6.8,"Santa Cruz County, CA"
75,2019,Apr,140265,132410,7855,5.6,"Santa Cruz County, CA"
76,2019,May,141431,135561,5870,4.2,"Santa Cruz County, CA"
77,2019,Jun,143494,137291,6203,4.3,"Santa Cruz County, CA"
78,2019,Jul,144137,137881,6256,4.3,"Santa Cruz County, CA"
79,2019,Aug,143463,137825,5638,3.9,"Santa Cruz County, CA"
80,2019,Sep,142651,137815,4836,3.4,"Santa Cruz County, CA"
81,2019,Oct,141940,136817,5123,3.6,"Santa Cruz County, CA"
82,2019,Nov,140125,134177,5948,4.2,"Santa Cruz County, CA"
83,2019,Dec,138390,131302,7088,5.1,"Santa Cruz County, CA"
84,2020,Jan,139062,130311,8751,6.3,"Santa Cruz County, CA"
85,2020,Feb,140933,131967,8966,6.4,"Santa Cruz County, CA"
86,2020,Mar,140690,127847,12843,9.1,"Santa Cruz County, CA"
87,2020,Apr,132976,109205,23771,17.9,"Santa Cruz County, CA"
88,2020,May,131727,112568,19159,14.5,"Santa Cruz County, CA"
89,2020,Jun,136939,120611,16328,11.9,"Santa Cruz County, CA"
90,2020,Jul,136190,121703,14487,10.6,"Santa Cruz County, CA"
91,2020,Aug,134234,122571,11663,8.7,"Santa Cruz County, CA"
92,2020,Sep,133789,122840,10949,8.2,"Santa Cruz County, CA"
93,2020,Oct,133457,123712,9745,7.3,"Santa Cruz County, CA"
94,2020,Nov,131474,121422,10052,7.6,"Santa Cruz County, CA"
95,2020,Dec,129752,118985,10767,8.3,"Santa Cruz County, CA"
96,2021,Jan,129136,117138,11998,9.3,"Santa Cruz County, CA"
97,2021,Feb,131220,119114,12106,9.2,"Santa Cruz County, CA"
98,2021,Mar,132322,120689,11633,8.8,"Santa Cruz County, CA"
99,2021,Apr,132019,121115,10904,8.3,"Santa Cruz County, CA"
100,2021,May,133011,123647,9364,7.0,"Santa Cruz County, CA"
101,2021,Jun,135282,125520,9762,7.2,"Santa Cruz County, CA"
102,2021,Jul,136839,127866,8973,6.6,"Santa Cruz County, CA"
103,2021,Aug,135883,127616,8267,6.1,"Santa Cruz County, CA"
104,2021,Sep,134729,127826,6903,5.1,"Santa Cruz County, CA"
105,2021,Oct,134112,127399,6713,5.0,"Santa Cruz County, CA"
106,2021,Nov,132730,125962,6768,5.1,"Santa Cruz County, CA"
107,2021,Dec,130209,122934,7275,5.6,"Santa Cruz County, CA"
108,2022,Jan,130799,122150,8649,6.6,"Santa Cruz County, CA"
109,2022,Feb,132231,123554,8677,6.6,"Santa Cruz County, CA"
110,2022,Mar,133049,125067,7982,6.0,"Santa Cruz County, CA"
111,2022,Apr,132925,126154,6771,5.1,"Santa Cruz County, CA"
112,2022,May,134342,128836,5506,4.1,"Santa Cruz County, CA"
113,2022,Jun,135388,129681,5707,4.2,"Santa Cruz County, CA"
114,2022,Jul,136866,131359,5507,4.0,"Santa Cruz County, CA"
115,2022,Aug,136615,131248,5367,3.9,"Santa Cruz County, CA"
116,2022,Sep,135916,131200,4716,3.5,"Santa Cruz County, CA"
117,2022,Oct,135692,130532,5160,3.8,"Santa Cruz County, CA"
118,2022,Nov,134417,128358,6059,4.5,"Santa Cruz County, CA"
119,2022,Dec,131866,125307,6559,5.0,"Santa Cruz County, CA"
120,2023,Jan,132456,124235,8221,6.2,"Santa Cruz County, CA"
121,2023,Feb,134943,125699,9244,6.9,"Santa Cruz County, CA"
122,2023,Mar,135683,126257,9426,6.9,"Santa Cruz County, CA"
123,2023,Apr,134451,126346,8105,6.0,"Santa Cruz County, CA"
124,2023,May,135668,127846,7822,5.8,"Santa Cruz County, CA"
125,2023,Jun,135436,128293,7143,5.3,"Santa Cruz County, CA"
126,2023,Jul,136301,129703,6598,4.8,"Santa Cruz County, CA"
127,2023,Aug,135851,128974,6877,5.1,"Santa Cruz County, CA"
128,2023,Sep,135671,129332,6339,4.7,"Santa Cruz County, CA"
129,2023,Oct,135526,128970,6556,4.8,"Santa Cruz County, CA"
0,2013,Jan,643,585,58,9.0,"Alpine County, CA"
1,2013,Feb,644,590,54,8.4,"Alpine County, CA"
2,2013,Mar,618,566,52,8.4,"Alpine County, CA"
3,2013,Apr,485,436,49,10.1,"Alpine County, CA"
4,2013,May,469,419,50,10.7,"Alpine County, CA"
5,2013,Jun,477,422,55,11.5,"Alpine County, CA"
6,2013,Jul,503,443,60,11.9,"Alpine County, CA"
7,2013,Aug,490,439,51,10.4,"Alpine County, CA"
8,2013,Sep,478,430,48,10.0,"Alpine County, CA"
9,2013,Oct,468,420,48,10.3,"Alpine County, CA"
10,2013,Nov,470,426,44,9.4,"Alpine County, CA"
11,2013,Dec,528,485,43,8.1,"Alpine County, CA"
12,2014,Jan,530,488,42,7.9,"Alpine County, CA"
13,2014,Feb,515,471,44,8.5,"Alpine County, CA"
14,2014,Mar,510,466,44,8.6,"Alpine County, CA"
15,2014,Apr,503,463,40,8.0,"Alpine County, CA"
16,2014,May,494,443,51,10.3,"Alpine County, CA"
17,2014,Jun,507,454,53,10.5,"Alpine County, CA"
18,2014,Jul,517,471,46,8.9,"Alpine County, CA"
19,2014,Aug,503,460,43,8.5,"Alpine County, CA"
20,2014,Sep,495,458,37,7.5,"Alpine County, CA"
21,2014,Oct,490,452,38,7.8,"Alpine County, CA"
22,2014,Nov,494,457,37,7.5,"Alpine County, CA"
23,2014,Dec,550,518,32,5.8,"Alpine County, CA"
24,2015,Jan,566,529,37,6.5,"Alpine County, CA"
25,2015,Feb,558,520,38,6.8,"Alpine County, CA"
26,2015,Mar,537,496,41,7.6,"Alpine County, CA"
27,2015,Apr,586,544,42,7.2,"Alpine County, CA"
28,2015,May,534,490,44,8.2,"Alpine County, CA"
29,2015,Jun,524,477,47,9.0,"Alpine County, CA"
30,2015,Jul,528,484,44,8.3,"Alpine County, CA"
31,2015,Aug,534,494,40,7.5,"Alpine County, CA"
32,2015,Sep,525,485,40,7.6,"Alpine County, CA"
33,2015,Oct,507,467,40,7.9,"Alpine County, CA"
34,2015,Nov,541,504,37,6.8,"Alpine County, CA"
35,2015,Dec,645,609,36,5.6,"Alpine County, CA"
36,2016,Jan,679,643,36,5.3,"Alpine County, CA"
37,2016,Feb,678,643,35,5.2,"Alpine County, CA"
38,2016,Mar,662,625,37,5.6,"Alpine County, CA"
39,2016,Apr,623,587,36,5.8,"Alpine County, CA"
40,2016,May,463,426,37,8.0,"Alpine County, CA"
41,2016,Jun,493,455,38,7.7,"Alpine County, CA"
42,2016,Jul,491,454,37,7.5,"Alpine County, CA"
43,2016,Aug,490,455,35,7.1,"Alpine County, CA"
44,2016,Sep,489,453,36,7.4,"Alpine County, CA"
45,2016,Oct,472,438,34,7.2,"Alpine County, CA"
46,2016,Nov,508,471,37,7.3,"Alpine County, CA"
47,2016,Dec,597,569,28,4.7,"Alpine County, CA"
48,2017,Jan,639,604,35,5.5,"Alpine County, CA"
49,2017,Feb,651,616,35,5.4,"Alpine County, CA"
50,2017,Mar,634,599,35,5.5,"Alpine County, CA"
51,2017,Apr,585,556,29,5.0,"Alpine County, CA"
52,2017,May,465,430,35,7.5,"Alpine County, CA"
53,2017,Jun,484,441,43,8.9,"Alpine County, CA"
54,2017,Jul,501,461,40,8.0,"Alpine County, CA"
55,2017,Aug,488,453,35,7.2,"Alpine County, CA"
56,2017,Sep,480,448,32,6.7,"Alpine County, CA"
57,2017,Oct,472,442,30,6.4,"Alpine County, CA"
58,2017,Nov,544,515,29,5.3,"Alpine County, CA"
59,2017,Dec,634,608,26,4.1,"Alpine County, CA"
60,2018,Jan,678,648,30,4.4,"Alpine County, CA"
61,2018,Feb,670,646,24,3.6,"Alpine County, CA"
62,2018,Mar,636,613,23,3.6,"Alpine County, CA"
63,2018,Apr,494,475,19,3.8,"Alpine County, CA"
64,2018,May,454,430,24,5.3,"Alpine County, CA"
65,2018,Jun,474,446,28,5.9,"Alpine County, CA"
66,2018,Jul,497,466,31,6.2,"Alpine County, CA"
67,2018,Aug,485,459,26,5.4,"Alpine County, CA"
68,2018,Sep,481,457,24,5.0,"Alpine County, CA"
69,2018,Oct,479,455,24,5.0,"Alpine County, CA"
70,2018,Nov,553,529,24,4.3,"Alpine County, CA"
71,2018,Dec,663,640,23,3.5,"Alpine County, CA"
72,2019,Jan,717,686,31,4.3,"Alpine County, CA"
73,2019,Feb,691,662,29,4.2,"Alpine County, CA"
74,2019,Mar,672,642,30,4.5,"Alpine County, CA"
75,2019,Apr,584,561,23,3.9,"Alpine County, CA"
76,2019,May,473,445,28,5.9,"Alpine County, CA"
77,2019,Jun,490,456,34,6.9,"Alpine County, CA"
78,2019,Jul,486,451,35,7.2,"Alpine County, CA"
79,2019,Aug,481,453,28,5.8,"Alpine County, CA"
80,2019,Sep,476,452,24,5.0,"Alpine County, CA"
81,2019,Oct,457,432,25,5.5,"Alpine County, CA"
82,2019,Nov,452,426,26,5.8,"Alpine County, CA"
83,2019,Dec,524,499,25,4.8,"Alpine County, CA"
84,2020,Jan,651,620,31,4.8,"Alpine County, CA"
85,2020,Feb,634,602,32,5.0,"Alpine County, CA"
86,2020,Mar,641,597,44,6.9,"Alpine County, CA"
87,2020,Apr,470,360,110,23.4,"Alpine County, CA"
88,2020,May,448,344,104,23.2,"Alpine County, CA"
89,2020,Jun,465,376,89,19.1,"Alpine County, CA"
90,2020,Jul,463,395,68,14.7,"Alpine County, CA"
91,2020,Aug,461,410,51,11.1,"Alpine County, CA"
92,2020,Sep,462,411,51,11.0,"Alpine County, CA"
93,2020,Oct,449,403,46,10.2,"Alpine County, CA"
94,2020,Nov,477,434,43,9.0,"Alpine County, CA"
95,2020,Dec,555,508,47,8.5,"Alpine County, CA"
96,2021,Jan,625,579,46,7.4,"Alpine County, CA"
97,2021,Feb,635,586,49,7.7,"Alpine County, CA"
98,2021,Mar,624,574,50,8.0,"Alpine County, CA"
99,2021,Apr,571,525,46,8.1,"Alpine County, CA"
100,2021,May,474,429,45,9.5,"Alpine County, CA"
101,2021,Jun,476,431,45,9.5,"Alpine County, CA"
102,2021,Jul,488,443,45,9.2,"Alpine County, CA"
103,2021,Aug,462,418,44,9.5,"Alpine County, CA"
104,2021,Sep,451,410,41,9.1,"Alpine County, CA"
105,2021,Oct,427,391,36,8.4,"Alpine County, CA"
106,2021,Nov,442,412,30,6.8,"Alpine County, CA"
107,2021,Dec,486,456,30,6.2,"Alpine County, CA"
108,2022,Jan,556,519,37,6.7,"Alpine County, CA"
109,2022,Feb,562,527,35,6.2,"Alpine County, CA"
110,2022,Mar,553,521,32,5.8,"Alpine County, CA"
111,2022,Apr,563,538,25,4.4,"Alpine County, CA"
112,2022,May,473,446,27,5.7,"Alpine County, CA"
113,2022,Jun,452,425,27,6.0,"Alpine County, CA"
114,2022,Jul,460,436,24,5.2,"Alpine County, CA"
115,2022,Aug,453,428,25,5.5,"Alpine County, CA"
116,2022,Sep,452,431,21,4.6,"Alpine County, CA"
117,2022,Oct,443,418,25,5.6,"Alpine County, CA"
118,2022,Nov,482,457,25,5.2,"Alpine County, CA"
119,2022,Dec,563,539,24,4.3,"Alpine County, CA"
120,2023,Jan,633,602,31,4.9,"Alpine County, CA"
121,2023,Feb,636,601,35,5.5,"Alpine County, CA"
122,2023,Mar,624,589,35,5.6,"Alpine County, CA"
123,2023,Apr,561,529,32,5.7,"Alpine County, CA"
124,2023,May,488,454,34,7.0,"Alpine County, CA"
125,2023,Jun,494,459,35,7.1,"Alpine County, CA"
126,2023,Jul,511,475,36,7.0,"Alpine County, CA"
127,2023,Aug,506,469,37,7.3,"Alpine County, CA"
128,2023,Sep,499,468,31,6.2,"Alpine County, CA"
129,2023,Oct,482,447,35,7.3,"Alpine County, CA"
0,2013,Jan,48910,44292,4618,9.4,"Nevada County, CA"
1,2013,Feb,48478,44066,4412,9.1,"Nevada County, CA"
2,2013,Mar,48059,43793,4266,8.9,"Nevada County, CA"
3,2013,Apr,47451,43531,3920,8.3,"Nevada County, CA"
4,2013,May,47580,43688,3892,8.2,"Nevada County, CA"
5,2013,Jun,48565,44476,4089,8.4,"Nevada County, CA"
6,2013,Jul,48382,44348,4034,8.3,"Nevada County, CA"
7,2013,Aug,48639,44852,3787,7.8,"Nevada County, CA"
8,2013,Sep,48046,44418,3628,7.6,"Nevada County, CA"
9,2013,Oct,47041,43422,3619,7.7,"Nevada County, CA"
10,2013,Nov,47265,43690,3575,7.6,"Nevada County, CA"
11,2013,Dec,47515,44100,3415,7.2,"Nevada County, CA"
12,2014,Jan,48132,44511,3621,7.5,"Nevada County, CA"
13,2014,Feb,48368,44717,3651,7.5,"Nevada County, CA"
14,2014,Mar,48068,44427,3641,7.6,"Nevada County, CA"
15,2014,Apr,47187,44107,3080,6.5,"Nevada County, CA"
16,2014,May,47095,43995,3100,6.6,"Nevada County, CA"
17,2014,Jun,47882,44702,3180,6.6,"Nevada County, CA"
18,2014,Jul,48099,44790,3309,6.9,"Nevada County, CA"
19,2014,Aug,47252,44130,3122,6.6,"Nevada County, CA"
20,2014,Sep,47840,44987,2853,6.0,"Nevada County, CA"
21,2014,Oct,47788,44963,2825,5.9,"Nevada County, CA"
22,2014,Nov,47587,44684,2903,6.1,"Nevada County, CA"
23,2014,Dec,47659,44961,2698,5.7,"Nevada County, CA"
24,2015,Jan,48793,45764,3029,6.2,"Nevada County, CA"
25,2015,Feb,48350,45445,2905,6.0,"Nevada County, CA"
26,2015,Mar,48141,45273,2868,6.0,"Nevada County, CA"
27,2015,Apr,47526,44840,2686,5.7,"Nevada County, CA"
28,2015,May,48005,45402,2603,5.4,"Nevada County, CA"
29,2015,Jun,48320,45675,2645,5.5,"Nevada County, CA"
30,2015,Jul,47891,45175,2716,5.7,"Nevada County, CA"
31,2015,Aug,48389,45891,2498,5.2,"Nevada County, CA"
32,2015,Sep,47650,45342,2308,4.8,"Nevada County, CA"
33,2015,Oct,47449,45070,2379,5.0,"Nevada County, CA"
34,2015,Nov,47610,45183,2427,5.1,"Nevada County, CA"
35,2015,Dec,47947,45590,2357,4.9,"Nevada County, CA"
36,2016,Jan,48598,46035,2563,5.3,"Nevada County, CA"
37,2016,Feb,48707,46198,2509,5.2,"Nevada County, CA"
38,2016,Mar,48625,46085,2540,5.2,"Nevada County, CA"
39,2016,Apr,47653,45382,2271,4.8,"Nevada County, CA"
40,2016,May,47323,45224,2099,4.4,"Nevada County, CA"
41,2016,Jun,48084,45754,2330,4.8,"Nevada County, CA"
42,2016,Jul,48013,45626,2387,5.0,"Nevada County, CA"
43,2016,Aug,48625,46322,2303,4.7,"Nevada County, CA"
44,2016,Sep,48254,46058,2196,4.6,"Nevada County, CA"
45,2016,Oct,48004,45815,2189,4.6,"Nevada County, CA"
46,2016,Nov,47764,45601,2163,4.5,"Nevada County, CA"
47,2016,Dec,48113,45957,2156,4.5,"Nevada County, CA"
48,2017,Jan,48385,45967,2418,5.0,"Nevada County, CA"
49,2017,Feb,48816,46455,2361,4.8,"Nevada County, CA"
50,2017,Mar,48483,46322,2161,4.5,"Nevada County, CA"
51,2017,Apr,47767,45808,1959,4.1,"Nevada County, CA"
52,2017,May,47515,45698,1817,3.8,"Nevada County, CA"
53,2017,Jun,48494,46464,2030,4.2,"Nevada County, CA"
54,2017,Jul,48168,46060,2108,4.4,"Nevada County, CA"
55,2017,Aug,48888,46812,2076,4.2,"Nevada County, CA"
56,2017,Sep,48525,46693,1832,3.8,"Nevada County, CA"
57,2017,Oct,48160,46401,1759,3.7,"Nevada County, CA"
58,2017,Nov,47885,46152,1733,3.6,"Nevada County, CA"
59,2017,Dec,48369,46632,1737,3.6,"Nevada County, CA"
60,2018,Jan,48614,46714,1900,3.9,"Nevada County, CA"
61,2018,Feb,48885,46997,1888,3.9,"Nevada County, CA"
62,2018,Mar,48758,46903,1855,3.8,"Nevada County, CA"
63,2018,Apr,47881,46244,1637,3.4,"Nevada County, CA"
64,2018,May,47951,46436,1515,3.2,"Nevada County, CA"
65,2018,Jun,48463,46681,1782,3.7,"Nevada County, CA"
66,2018,Jul,48385,46638,1747,3.6,"Nevada County, CA"
67,2018,Aug,48757,47060,1697,3.5,"Nevada County, CA"
68,2018,Sep,48632,47057,1575,3.2,"Nevada County, CA"
69,2018,Oct,48766,47166,1600,3.3,"Nevada County, CA"
70,2018,Nov,48775,47160,1615,3.3,"Nevada County, CA"
71,2018,Dec,48938,47263,1675,3.4,"Nevada County, CA"
72,2019,Jan,49253,47204,2049,4.2,"Nevada County, CA"
73,2019,Feb,49202,47308,1894,3.8,"Nevada County, CA"
74,2019,Mar,49131,47245,1886,3.8,"Nevada County, CA"
75,2019,Apr,48329,46772,1557,3.2,"Nevada County, CA"
76,2019,May,47829,46400,1429,3.0,"Nevada County, CA"
77,2019,Jun,48249,46624,1625,3.4,"Nevada County, CA"
78,2019,Jul,48548,46841,1707,3.5,"Nevada County, CA"
79,2019,Aug,48408,46790,1618,3.3,"Nevada County, CA"
80,2019,Sep,48154,46779,1375,2.9,"Nevada County, CA"
81,2019,Oct,48197,46724,1473,3.1,"Nevada County, CA"
82,2019,Nov,48158,46672,1486,3.1,"Nevada County, CA"
83,2019,Dec,48529,47039,1490,3.1,"Nevada County, CA"
84,2020,Jan,49079,47254,1825,3.7,"Nevada County, CA"
85,2020,Feb,49298,47535,1763,3.6,"Nevada County, CA"
86,2020,Mar,48471,45931,2540,5.2,"Nevada County, CA"
87,2020,Apr,44737,37738,6999,15.6,"Nevada County, CA"
88,2020,May,44425,38511,5914,13.3,"Nevada County, CA"
89,2020,Jun,46804,41644,5160,11.0,"Nevada County, CA"
90,2020,Jul,46888,42170,4718,10.1,"Nevada County, CA"
91,2020,Aug,46944,43115,3829,8.2,"Nevada County, CA"
92,2020,Sep,46653,43084,3569,7.7,"Nevada County, CA"
93,2020,Oct,46605,43476,3129,6.7,"Nevada County, CA"
94,2020,Nov,46258,43202,3056,6.6,"Nevada County, CA"
95,2020,Dec,46269,43075,3194,6.9,"Nevada County, CA"
96,2021,Jan,46483,43155,3328,7.2,"Nevada County, CA"
97,2021,Feb,46699,43478,3221,6.9,"Nevada County, CA"
98,2021,Mar,47116,44020,3096,6.6,"Nevada County, CA"
99,2021,Apr,46958,44032,2926,6.2,"Nevada County, CA"
100,2021,May,46721,44078,2643,5.7,"Nevada County, CA"
101,2021,Jun,47753,44803,2950,6.2,"Nevada County, CA"
102,2021,Jul,48520,45719,2801,5.8,"Nevada County, CA"
103,2021,Aug,48277,45569,2708,5.6,"Nevada County, CA"
104,2021,Sep,47529,45248,2281,4.8,"Nevada County, CA"
105,2021,Oct,47497,45279,2218,4.7,"Nevada County, CA"
106,2021,Nov,47272,45221,2051,4.3,"Nevada County, CA"
107,2021,Dec,47581,45685,1896,4.0,"Nevada County, CA"
108,2022,Jan,48338,46089,2249,4.7,"Nevada County, CA"
109,2022,Feb,48542,46503,2039,4.2,"Nevada County, CA"
110,2022,Mar,48719,46885,1834,3.8,"Nevada County, CA"
111,2022,Apr,47516,45968,1548,3.3,"Nevada County, CA"
112,2022,May,47513,46137,1376,2.9,"Nevada County, CA"
113,2022,Jun,48064,46458,1606,3.3,"Nevada County, CA"
114,2022,Jul,49004,47433,1571,3.2,"Nevada County, CA"
115,2022,Aug,49180,47557,1623,3.3,"Nevada County, CA"
116,2022,Sep,48577,47141,1436,3.0,"Nevada County, CA"
117,2022,Oct,48554,46990,1564,3.2,"Nevada County, CA"
118,2022,Nov,48613,47017,1596,3.3,"Nevada County, CA"
119,2022,Dec,49054,47527,1527,3.1,"Nevada County, CA"
120,2023,Jan,49027,47066,1961,4.0,"Nevada County, CA"
121,2023,Feb,49048,47026,2022,4.1,"Nevada County, CA"
122,2023,Mar,48786,46725,2061,4.2,"Nevada County, CA"
123,2023,Apr,47232,45475,1757,3.7,"Nevada County, CA"
124,2023,May,47072,45309,1763,3.7,"Nevada County, CA"
125,2023,Jun,46989,45097,1892,4.0,"Nevada County, CA"
126,2023,Jul,47716,45878,1838,3.9,"Nevada County, CA"
127,2023,Aug,47639,45644,1995,4.2,"Nevada County, CA"
128,2023,Sep,47580,45694,1886,4.0,"Nevada County, CA"
129,2023,Oct,47424,45534,1890,4.0,"Nevada County, CA"
0,2013,Jan,11575,10058,1517,13.1,"Lassen County, CA"
1,2013,Feb,10846,9415,1431,13.2,"Lassen County, CA"
2,2013,Mar,10818,9458,1360,12.6,"Lassen County, CA"
3,2013,Apr,10812,9616,1196,11.1,"Lassen County, CA"
4,2013,May,10840,9772,1068,9.9,"Lassen County, CA"
5,2013,Jun,10760,9636,1124,10.4,"Lassen County, CA"
6,2013,Jul,10864,9756,1108,10.2,"Lassen County, CA"
7,2013,Aug,10892,9848,1044,9.6,"Lassen County, CA"
8,2013,Sep,11353,10367,986,8.7,"Lassen County, CA"
9,2013,Oct,11331,10290,1041,9.2,"Lassen County, CA"
10,2013,Nov,10815,9692,1123,10.4,"Lassen County, CA"
11,2013,Dec,10714,9583,1131,10.6,"Lassen County, CA"
12,2014,Jan,11152,9869,1283,11.5,"Lassen County, CA"
13,2014,Feb,10570,9262,1308,12.4,"Lassen County, CA"
14,2014,Mar,10702,9427,1275,11.9,"Lassen County, CA"
15,2014,Apr,10651,9595,1056,9.9,"Lassen County, CA"
16,2014,May,10694,9784,910,8.5,"Lassen County, CA"
17,2014,Jun,10592,9660,932,8.8,"Lassen County, CA"
18,2014,Jul,10611,9674,937,8.8,"Lassen County, CA"
19,2014,Aug,10557,9676,881,8.3,"Lassen County, CA"
20,2014,Sep,10714,9920,794,7.4,"Lassen County, CA"
21,2014,Oct,11619,10837,782,6.7,"Lassen County, CA"
22,2014,Nov,10810,9940,870,8.0,"Lassen County, CA"
23,2014,Dec,10907,9997,910,8.3,"Lassen County, CA"
24,2015,Jan,11095,10055,1040,9.4,"Lassen County, CA"
25,2015,Feb,11003,10002,1001,9.1,"Lassen County, CA"
26,2015,Mar,10598,9671,927,8.7,"Lassen County, CA"
27,2015,Apr,10572,9763,809,7.7,"Lassen County, CA"
28,2015,May,10797,10056,741,6.9,"Lassen County, CA"
29,2015,Jun,10778,10042,736,6.8,"Lassen County, CA"
30,2015,Jul,10569,9837,732,6.9,"Lassen County, CA"
31,2015,Aug,10518,9837,681,6.5,"Lassen County, CA"
32,2015,Sep,10657,10044,613,5.8,"Lassen County, CA"
33,2015,Oct,11367,10740,627,5.5,"Lassen County, CA"
34,2015,Nov,10939,10227,712,6.5,"Lassen County, CA"
35,2015,Dec,10232,9462,770,7.5,"Lassen County, CA"
36,2016,Jan,10710,9785,925,8.6,"Lassen County, CA"
37,2016,Feb,10279,9363,916,8.9,"Lassen County, CA"
38,2016,Mar,10348,9444,904,8.7,"Lassen County, CA"
39,2016,Apr,10308,9574,734,7.1,"Lassen County, CA"
40,2016,May,10344,9712,632,6.1,"Lassen County, CA"
41,2016,Jun,10381,9711,670,6.5,"Lassen County, CA"
42,2016,Jul,10156,9493,663,6.5,"Lassen County, CA"
43,2016,Aug,10124,9502,622,6.1,"Lassen County, CA"
44,2016,Sep,10709,10109,600,5.6,"Lassen County, CA"
45,2016,Oct,11074,10476,598,5.4,"Lassen County, CA"
46,2016,Nov,10014,9367,647,6.5,"Lassen County, CA"
47,2016,Dec,9901,9164,737,7.4,"Lassen County, CA"
48,2017,Jan,9877,9158,719,7.3,"Lassen County, CA"
49,2017,Feb,9836,9096,740,7.5,"Lassen County, CA"
50,2017,Mar,9817,9121,696,7.1,"Lassen County, CA"
51,2017,Apr,9904,9290,614,6.2,"Lassen County, CA"
52,2017,May,9985,9479,506,5.1,"Lassen County, CA"
53,2017,Jun,9930,9398,532,5.4,"Lassen County, CA"
54,2017,Jul,9958,9430,528,5.3,"Lassen County, CA"
55,2017,Aug,9898,9390,508,5.1,"Lassen County, CA"
56,2017,Sep,10090,9645,445,4.4,"Lassen County, CA"
57,2017,Oct,10829,10395,434,4.0,"Lassen County, CA"
58,2017,Nov,10467,10010,457,4.4,"Lassen County, CA"
59,2017,Dec,9712,9216,496,5.1,"Lassen County, CA"
60,2018,Jan,9855,9274,581,5.9,"Lassen County, CA"
61,2018,Feb,9872,9247,625,6.3,"Lassen County, CA"
62,2018,Mar,9579,8983,596,6.2,"Lassen County, CA"
63,2018,Apr,9596,9092,504,5.3,"Lassen County, CA"
64,2018,May,9781,9374,407,4.2,"Lassen County, CA"
65,2018,Jun,9704,9247,457,4.7,"Lassen County, CA"
66,2018,Jul,9732,9290,442,4.5,"Lassen County, CA"
67,2018,Aug,9753,9321,432,4.4,"Lassen County, CA"
68,2018,Sep,9853,9470,383,3.9,"Lassen County, CA"
69,2018,Oct,10531,10139,392,3.7,"Lassen County, CA"
70,2018,Nov,10358,9950,408,3.9,"Lassen County, CA"
71,2018,Dec,9635,9164,471,4.9,"Lassen County, CA"
72,2019,Jan,9933,9324,609,6.1,"Lassen County, CA"
73,2019,Feb,9956,9365,591,5.9,"Lassen County, CA"
74,2019,Mar,9820,9226,594,6.0,"Lassen County, CA"
75,2019,Apr,9545,9065,480,5.0,"Lassen County, CA"
76,2019,May,9617,9224,393,4.1,"Lassen County, CA"
77,2019,Jun,9539,9100,439,4.6,"Lassen County, CA"
78,2019,Jul,9511,9061,450,4.7,"Lassen County, CA"
79,2019,Aug,9501,9095,406,4.3,"Lassen County, CA"
80,2019,Sep,9605,9269,336,3.5,"Lassen County, CA"
81,2019,Oct,10283,9933,350,3.4,"Lassen County, CA"
82,2019,Nov,10231,9857,374,3.7,"Lassen County, CA"
83,2019,Dec,9278,8865,413,4.5,"Lassen County, CA"
84,2020,Jan,9444,8885,559,5.9,"Lassen County, CA"
85,2020,Feb,9487,8929,558,5.9,"Lassen County, CA"
86,2020,Mar,9581,8798,783,8.2,"Lassen County, CA"
87,2020,Apr,9418,8319,1099,11.7,"Lassen County, CA"
88,2020,May,9271,8371,900,9.7,"Lassen County, CA"
89,2020,Jun,9484,8713,771,8.1,"Lassen County, CA"
90,2020,Jul,9374,8627,747,8.0,"Lassen County, CA"
91,2020,Aug,9393,8788,605,6.4,"Lassen County, CA"
92,2020,Sep,9474,8892,582,6.1,"Lassen County, CA"
93,2020,Oct,9830,9293,537,5.5,"Lassen County, CA"
94,2020,Nov,9261,8688,573,6.2,"Lassen County, CA"
95,2020,Dec,9138,8501,637,7.0,"Lassen County, CA"
96,2021,Jan,9276,8586,690,7.4,"Lassen County, CA"
97,2021,Feb,9232,8518,714,7.7,"Lassen County, CA"
98,2021,Mar,9246,8562,684,7.4,"Lassen County, CA"
99,2021,Apr,9154,8532,622,6.8,"Lassen County, CA"
100,2021,May,9237,8701,536,5.8,"Lassen County, CA"
101,2021,Jun,9311,8732,579,6.2,"Lassen County, CA"
102,2021,Jul,9051,8483,568,6.3,"Lassen County, CA"
103,2021,Aug,9064,8505,559,6.2,"Lassen County, CA"
104,2021,Sep,9181,8722,459,5.0,"Lassen County, CA"
105,2021,Oct,9463,9024,439,4.6,"Lassen County, CA"
106,2021,Nov,8904,8488,416,4.7,"Lassen County, CA"
107,2021,Dec,8746,8325,421,4.8,"Lassen County, CA"
108,2022,Jan,8849,8300,549,6.2,"Lassen County, CA"
109,2022,Feb,8775,8250,525,6.0,"Lassen County, CA"
110,2022,Mar,8802,8328,474,5.4,"Lassen County, CA"
111,2022,Apr,8684,8324,360,4.1,"Lassen County, CA"
112,2022,May,8795,8486,309,3.5,"Lassen County, CA"
113,2022,Jun,8745,8390,355,4.1,"Lassen County, CA"
114,2022,Jul,8553,8183,370,4.3,"Lassen County, CA"
115,2022,Aug,8741,8366,375,4.3,"Lassen County, CA"
116,2022,Sep,9299,8975,324,3.5,"Lassen County, CA"
117,2022,Oct,9856,9511,345,3.5,"Lassen County, CA"
118,2022,Nov,9403,9015,388,4.1,"Lassen County, CA"
119,2022,Dec,8867,8459,408,4.6,"Lassen County, CA"
120,2023,Jan,8952,8411,541,6.0,"Lassen County, CA"
121,2023,Feb,8947,8367,580,6.5,"Lassen County, CA"
122,2023,Mar,8985,8426,559,6.2,"Lassen County, CA"
123,2023,Apr,8729,8282,447,5.1,"Lassen County, CA"
124,2023,May,8810,8400,410,4.7,"Lassen County, CA"
125,2023,Jun,8746,8341,405,4.6,"Lassen County, CA"
126,2023,Jul,8572,8175,397,4.6,"Lassen County, CA"
127,2023,Aug,8771,8350,421,4.8,"Lassen County, CA"
128,2023,Sep,9003,8622,381,4.2,"Lassen County, CA"
129,2023,Oct,9480,9094,386,4.1,"Lassen County, CA"
0,2013,Jan,463031,426008,37023,8.0,"Pinellas County, FL"
1,2013,Feb,462065,427992,34073,7.4,"Pinellas County, FL"
2,2013,Mar,463014,430685,32329,7.0,"Pinellas County, FL"
3,2013,Apr,464963,433622,31341,6.7,"Pinellas County, FL"
4,2013,May,471427,439060,32367,6.9,"Pinellas County, FL"
5,2013,Jun,474045,439818,34227,7.2,"Pinellas County, FL"
6,2013,Jul,475233,441552,33681,7.1,"Pinellas County, FL"
7,2013,Aug,474276,441350,32926,6.9,"Pinellas County, FL"
8,2013,Sep,474980,443128,31852,6.7,"Pinellas County, FL"
9,2013,Oct,470878,439432,31446,6.7,"Pinellas County, FL"
10,2013,Nov,467307,437246,30061,6.4,"Pinellas County, FL"
11,2013,Dec,465377,436824,28553,6.1,"Pinellas County, FL"
12,2014,Jan,463287,432953,30334,6.5,"Pinellas County, FL"
13,2014,Feb,465028,435411,29617,6.4,"Pinellas County, FL"
14,2014,Mar,468567,439326,29241,6.2,"Pinellas County, FL"
15,2014,Apr,467100,440713,26387,5.6,"Pinellas County, FL"
16,2014,May,473066,444957,28109,5.9,"Pinellas County, FL"
17,2014,Jun,473945,445324,28621,6.0,"Pinellas County, FL"
18,2014,Jul,475703,445999,29704,6.2,"Pinellas County, FL"
19,2014,Aug,474934,445895,29039,6.1,"Pinellas County, FL"
20,2014,Sep,475674,448650,27024,5.7,"Pinellas County, FL"
21,2014,Oct,474632,448132,26500,5.6,"Pinellas County, FL"
22,2014,Nov,470241,443876,26365,5.6,"Pinellas County, FL"
23,2014,Dec,468567,443819,24748,5.3,"Pinellas County, FL"
24,2015,Jan,465891,439245,26646,5.7,"Pinellas County, FL"
25,2015,Feb,465597,440961,24636,5.3,"Pinellas County, FL"
26,2015,Mar,466924,443360,23564,5.0,"Pinellas County, FL"
27,2015,Apr,468161,445448,22713,4.9,"Pinellas County, FL"
28,2015,May,474073,450070,24003,5.1,"Pinellas County, FL"
29,2015,Jun,475410,451244,24166,5.1,"Pinellas County, FL"
30,2015,Jul,475851,451163,24688,5.2,"Pinellas County, FL"
31,2015,Aug,475244,451297,23947,5.0,"Pinellas County, FL"
32,2015,Sep,475946,453241,22705,4.8,"Pinellas County, FL"
33,2015,Oct,477205,454378,22827,4.8,"Pinellas County, FL"
34,2015,Nov,474780,452489,22291,4.7,"Pinellas County, FL"
35,2015,Dec,474505,453204,21301,4.5,"Pinellas County, FL"
36,2016,Jan,471625,449333,22292,4.7,"Pinellas County, FL"
37,2016,Feb,474459,453530,20929,4.4,"Pinellas County, FL"
38,2016,Mar,475791,455038,20753,4.4,"Pinellas County, FL"
39,2016,Apr,476410,456525,19885,4.2,"Pinellas County, FL"
40,2016,May,480365,460557,19808,4.1,"Pinellas County, FL"
41,2016,Jun,481816,460203,21613,4.5,"Pinellas County, FL"
42,2016,Jul,483692,461430,22262,4.6,"Pinellas County, FL"
43,2016,Aug,482618,460639,21979,4.6,"Pinellas County, FL"
44,2016,Sep,485671,463907,21764,4.5,"Pinellas County, FL"
45,2016,Oct,485112,463921,21191,4.4,"Pinellas County, FL"
46,2016,Nov,480186,459805,20381,4.2,"Pinellas County, FL"
47,2016,Dec,479519,459805,19714,4.1,"Pinellas County, FL"
48,2017,Jan,473537,452178,21359,4.5,"Pinellas County, FL"
49,2017,Feb,475605,455770,19835,4.2,"Pinellas County, FL"
50,2017,Mar,477170,458614,18556,3.9,"Pinellas County, FL"
51,2017,Apr,478212,460580,17632,3.7,"Pinellas County, FL"
52,2017,May,479917,461684,18233,3.8,"Pinellas County, FL"
53,2017,Jun,483651,464456,19195,4.0,"Pinellas County, FL"
54,2017,Jul,484427,464900,19527,4.0,"Pinellas County, FL"
55,2017,Aug,483030,463348,19682,4.1,"Pinellas County, FL"
56,2017,Sep,486359,468214,18145,3.7,"Pinellas County, FL"
57,2017,Oct,483180,465558,17622,3.6,"Pinellas County, FL"
58,2017,Nov,480302,462744,17558,3.7,"Pinellas County, FL"
59,2017,Dec,478817,462154,16663,3.5,"Pinellas County, FL"
60,2018,Jan,474431,456145,18286,3.9,"Pinellas County, FL"
61,2018,Feb,477390,460399,16991,3.6,"Pinellas County, FL"
62,2018,Mar,477770,461319,16451,3.4,"Pinellas County, FL"
63,2018,Apr,478070,462734,15336,3.2,"Pinellas County, FL"
64,2018,May,480908,465335,15573,3.2,"Pinellas County, FL"
65,2018,Jun,485331,467422,17909,3.7,"Pinellas County, FL"
66,2018,Jul,486104,468817,17287,3.6,"Pinellas County, FL"
67,2018,Aug,484109,467073,17036,3.5,"Pinellas County, FL"
68,2018,Sep,487089,471521,15568,3.2,"Pinellas County, FL"
69,2018,Oct,487011,471278,15733,3.2,"Pinellas County, FL"
70,2018,Nov,482803,467568,15235,3.2,"Pinellas County, FL"
71,2018,Dec,482276,467112,15164,3.1,"Pinellas County, FL"
72,2019,Jan,474614,457300,17314,3.6,"Pinellas County, FL"
73,2019,Feb,476312,461003,15309,3.2,"Pinellas County, FL"
74,2019,Mar,476417,461379,15038,3.2,"Pinellas County, FL"
75,2019,Apr,476260,462794,13466,2.8,"Pinellas County, FL"
76,2019,May,480728,466439,14289,3.0,"Pinellas County, FL"
77,2019,Jun,484917,468932,15985,3.3,"Pinellas County, FL"
78,2019,Jul,486609,470485,16124,3.3,"Pinellas County, FL"
79,2019,Aug,486823,470711,16112,3.3,"Pinellas County, FL"
80,2019,Sep,490740,476373,14367,2.9,"Pinellas County, FL"
81,2019,Oct,489732,475528,14204,2.9,"Pinellas County, FL"
82,2019,Nov,487193,473287,13906,2.9,"Pinellas County, FL"
83,2019,Dec,487398,474550,12848,2.6,"Pinellas County, FL"
84,2020,Jan,481366,466495,14871,3.1,"Pinellas County, FL"
85,2020,Feb,483660,470516,13144,2.7,"Pinellas County, FL"
86,2020,Mar,475839,456075,19764,4.2,"Pinellas County, FL"
87,2020,Apr,450233,389384,60849,13.5,"Pinellas County, FL"
88,2020,May,477901,414027,63874,13.4,"Pinellas County, FL"
89,2020,Jun,477454,427458,49996,10.5,"Pinellas County, FL"
90,2020,Jul,485436,431815,53621,11.0,"Pinellas County, FL"
91,2020,Aug,479502,442218,37284,7.8,"Pinellas County, FL"
92,2020,Sep,479907,445809,34098,7.1,"Pinellas County, FL"
93,2020,Oct,481878,453195,28683,6.0,"Pinellas County, FL"
94,2020,Nov,477236,450749,26487,5.6,"Pinellas County, FL"
95,2020,Dec,477079,452072,25007,5.2,"Pinellas County, FL"
96,2021,Jan,476833,452481,24352,5.1,"Pinellas County, FL"
97,2021,Feb,478737,456517,22220,4.6,"Pinellas County, FL"
98,2021,Mar,481436,460105,21331,4.4,"Pinellas County, FL"
99,2021,Apr,481995,461800,20195,4.2,"Pinellas County, FL"
100,2021,May,485112,465575,19537,4.0,"Pinellas County, FL"
101,2021,Jun,491525,469103,22422,4.6,"Pinellas County, FL"
102,2021,Jul,492236,471107,21129,4.3,"Pinellas County, FL"
103,2021,Aug,493117,472709,20408,4.1,"Pinellas County, FL"
104,2021,Sep,497033,478718,18315,3.7,"Pinellas County, FL"
105,2021,Oct,497848,480602,17246,3.5,"Pinellas County, FL"
106,2021,Nov,497298,480865,16433,3.3,"Pinellas County, FL"
107,2021,Dec,497889,483635,14254,2.9,"Pinellas County, FL"
108,2022,Jan,500873,483443,17430,3.5,"Pinellas County, FL"
109,2022,Feb,501016,485984,15032,3.0,"Pinellas County, FL"
110,2022,Mar,503948,490329,13619,2.7,"Pinellas County, FL"
111,2022,Apr,505533,493391,12142,2.4,"Pinellas County, FL"
112,2022,May,508885,496311,12574,2.5,"Pinellas County, FL"
113,2022,Jun,513570,499050,14520,2.8,"Pinellas County, FL"
114,2022,Jul,512154,498527,13627,2.7,"Pinellas County, FL"
115,2022,Aug,514269,500277,13992,2.7,"Pinellas County, FL"
116,2022,Sep,516337,503446,12891,2.5,"Pinellas County, FL"
117,2022,Oct,516694,503921,12773,2.5,"Pinellas County, FL"
118,2022,Nov,514964,502591,12373,2.4,"Pinellas County, FL"
119,2022,Dec,515727,504691,11036,2.1,"Pinellas County, FL"
120,2023,Jan,516995,504350,12645,2.4,"Pinellas County, FL"
121,2023,Feb,521756,509130,12626,2.4,"Pinellas County, FL"
122,2023,Mar,526733,513934,12799,2.4,"Pinellas County, FL"
123,2023,Apr,526349,515187,11162,2.1,"Pinellas County, FL"
124,2023,May,528247,515177,13070,2.5,"Pinellas County, FL"
125,2023,Jun,535735,521237,14498,2.7,"Pinellas County, FL"
126,2023,Jul,535512,520131,15381,2.9,"Pinellas County, FL"
127,2023,Aug,538285,522230,16055,3.0,"Pinellas County, FL"
128,2023,Sep,539439,523274,16165,3.0,"Pinellas County, FL"
129,2023,Oct,537161,521304,15857,3.0,"Pinellas County, FL"
0,2013,Jan,65644,58649,6995,10.7,"Hernando County, FL"
1,2013,Feb,65392,58926,6466,9.9,"Hernando County, FL"
2,2013,Mar,65375,59221,6154,9.4,"Hernando County, FL"
3,2013,Apr,65529,59602,5927,9.0,"Hernando County, FL"
4,2013,May,66502,60336,6166,9.3,"Hernando County, FL"
5,2013,Jun,67023,60478,6545,9.8,"Hernando County, FL"
6,2013,Jul,67185,60767,6418,9.6,"Hernando County, FL"
7,2013,Aug,66967,60694,6273,9.4,"Hernando County, FL"
8,2013,Sep,67042,60955,6087,9.1,"Hernando County, FL"
9,2013,Oct,66454,60413,6041,9.1,"Hernando County, FL"
10,2013,Nov,65929,60149,5780,8.8,"Hernando County, FL"
11,2013,Dec,65602,60085,5517,8.4,"Hernando County, FL"
12,2014,Jan,65301,59446,5855,9.0,"Hernando County, FL"
13,2014,Feb,65541,59790,5751,8.8,"Hernando County, FL"
14,2014,Mar,65972,60274,5698,8.6,"Hernando County, FL"
15,2014,Apr,65543,60403,5140,7.8,"Hernando County, FL"
16,2014,May,66362,60996,5366,8.1,"Hernando County, FL"
17,2014,Jun,66595,61104,5491,8.2,"Hernando County, FL"
18,2014,Jul,66944,61235,5709,8.5,"Hernando County, FL"
19,2014,Aug,66804,61187,5617,8.4,"Hernando County, FL"
20,2014,Sep,66838,61594,5244,7.8,"Hernando County, FL"
21,2014,Oct,66634,61524,5110,7.7,"Hernando County, FL"
22,2014,Nov,66030,60935,5095,7.7,"Hernando County, FL"
23,2014,Dec,65695,60885,4810,7.3,"Hernando County, FL"
24,2015,Jan,65656,60446,5210,7.9,"Hernando County, FL"
25,2015,Feb,65420,60590,4830,7.4,"Hernando County, FL"
26,2015,Mar,65513,60916,4597,7.0,"Hernando County, FL"
27,2015,Apr,65666,61180,4486,6.8,"Hernando County, FL"
28,2015,May,66609,61830,4779,7.2,"Hernando County, FL"
29,2015,Jun,66892,62025,4867,7.3,"Hernando County, FL"
30,2015,Jul,66981,62042,4939,7.4,"Hernando County, FL"
31,2015,Aug,66794,62079,4715,7.1,"Hernando County, FL"
32,2015,Sep,66783,62326,4457,6.7,"Hernando County, FL"
33,2015,Oct,66969,62507,4462,6.7,"Hernando County, FL"
34,2015,Nov,66667,62249,4418,6.6,"Hernando County, FL"
35,2015,Dec,66519,62289,4230,6.4,"Hernando County, FL"
36,2016,Jan,67088,62652,4436,6.6,"Hernando County, FL"
37,2016,Feb,67329,63190,4139,6.1,"Hernando County, FL"
38,2016,Mar,67475,63415,4060,6.0,"Hernando County, FL"
39,2016,Apr,67522,63595,3927,5.8,"Hernando County, FL"
40,2016,May,68067,64141,3926,5.8,"Hernando County, FL"
41,2016,Jun,68559,64264,4295,6.3,"Hernando County, FL"
42,2016,Jul,68765,64403,4362,6.3,"Hernando County, FL"
43,2016,Aug,68632,64310,4322,6.3,"Hernando County, FL"
44,2016,Sep,69072,64754,4318,6.3,"Hernando County, FL"
45,2016,Oct,68982,64793,4189,6.1,"Hernando County, FL"
46,2016,Nov,68283,64210,4073,6.0,"Hernando County, FL"
47,2016,Dec,68052,64165,3887,5.7,"Hernando County, FL"
48,2017,Jan,68136,63888,4248,6.2,"Hernando County, FL"
49,2017,Feb,68276,64364,3912,5.7,"Hernando County, FL"
50,2017,Mar,68382,64758,3624,5.3,"Hernando County, FL"
51,2017,Apr,68305,64886,3419,5.0,"Hernando County, FL"
52,2017,May,68673,65112,3561,5.2,"Hernando County, FL"
53,2017,Jun,69405,65610,3795,5.5,"Hernando County, FL"
54,2017,Jul,69493,65619,3874,5.6,"Hernando County, FL"
55,2017,Aug,69304,65409,3895,5.6,"Hernando County, FL"
56,2017,Sep,69619,66093,3526,5.1,"Hernando County, FL"
57,2017,Oct,69272,65799,3473,5.0,"Hernando County, FL"
58,2017,Nov,68903,65420,3483,5.1,"Hernando County, FL"
59,2017,Dec,68549,65255,3294,4.8,"Hernando County, FL"
60,2018,Jan,69287,65588,3699,5.3,"Hernando County, FL"
61,2018,Feb,69571,66171,3400,4.9,"Hernando County, FL"
62,2018,Mar,69675,66374,3301,4.7,"Hernando County, FL"
63,2018,Apr,69614,66574,3040,4.4,"Hernando County, FL"
64,2018,May,69967,66916,3051,4.4,"Hernando County, FL"
65,2018,Jun,70819,67217,3602,5.1,"Hernando County, FL"
66,2018,Jul,70816,67365,3451,4.9,"Hernando County, FL"
67,2018,Aug,70485,67114,3371,4.8,"Hernando County, FL"
68,2018,Sep,70892,67783,3109,4.4,"Hernando County, FL"
69,2018,Oct,70900,67771,3129,4.4,"Hernando County, FL"
70,2018,Nov,70238,67220,3018,4.3,"Hernando County, FL"
71,2018,Dec,70071,67043,3028,4.3,"Hernando County, FL"
72,2019,Jan,70343,66802,3541,5.0,"Hernando County, FL"
73,2019,Feb,70470,67309,3161,4.5,"Hernando County, FL"
74,2019,Mar,70455,67397,3058,4.3,"Hernando County, FL"
75,2019,Apr,70313,67585,2728,3.9,"Hernando County, FL"
76,2019,May,71069,68145,2924,4.1,"Hernando County, FL"
77,2019,Jun,71857,68506,3351,4.7,"Hernando County, FL"
78,2019,Jul,72088,68744,3344,4.6,"Hernando County, FL"
79,2019,Aug,72060,68755,3305,4.6,"Hernando County, FL"
80,2019,Sep,72597,69600,2997,4.1,"Hernando County, FL"
81,2019,Oct,72473,69492,2981,4.1,"Hernando County, FL"
82,2019,Nov,71988,69134,2854,4.0,"Hernando County, FL"
83,2019,Dec,71945,69280,2665,3.7,"Hernando County, FL"
84,2020,Jan,72846,69749,3097,4.3,"Hernando County, FL"
85,2020,Feb,73119,70353,2766,3.8,"Hernando County, FL"
86,2020,Mar,72289,68198,4091,5.7,"Hernando County, FL"
87,2020,Apr,67404,58123,9281,13.8,"Hernando County, FL"
88,2020,May,71942,61838,10104,14.0,"Hernando County, FL"
89,2020,Jun,72030,63839,8191,11.4,"Hernando County, FL"
90,2020,Jul,73361,64483,8878,12.1,"Hernando County, FL"
91,2020,Aug,72282,66006,6276,8.7,"Hernando County, FL"
92,2020,Sep,72383,66529,5854,8.1,"Hernando County, FL"
93,2020,Oct,72689,67632,5057,7.0,"Hernando County, FL"
94,2020,Nov,71954,67259,4695,6.5,"Hernando County, FL"
95,2020,Dec,71948,67468,4480,6.2,"Hernando County, FL"
96,2021,Jan,72118,67574,4544,6.3,"Hernando County, FL"
97,2021,Feb,72308,68142,4166,5.8,"Hernando County, FL"
98,2021,Mar,72753,68665,4088,5.6,"Hernando County, FL"
99,2021,Apr,72691,68890,3801,5.2,"Hernando County, FL"
100,2021,May,73214,69499,3715,5.1,"Hernando County, FL"
101,2021,Jun,74268,70009,4259,5.7,"Hernando County, FL"
102,2021,Jul,74495,70366,4129,5.5,"Hernando County, FL"
103,2021,Aug,74543,70522,4021,5.4,"Hernando County, FL"
104,2021,Sep,74952,71378,3574,4.8,"Hernando County, FL"
105,2021,Oct,75117,71717,3400,4.5,"Hernando County, FL"
106,2021,Nov,74833,71639,3194,4.3,"Hernando County, FL"
107,2021,Dec,74930,72072,2858,3.8,"Hernando County, FL"
108,2022,Jan,75604,72106,3498,4.6,"Hernando County, FL"
109,2022,Feb,75547,72453,3094,4.1,"Hernando County, FL"
110,2022,Mar,75897,73106,2791,3.7,"Hernando County, FL"
111,2022,Apr,76129,73629,2500,3.3,"Hernando County, FL"
112,2022,May,76706,74138,2568,3.3,"Hernando County, FL"
113,2022,Jun,77476,74502,2974,3.8,"Hernando County, FL"
114,2022,Jul,77237,74418,2819,3.6,"Hernando County, FL"
115,2022,Aug,77522,74645,2877,3.7,"Hernando County, FL"
116,2022,Sep,77713,75094,2619,3.4,"Hernando County, FL"
117,2022,Oct,77826,75245,2581,3.3,"Hernando County, FL"
118,2022,Nov,77403,74906,2497,3.2,"Hernando County, FL"
119,2022,Dec,77448,75239,2209,2.9,"Hernando County, FL"
120,2023,Jan,77802,75264,2538,3.3,"Hernando County, FL"
121,2023,Feb,78530,75989,2541,3.2,"Hernando County, FL"
122,2023,Mar,79316,76694,2622,3.3,"Hernando County, FL"
123,2023,Apr,79250,76935,2315,2.9,"Hernando County, FL"
124,2023,May,79618,76902,2716,3.4,"Hernando County, FL"
125,2023,Jun,80908,77777,3131,3.9,"Hernando County, FL"
126,2023,Jul,80844,77640,3204,4.0,"Hernando County, FL"
127,2023,Aug,81219,77918,3301,4.1,"Hernando County, FL"
128,2023,Sep,81372,78061,3311,4.1,"Hernando County, FL"
129,2023,Oct,81196,77831,3365,4.1,"Hernando County, FL"
0,2013,Jan,799932,732719,67213,8.4,"Alameda County, CA"
1,2013,Feb,799186,735893,63293,7.9,"Alameda County, CA"
2,2013,Mar,798506,737347,61159,7.7,"Alameda County, CA"
3,2013,Apr,795215,738885,56330,7.1,"Alameda County, CA"
4,2013,May,798026,741440,56586,7.1,"Alameda County, CA"
5,2013,Jun,799309,737339,61970,7.8,"Alameda County, CA"
6,2013,Jul,807491,745036,62455,7.7,"Alameda County, CA"
7,2013,Aug,801800,742264,59536,7.4,"Alameda County, CA"
8,2013,Sep,803080,746759,56321,7.0,"Alameda County, CA"
9,2013,Oct,798961,742857,56104,7.0,"Alameda County, CA"
10,2013,Nov,800290,747267,53023,6.6,"Alameda County, CA"
11,2013,Dec,796360,746853,49507,6.2,"Alameda County, CA"
12,2014,Jan,797332,744833,52499,6.6,"Alameda County, CA"
13,2014,Feb,801545,749101,52444,6.5,"Alameda County, CA"
14,2014,Mar,803957,751615,52342,6.5,"Alameda County, CA"
15,2014,Apr,796757,752176,44581,5.6,"Alameda County, CA"
16,2014,May,802379,757056,45323,5.6,"Alameda County, CA"
17,2014,Jun,805775,757527,48248,6.0,"Alameda County, CA"
18,2014,Jul,813248,761544,51704,6.4,"Alameda County, CA"
19,2014,Aug,808902,759025,49877,6.2,"Alameda County, CA"
20,2014,Sep,809169,763911,45258,5.6,"Alameda County, CA"
21,2014,Oct,812509,768000,44509,5.5,"Alameda County, CA"
22,2014,Nov,814301,770713,43588,5.4,"Alameda County, CA"
23,2014,Dec,810033,770322,39711,4.9,"Alameda County, CA"
24,2015,Jan,811467,767571,43896,5.4,"Alameda County, CA"
25,2015,Feb,813116,771563,41553,5.1,"Alameda County, CA"
26,2015,Mar,815326,774308,41018,5.0,"Alameda County, CA"
27,2015,Apr,813628,775747,37881,4.7,"Alameda County, CA"
28,2015,May,818460,780342,38118,4.7,"Alameda County, CA"
29,2015,Jun,818763,778224,40539,5.0,"Alameda County, CA"
30,2015,Jul,824752,782624,42128,5.1,"Alameda County, CA"
31,2015,Aug,822024,782176,39848,4.8,"Alameda County, CA"
32,2015,Sep,820266,783862,36404,4.4,"Alameda County, CA"
33,2015,Oct,822157,785093,37064,4.5,"Alameda County, CA"
34,2015,Nov,823791,787507,36284,4.4,"Alameda County, CA"
35,2015,Dec,824337,789744,34593,4.2,"Alameda County, CA"
36,2016,Jan,823113,786316,36797,4.5,"Alameda County, CA"
37,2016,Feb,828349,791797,36552,4.4,"Alameda County, CA"
38,2016,Mar,831325,793973,37352,4.5,"Alameda County, CA"
39,2016,Apr,825493,790809,34684,4.2,"Alameda County, CA"
40,2016,May,826660,794634,32026,3.9,"Alameda County, CA"
41,2016,Jun,830227,792327,37900,4.6,"Alameda County, CA"
42,2016,Jul,837682,798594,39088,4.7,"Alameda County, CA"
43,2016,Aug,834229,796191,38038,4.6,"Alameda County, CA"
44,2016,Sep,837331,801438,35893,4.3,"Alameda County, CA"
45,2016,Oct,837492,801744,35748,4.3,"Alameda County, CA"
46,2016,Nov,836390,803103,33287,4.0,"Alameda County, CA"
47,2016,Dec,833630,801520,32110,3.9,"Alameda County, CA"
48,2017,Jan,834686,798811,35875,4.3,"Alameda County, CA"
49,2017,Feb,838000,804165,33835,4.0,"Alameda County, CA"
50,2017,Mar,840414,807951,32463,3.9,"Alameda County, CA"
51,2017,Apr,831779,802059,29720,3.6,"Alameda County, CA"
52,2017,May,834053,805347,28706,3.4,"Alameda County, CA"
53,2017,Jun,836637,803640,32997,3.9,"Alameda County, CA"
54,2017,Jul,844686,810062,34624,4.1,"Alameda County, CA"
55,2017,Aug,839338,805481,33857,4.0,"Alameda County, CA"
56,2017,Sep,842979,813600,29379,3.5,"Alameda County, CA"
57,2017,Oct,839776,811466,28310,3.4,"Alameda County, CA"
58,2017,Nov,838868,811745,27123,3.2,"Alameda County, CA"
59,2017,Dec,836876,810867,26009,3.1,"Alameda County, CA"
60,2018,Jan,833344,804748,28596,3.4,"Alameda County, CA"
61,2018,Feb,841267,813888,27379,3.3,"Alameda County, CA"
62,2018,Mar,842548,816549,25999,3.1,"Alameda County, CA"
63,2018,Apr,835525,811890,23635,2.8,"Alameda County, CA"
64,2018,May,839132,817067,22065,2.6,"Alameda County, CA"
65,2018,Jun,840532,813084,27448,3.3,"Alameda County, CA"
66,2018,Jul,848214,820853,27361,3.2,"Alameda County, CA"
67,2018,Aug,840679,813770,26909,3.2,"Alameda County, CA"
68,2018,Sep,844111,819484,24627,2.9,"Alameda County, CA"
69,2018,Oct,844484,819268,25216,3.0,"Alameda County, CA"
70,2018,Nov,844737,820054,24683,2.9,"Alameda County, CA"
71,2018,Dec,844351,819431,24920,3.0,"Alameda County, CA"
72,2019,Jan,840944,811170,29774,3.5,"Alameda County, CA"
73,2019,Feb,846928,820523,26405,3.1,"Alameda County, CA"
74,2019,Mar,846787,820031,26756,3.2,"Alameda County, CA"
75,2019,Apr,834993,812722,22271,2.7,"Alameda County, CA"
76,2019,May,837271,815375,21896,2.6,"Alameda County, CA"
77,2019,Jun,838119,811990,26129,3.1,"Alameda County, CA"
78,2019,Jul,848237,820353,27884,3.3,"Alameda County, CA"
79,2019,Aug,843638,816966,26672,3.2,"Alameda County, CA"
80,2019,Sep,845652,822792,22860,2.7,"Alameda County, CA"
81,2019,Oct,844228,820366,23862,2.8,"Alameda County, CA"
82,2019,Nov,844409,820720,23689,2.8,"Alameda County, CA"
83,2019,Dec,845300,822830,22470,2.7,"Alameda County, CA"
84,2020,Jan,842338,816114,26224,3.1,"Alameda County, CA"
85,2020,Feb,850067,825137,24930,2.9,"Alameda County, CA"
86,2020,Mar,838367,801542,36825,4.4,"Alameda County, CA"
87,2020,Apr,806815,686897,119918,14.9,"Alameda County, CA"
88,2020,May,799499,686578,112921,14.1,"Alameda County, CA"
89,2020,Jun,822293,716770,105523,12.8,"Alameda County, CA"
90,2020,Jul,823200,724611,98589,12.0,"Alameda County, CA"
91,2020,Aug,815450,733779,81671,10.0,"Alameda County, CA"
92,2020,Sep,813898,736143,77755,9.6,"Alameda County, CA"
93,2020,Oct,813003,745368,67635,8.3,"Alameda County, CA"
94,2020,Nov,807375,743148,64227,8.0,"Alameda County, CA"
95,2020,Dec,803967,741794,62173,7.7,"Alameda County, CA"
96,2021,Jan,803030,741697,61333,7.6,"Alameda County, CA"
97,2021,Feb,808427,749402,59025,7.3,"Alameda County, CA"
98,2021,Mar,810089,753518,56571,7.0,"Alameda County, CA"
99,2021,Apr,805041,750114,54927,6.8,"Alameda County, CA"
100,2021,May,807854,757179,50675,6.3,"Alameda County, CA"
101,2021,Jun,813301,756819,56482,6.9,"Alameda County, CA"
102,2021,Jul,820567,767176,53391,6.5,"Alameda County, CA"
103,2021,Aug,816547,766263,50284,6.2,"Alameda County, CA"
104,2021,Sep,816174,774008,42166,5.2,"Alameda County, CA"
105,2021,Oct,817573,777259,40314,4.9,"Alameda County, CA"
106,2021,Nov,819172,783003,36169,4.4,"Alameda County, CA"
107,2021,Dec,817831,785242,32589,4.0,"Alameda County, CA"
108,2022,Jan,820283,784052,36231,4.4,"Alameda County, CA"
109,2022,Feb,825506,793422,32084,3.9,"Alameda County, CA"
110,2022,Mar,828575,799935,28640,3.5,"Alameda County, CA"
111,2022,Apr,816117,791361,24756,3.0,"Alameda County, CA"
112,2022,May,820999,798394,22605,2.8,"Alameda County, CA"
113,2022,Jun,822302,795561,26741,3.3,"Alameda County, CA"
114,2022,Jul,826482,799913,26569,3.2,"Alameda County, CA"
115,2022,Aug,827555,800155,27400,3.3,"Alameda County, CA"
116,2022,Sep,829021,804491,24530,3.0,"Alameda County, CA"
117,2022,Oct,831013,805011,26002,3.1,"Alameda County, CA"
118,2022,Nov,829318,802883,26435,3.2,"Alameda County, CA"
119,2022,Dec,830100,805675,24425,2.9,"Alameda County, CA"
120,2023,Jan,823276,793170,30106,3.7,"Alameda County, CA"
121,2023,Feb,832479,801063,31416,3.8,"Alameda County, CA"
122,2023,Mar,833885,802184,31701,3.8,"Alameda County, CA"
123,2023,Apr,825417,796830,28587,3.5,"Alameda County, CA"
124,2023,May,827432,796706,30726,3.7,"Alameda County, CA"
125,2023,Jun,825635,791065,34570,4.2,"Alameda County, CA"
126,2023,Jul,834290,799600,34690,4.2,"Alameda County, CA"
127,2023,Aug,831463,793858,37605,4.5,"Alameda County, CA"
128,2023,Sep,833949,798350,35599,4.3,"Alameda County, CA"
129,2023,Oct,832638,796242,36396,4.4,"Alameda County, CA"
0,2013,Jan,83531,75115,8416,10.1,"Bay County, FL"
1,2013,Feb,84113,76718,7395,8.8,"Bay County, FL"
2,2013,Mar,85975,79384,6591,7.7,"Bay County, FL"
3,2013,Apr,86192,79994,6198,7.2,"Bay County, FL"
4,2013,May,87301,81050,6251,7.2,"Bay County, FL"
5,2013,Jun,88758,82148,6610,7.4,"Bay County, FL"
6,2013,Jul,89298,82842,6456,7.2,"Bay County, FL"
7,2013,Aug,88344,82058,6286,7.1,"Bay County, FL"
8,2013,Sep,87453,81363,6090,7.0,"Bay County, FL"
9,2013,Oct,85854,79756,6098,7.1,"Bay County, FL"
10,2013,Nov,84138,77898,6240,7.4,"Bay County, FL"
11,2013,Dec,83559,77473,6086,7.3,"Bay County, FL"
12,2014,Jan,83829,77309,6520,7.8,"Bay County, FL"
13,2014,Feb,84973,78769,6204,7.3,"Bay County, FL"
14,2014,Mar,87586,81895,5691,6.5,"Bay County, FL"
15,2014,Apr,87554,82480,5074,5.8,"Bay County, FL"
16,2014,May,89026,83465,5561,6.2,"Bay County, FL"
17,2014,Jun,90337,84657,5680,6.3,"Bay County, FL"
18,2014,Jul,90721,84838,5883,6.5,"Bay County, FL"
19,2014,Aug,89388,83596,5792,6.5,"Bay County, FL"
20,2014,Sep,88203,82782,5421,6.1,"Bay County, FL"
21,2014,Oct,87219,81789,5430,6.2,"Bay County, FL"
22,2014,Nov,85562,79916,5646,6.6,"Bay County, FL"
23,2014,Dec,84708,79142,5566,6.6,"Bay County, FL"
24,2015,Jan,85588,79624,5964,7.0,"Bay County, FL"
25,2015,Feb,85524,80175,5349,6.3,"Bay County, FL"
26,2015,Mar,87623,82784,4839,5.5,"Bay County, FL"
27,2015,Apr,87646,83042,4604,5.3,"Bay County, FL"
28,2015,May,88975,84085,4890,5.5,"Bay County, FL"
29,2015,Jun,90408,85496,4912,5.4,"Bay County, FL"
30,2015,Jul,90470,85553,4917,5.4,"Bay County, FL"
31,2015,Aug,89618,84941,4677,5.2,"Bay County, FL"
32,2015,Sep,88610,84184,4426,5.0,"Bay County, FL"
33,2015,Oct,87796,83352,4444,5.1,"Bay County, FL"
34,2015,Nov,86567,81900,4667,5.4,"Bay County, FL"
35,2015,Dec,85784,81172,4612,5.4,"Bay County, FL"
36,2016,Jan,85868,81026,4842,5.6,"Bay County, FL"
37,2016,Feb,86331,81925,4406,5.1,"Bay County, FL"
38,2016,Mar,88238,84057,4181,4.7,"Bay County, FL"
39,2016,Apr,87708,83714,3994,4.6,"Bay County, FL"
40,2016,May,89133,85175,3958,4.4,"Bay County, FL"
41,2016,Jun,90952,86655,4297,4.7,"Bay County, FL"
42,2016,Jul,91322,86967,4355,4.8,"Bay County, FL"
43,2016,Aug,90239,85935,4304,4.8,"Bay County, FL"
44,2016,Sep,89009,84780,4229,4.8,"Bay County, FL"
45,2016,Oct,87968,83841,4127,4.7,"Bay County, FL"
46,2016,Nov,86292,82235,4057,4.7,"Bay County, FL"
47,2016,Dec,85447,81243,4204,4.9,"Bay County, FL"
48,2017,Jan,84734,80109,4625,5.5,"Bay County, FL"
49,2017,Feb,85088,80971,4117,4.8,"Bay County, FL"
50,2017,Mar,86904,83189,3715,4.3,"Bay County, FL"
51,2017,Apr,86890,83449,3441,4.0,"Bay County, FL"
52,2017,May,88070,84523,3547,4.0,"Bay County, FL"
53,2017,Jun,90443,86688,3755,4.2,"Bay County, FL"
54,2017,Jul,89948,86165,3783,4.2,"Bay County, FL"
55,2017,Aug,89881,86091,3790,4.2,"Bay County, FL"
56,2017,Sep,89476,86098,3378,3.8,"Bay County, FL"
57,2017,Oct,87423,84135,3288,3.8,"Bay County, FL"
58,2017,Nov,86437,83015,3422,4.0,"Bay County, FL"
59,2017,Dec,85268,81827,3441,4.0,"Bay County, FL"
60,2018,Jan,85347,81485,3862,4.5,"Bay County, FL"
61,2018,Feb,85897,82403,3494,4.1,"Bay County, FL"
62,2018,Mar,87039,83833,3206,3.7,"Bay County, FL"
63,2018,Apr,88073,85121,2952,3.4,"Bay County, FL"
64,2018,May,89412,86472,2940,3.3,"Bay County, FL"
65,2018,Jun,91642,88240,3402,3.7,"Bay County, FL"
66,2018,Jul,91856,88578,3278,3.6,"Bay County, FL"
67,2018,Aug,90020,86923,3097,3.4,"Bay County, FL"
68,2018,Sep,89245,86404,2841,3.2,"Bay County, FL"
69,2018,Oct,83403,80586,2817,3.4,"Bay County, FL"
70,2018,Nov,83976,77726,6250,7.4,"Bay County, FL"
71,2018,Dec,83217,77974,5243,6.3,"Bay County, FL"
72,2019,Jan,82102,77201,4901,6.0,"Bay County, FL"
73,2019,Feb,82465,78463,4002,4.9,"Bay County, FL"
74,2019,Mar,82968,79362,3606,4.3,"Bay County, FL"
75,2019,Apr,82970,79937,3033,3.7,"Bay County, FL"
76,2019,May,84594,81523,3071,3.6,"Bay County, FL"
77,2019,Jun,86254,82976,3278,3.8,"Bay County, FL"
78,2019,Jul,86026,82823,3203,3.7,"Bay County, FL"
79,2019,Aug,85328,82292,3036,3.6,"Bay County, FL"
80,2019,Sep,85208,82515,2693,3.2,"Bay County, FL"
81,2019,Oct,84291,81668,2623,3.1,"Bay County, FL"
82,2019,Nov,83171,80665,2506,3.0,"Bay County, FL"
83,2019,Dec,82289,79902,2387,2.9,"Bay County, FL"
84,2020,Jan,82243,79443,2800,3.4,"Bay County, FL"
85,2020,Feb,82650,80381,2269,2.7,"Bay County, FL"
86,2020,Mar,82443,79242,3201,3.9,"Bay County, FL"
87,2020,Apr,75657,66243,9414,12.4,"Bay County, FL"
88,2020,May,81832,73193,8639,10.6,"Bay County, FL"
89,2020,Jun,83017,76718,6299,7.6,"Bay County, FL"
90,2020,Jul,84959,77896,7063,8.3,"Bay County, FL"
91,2020,Aug,83706,78593,5113,6.1,"Bay County, FL"
92,2020,Sep,84683,79823,4860,5.7,"Bay County, FL"
93,2020,Oct,85153,80892,4261,5.0,"Bay County, FL"
94,2020,Nov,84006,79854,4152,4.9,"Bay County, FL"
95,2020,Dec,83407,79154,4253,5.1,"Bay County, FL"
96,2021,Jan,83292,78894,4398,5.3,"Bay County, FL"
97,2021,Feb,83994,79992,4002,4.8,"Bay County, FL"
98,2021,Mar,85263,81579,3684,4.3,"Bay County, FL"
99,2021,Apr,85392,81969,3423,4.0,"Bay County, FL"
100,2021,May,86536,83279,3257,3.8,"Bay County, FL"
101,2021,Jun,88070,84269,3801,4.3,"Bay County, FL"
102,2021,Jul,87566,84039,3527,4.0,"Bay County, FL"
103,2021,Aug,86710,83340,3370,3.9,"Bay County, FL"
104,2021,Sep,86757,83773,2984,3.4,"Bay County, FL"
105,2021,Oct,85845,82952,2893,3.4,"Bay County, FL"
106,2021,Nov,85162,82386,2776,3.3,"Bay County, FL"
107,2021,Dec,84783,82207,2576,3.0,"Bay County, FL"
108,2022,Jan,84904,81662,3242,3.8,"Bay County, FL"
109,2022,Feb,85219,82501,2718,3.2,"Bay County, FL"
110,2022,Mar,86556,84196,2360,2.7,"Bay County, FL"
111,2022,Apr,87017,84936,2081,2.4,"Bay County, FL"
112,2022,May,88365,86227,2138,2.4,"Bay County, FL"
113,2022,Jun,89388,86841,2547,2.8,"Bay County, FL"
114,2022,Jul,90011,87563,2448,2.7,"Bay County, FL"
115,2022,Aug,89934,87535,2399,2.7,"Bay County, FL"
116,2022,Sep,89396,87252,2144,2.4,"Bay County, FL"
117,2022,Oct,88775,86653,2122,2.4,"Bay County, FL"
118,2022,Nov,87912,85756,2156,2.5,"Bay County, FL"
119,2022,Dec,88160,86181,1979,2.2,"Bay County, FL"
120,2023,Jan,87786,85432,2354,2.7,"Bay County, FL"
121,2023,Feb,88170,85995,2175,2.5,"Bay County, FL"
122,2023,Mar,89544,87414,2130,2.4,"Bay County, FL"
123,2023,Apr,89959,88099,1860,2.1,"Bay County, FL"
124,2023,May,90694,88531,2163,2.4,"Bay County, FL"
125,2023,Jun,92632,90150,2482,2.7,"Bay County, FL"
126,2023,Jul,92650,90063,2587,2.8,"Bay County, FL"
127,2023,Aug,93246,90603,2643,2.8,"Bay County, FL"
128,2023,Sep,92914,90278,2636,2.8,"Bay County, FL"
129,2023,Oct,92356,89670,2686,2.9,"Bay County, FL"
0,2013,Jan,18116,16367,1749,9.7,"Okeechobee County, FL"
1,2013,Feb,18045,16419,1626,9.0,"Okeechobee County, FL"
2,2013,Mar,18021,16468,1553,8.6,"Okeechobee County, FL"
3,2013,Apr,18080,16576,1504,8.3,"Okeechobee County, FL"
4,2013,May,18271,16708,1563,8.6,"Okeechobee County, FL"
5,2013,Jun,18118,16378,1740,9.6,"Okeechobee County, FL"
6,2013,Jul,18089,16311,1778,9.8,"Okeechobee County, FL"
7,2013,Aug,17963,16129,1834,10.2,"Okeechobee County, FL"
8,2013,Sep,18037,16309,1728,9.6,"Okeechobee County, FL"
9,2013,Oct,17977,16298,1679,9.3,"Okeechobee County, FL"
10,2013,Nov,17933,16390,1543,8.6,"Okeechobee County, FL"
11,2013,Dec,18137,16698,1439,7.9,"Okeechobee County, FL"
12,2014,Jan,17961,16496,1465,8.2,"Okeechobee County, FL"
13,2014,Feb,18044,16665,1379,7.6,"Okeechobee County, FL"
14,2014,Mar,17857,16514,1343,7.5,"Okeechobee County, FL"
15,2014,Apr,17745,16539,1206,6.8,"Okeechobee County, FL"
16,2014,May,17990,16715,1275,7.1,"Okeechobee County, FL"
17,2014,Jun,17645,16269,1376,7.8,"Okeechobee County, FL"
18,2014,Jul,17558,16094,1464,8.3,"Okeechobee County, FL"
19,2014,Aug,17391,15924,1467,8.4,"Okeechobee County, FL"
20,2014,Sep,17529,16169,1360,7.8,"Okeechobee County, FL"
21,2014,Oct,17547,16251,1296,7.4,"Okeechobee County, FL"
22,2014,Nov,17253,16012,1241,7.2,"Okeechobee County, FL"
23,2014,Dec,17310,16149,1161,6.7,"Okeechobee County, FL"
24,2015,Jan,17311,16075,1236,7.1,"Okeechobee County, FL"
25,2015,Feb,17249,16142,1107,6.4,"Okeechobee County, FL"
26,2015,Mar,17235,16192,1043,6.1,"Okeechobee County, FL"
27,2015,Apr,17301,16292,1009,5.8,"Okeechobee County, FL"
28,2015,May,17427,16364,1063,6.1,"Okeechobee County, FL"
29,2015,Jun,17090,15960,1130,6.6,"Okeechobee County, FL"
30,2015,Jul,16945,15749,1196,7.1,"Okeechobee County, FL"
31,2015,Aug,17248,16052,1196,6.9,"Okeechobee County, FL"
32,2015,Sep,17339,16214,1125,6.5,"Okeechobee County, FL"
33,2015,Oct,17479,16382,1097,6.3,"Okeechobee County, FL"
34,2015,Nov,17547,16517,1030,5.9,"Okeechobee County, FL"
35,2015,Dec,17644,16648,996,5.6,"Okeechobee County, FL"
36,2016,Jan,17692,16652,1040,5.9,"Okeechobee County, FL"
37,2016,Feb,17730,16791,939,5.3,"Okeechobee County, FL"
38,2016,Mar,17783,16865,918,5.2,"Okeechobee County, FL"
39,2016,Apr,17666,16815,851,4.8,"Okeechobee County, FL"
40,2016,May,17801,16954,847,4.8,"Okeechobee County, FL"
41,2016,Jun,17365,16395,970,5.6,"Okeechobee County, FL"
42,2016,Jul,17327,16320,1007,5.8,"Okeechobee County, FL"
43,2016,Aug,17806,16782,1024,5.8,"Okeechobee County, FL"
44,2016,Sep,18454,17442,1012,5.5,"Okeechobee County, FL"
45,2016,Oct,19725,18773,952,4.8,"Okeechobee County, FL"
46,2016,Nov,19566,18671,895,4.6,"Okeechobee County, FL"
47,2016,Dec,19551,18673,878,4.5,"Okeechobee County, FL"
48,2017,Jan,19594,18639,955,4.9,"Okeechobee County, FL"
49,2017,Feb,19675,18833,842,4.3,"Okeechobee County, FL"
50,2017,Mar,19995,19214,781,3.9,"Okeechobee County, FL"
51,2017,Apr,18927,18195,732,3.9,"Okeechobee County, FL"
52,2017,May,18670,17920,750,4.0,"Okeechobee County, FL"
53,2017,Jun,17437,16597,840,4.8,"Okeechobee County, FL"
54,2017,Jul,16802,15916,886,5.3,"Okeechobee County, FL"
55,2017,Aug,17731,16815,916,5.2,"Okeechobee County, FL"
56,2017,Sep,17387,16555,832,4.8,"Okeechobee County, FL"
57,2017,Oct,17430,16659,771,4.4,"Okeechobee County, FL"
58,2017,Nov,17298,16562,736,4.3,"Okeechobee County, FL"
59,2017,Dec,17453,16771,682,3.9,"Okeechobee County, FL"
60,2018,Jan,17622,16888,734,4.2,"Okeechobee County, FL"
61,2018,Feb,17720,17051,669,3.8,"Okeechobee County, FL"
62,2018,Mar,17794,17162,632,3.6,"Okeechobee County, FL"
63,2018,Apr,17730,17125,605,3.4,"Okeechobee County, FL"
64,2018,May,17627,17025,602,3.4,"Okeechobee County, FL"
65,2018,Jun,17058,16313,745,4.4,"Okeechobee County, FL"
66,2018,Jul,17001,16263,738,4.3,"Okeechobee County, FL"
67,2018,Aug,17801,17055,746,4.2,"Okeechobee County, FL"
68,2018,Sep,17770,17098,672,3.8,"Okeechobee County, FL"
69,2018,Oct,17776,17125,651,3.7,"Okeechobee County, FL"
70,2018,Nov,17625,17015,610,3.5,"Okeechobee County, FL"
71,2018,Dec,17662,17052,610,3.5,"Okeechobee County, FL"
72,2019,Jan,17737,17013,724,4.1,"Okeechobee County, FL"
73,2019,Feb,17734,17101,633,3.6,"Okeechobee County, FL"
74,2019,Mar,17743,17123,620,3.5,"Okeechobee County, FL"
75,2019,Apr,17632,17071,561,3.2,"Okeechobee County, FL"
76,2019,May,17827,17252,575,3.2,"Okeechobee County, FL"
77,2019,Jun,17075,16401,674,3.9,"Okeechobee County, FL"
78,2019,Jul,16930,16202,728,4.3,"Okeechobee County, FL"
79,2019,Aug,17764,17053,711,4.0,"Okeechobee County, FL"
80,2019,Sep,17874,17222,652,3.6,"Okeechobee County, FL"
81,2019,Oct,17894,17303,591,3.3,"Okeechobee County, FL"
82,2019,Nov,17733,17180,553,3.1,"Okeechobee County, FL"
83,2019,Dec,17765,17256,509,2.9,"Okeechobee County, FL"
84,2020,Jan,17747,17188,559,3.1,"Okeechobee County, FL"
85,2020,Feb,17643,17168,475,2.7,"Okeechobee County, FL"
86,2020,Mar,17360,16658,702,4.0,"Okeechobee County, FL"
87,2020,Apr,15785,14671,1114,7.1,"Okeechobee County, FL"
88,2020,May,16930,15615,1315,7.8,"Okeechobee County, FL"
89,2020,Jun,16468,15193,1275,7.7,"Okeechobee County, FL"
90,2020,Jul,16478,14978,1500,9.1,"Okeechobee County, FL"
91,2020,Aug,17087,16014,1073,6.3,"Okeechobee County, FL"
92,2020,Sep,17350,16325,1025,5.9,"Okeechobee County, FL"
93,2020,Oct,17703,16785,918,5.2,"Okeechobee County, FL"
94,2020,Nov,17383,16503,880,5.1,"Okeechobee County, FL"
95,2020,Dec,17495,16640,855,4.9,"Okeechobee County, FL"
96,2021,Jan,17135,16282,853,5.0,"Okeechobee County, FL"
97,2021,Feb,17254,16482,772,4.5,"Okeechobee County, FL"
98,2021,Mar,17341,16603,738,4.3,"Okeechobee County, FL"
99,2021,Apr,17481,16791,690,3.9,"Okeechobee County, FL"
100,2021,May,17501,16798,703,4.0,"Okeechobee County, FL"
101,2021,Jun,17469,16626,843,4.8,"Okeechobee County, FL"
102,2021,Jul,17329,16504,825,4.8,"Okeechobee County, FL"
103,2021,Aug,17420,16611,809,4.6,"Okeechobee County, FL"
104,2021,Sep,17428,16706,722,4.1,"Okeechobee County, FL"
105,2021,Oct,17289,16596,693,4.0,"Okeechobee County, FL"
106,2021,Nov,17206,16554,652,3.8,"Okeechobee County, FL"
107,2021,Dec,17246,16663,583,3.4,"Okeechobee County, FL"
108,2022,Jan,17578,16896,682,3.9,"Okeechobee County, FL"
109,2022,Feb,17586,16983,603,3.4,"Okeechobee County, FL"
110,2022,Mar,17660,17115,545,3.1,"Okeechobee County, FL"
111,2022,Apr,17510,17011,499,2.8,"Okeechobee County, FL"
112,2022,May,17650,17116,534,3.0,"Okeechobee County, FL"
113,2022,Jun,17640,17026,614,3.5,"Okeechobee County, FL"
114,2022,Jul,17517,16948,569,3.2,"Okeechobee County, FL"
115,2022,Aug,17847,17276,571,3.2,"Okeechobee County, FL"
116,2022,Sep,17793,17279,514,2.9,"Okeechobee County, FL"
117,2022,Oct,17810,17327,483,2.7,"Okeechobee County, FL"
118,2022,Nov,17754,17274,480,2.7,"Okeechobee County, FL"
119,2022,Dec,17786,17379,407,2.3,"Okeechobee County, FL"
120,2023,Jan,17799,17315,484,2.7,"Okeechobee County, FL"
121,2023,Feb,17901,17412,489,2.7,"Okeechobee County, FL"
122,2023,Mar,18037,17547,490,2.7,"Okeechobee County, FL"
123,2023,Apr,18067,17615,452,2.5,"Okeechobee County, FL"
124,2023,May,18284,17743,541,3.0,"Okeechobee County, FL"
125,2023,Jun,18126,17506,620,3.4,"Okeechobee County, FL"
126,2023,Jul,17978,17345,633,3.5,"Okeechobee County, FL"
127,2023,Aug,18387,17712,675,3.7,"Okeechobee County, FL"
128,2023,Sep,18398,17762,636,3.5,"Okeechobee County, FL"
129,2023,Oct,18368,17739,629,3.4,"Okeechobee County, FL"
0,2013,Jan,664539,609355,55184,8.3,"Palm Beach County, FL"
1,2013,Feb,664231,613278,50953,7.7,"Palm Beach County, FL"
2,2013,Mar,664604,616064,48540,7.3,"Palm Beach County, FL"
3,2013,Apr,665758,618573,47185,7.1,"Palm Beach County, FL"
4,2013,May,672695,623459,49236,7.3,"Palm Beach County, FL"
5,2013,Jun,674722,621601,53121,7.9,"Palm Beach County, FL"
6,2013,Jul,673418,619807,53611,8.0,"Palm Beach County, FL"
7,2013,Aug,671536,618707,52829,7.9,"Palm Beach County, FL"
8,2013,Sep,675268,624520,50748,7.5,"Palm Beach County, FL"
9,2013,Oct,671393,622320,49073,7.3,"Palm Beach County, FL"
10,2013,Nov,674049,628127,45922,6.8,"Palm Beach County, FL"
11,2013,Dec,674802,631639,43163,6.4,"Palm Beach County, FL"
12,2014,Jan,676804,631301,45503,6.7,"Palm Beach County, FL"
13,2014,Feb,681009,636833,44176,6.5,"Palm Beach County, FL"
14,2014,Mar,684314,640863,43451,6.3,"Palm Beach County, FL"
15,2014,Apr,680421,641424,38997,5.7,"Palm Beach County, FL"
16,2014,May,686251,644916,41335,6.0,"Palm Beach County, FL"
17,2014,Jun,683148,640672,42476,6.2,"Palm Beach County, FL"
18,2014,Jul,683106,638074,45032,6.6,"Palm Beach County, FL"
19,2014,Aug,682062,637760,44302,6.5,"Palm Beach County, FL"
20,2014,Sep,685431,644651,40780,5.9,"Palm Beach County, FL"
21,2014,Oct,688073,649715,38358,5.6,"Palm Beach County, FL"
22,2014,Nov,686978,649873,37105,5.4,"Palm Beach County, FL"
23,2014,Dec,687053,652934,34119,5.0,"Palm Beach County, FL"
24,2015,Jan,688038,650545,37493,5.4,"Palm Beach County, FL"
25,2015,Feb,685805,651008,34797,5.1,"Palm Beach County, FL"
26,2015,Mar,687740,654221,33519,4.9,"Palm Beach County, FL"
27,2015,Apr,688257,655467,32790,4.8,"Palm Beach County, FL"
28,2015,May,696355,660663,35692,5.1,"Palm Beach County, FL"
29,2015,Jun,693689,656314,37375,5.4,"Palm Beach County, FL"
30,2015,Jul,693394,653783,39611,5.7,"Palm Beach County, FL"
31,2015,Aug,694635,656237,38398,5.5,"Palm Beach County, FL"
32,2015,Sep,695344,658684,36660,5.3,"Palm Beach County, FL"
33,2015,Oct,699247,663558,35689,5.1,"Palm Beach County, FL"
34,2015,Nov,698968,664241,34727,5.0,"Palm Beach County, FL"
35,2015,Dec,701513,668529,32984,4.7,"Palm Beach County, FL"
36,2016,Jan,704449,669873,34576,4.9,"Palm Beach County, FL"
37,2016,Feb,708015,675761,32254,4.6,"Palm Beach County, FL"
38,2016,Mar,709647,677603,32044,4.5,"Palm Beach County, FL"
39,2016,Apr,708118,677197,30921,4.4,"Palm Beach County, FL"
40,2016,May,711425,680755,30670,4.3,"Palm Beach County, FL"
41,2016,Jun,712769,677551,35218,4.9,"Palm Beach County, FL"
42,2016,Jul,710712,673986,36726,5.2,"Palm Beach County, FL"
43,2016,Aug,710921,673650,37271,5.2,"Palm Beach County, FL"
44,2016,Sep,716300,679861,36439,5.1,"Palm Beach County, FL"
45,2016,Oct,715667,681070,34597,4.8,"Palm Beach County, FL"
46,2016,Nov,714730,681775,32955,4.6,"Palm Beach County, FL"
47,2016,Dec,716559,684986,31573,4.4,"Palm Beach County, FL"
48,2017,Jan,713864,679743,34121,4.8,"Palm Beach County, FL"
49,2017,Feb,716512,685147,31365,4.4,"Palm Beach County, FL"
50,2017,Mar,719895,690469,29426,4.1,"Palm Beach County, FL"
51,2017,Apr,716202,688559,27643,3.9,"Palm Beach County, FL"
52,2017,May,718656,689991,28665,4.0,"Palm Beach County, FL"
53,2017,Jun,719850,688282,31568,4.4,"Palm Beach County, FL"
54,2017,Jul,717455,684398,33057,4.6,"Palm Beach County, FL"
55,2017,Aug,716001,682323,33678,4.7,"Palm Beach County, FL"
56,2017,Sep,713873,683131,30742,4.3,"Palm Beach County, FL"
57,2017,Oct,715022,685654,29368,4.1,"Palm Beach County, FL"
58,2017,Nov,715295,686460,28835,4.0,"Palm Beach County, FL"
59,2017,Dec,715709,688931,26778,3.7,"Palm Beach County, FL"
60,2018,Jan,719092,690180,28912,4.0,"Palm Beach County, FL"
61,2018,Feb,722554,695526,27028,3.7,"Palm Beach County, FL"
62,2018,Mar,723300,697299,26001,3.6,"Palm Beach County, FL"
63,2018,Apr,720542,696420,24122,3.3,"Palm Beach County, FL"
64,2018,May,722549,698364,24185,3.3,"Palm Beach County, FL"
65,2018,Jun,721509,692517,28992,4.0,"Palm Beach County, FL"
66,2018,Jul,721647,692521,29126,4.0,"Palm Beach County, FL"
67,2018,Aug,717821,688789,29032,4.0,"Palm Beach County, FL"
68,2018,Sep,722664,696038,26626,3.7,"Palm Beach County, FL"
69,2018,Oct,727204,701077,26127,3.6,"Palm Beach County, FL"
70,2018,Nov,723912,699337,24575,3.4,"Palm Beach County, FL"
71,2018,Dec,725543,701307,24236,3.3,"Palm Beach County, FL"
72,2019,Jan,725093,697334,27759,3.8,"Palm Beach County, FL"
73,2019,Feb,726248,701959,24289,3.3,"Palm Beach County, FL"
74,2019,Mar,726590,702862,23728,3.3,"Palm Beach County, FL"
75,2019,Apr,725761,704533,21228,2.9,"Palm Beach County, FL"
76,2019,May,728793,706091,22702,3.1,"Palm Beach County, FL"
77,2019,Jun,729557,703246,26311,3.6,"Palm Beach County, FL"
78,2019,Jul,730404,702855,27549,3.8,"Palm Beach County, FL"
79,2019,Aug,731445,703725,27720,3.8,"Palm Beach County, FL"
80,2019,Sep,733420,708352,25068,3.4,"Palm Beach County, FL"
81,2019,Oct,736442,712383,24059,3.3,"Palm Beach County, FL"
82,2019,Nov,735659,713128,22531,3.1,"Palm Beach County, FL"
83,2019,Dec,738035,717407,20628,2.8,"Palm Beach County, FL"
84,2020,Jan,740283,716600,23683,3.2,"Palm Beach County, FL"
85,2020,Feb,742498,721741,20757,2.8,"Palm Beach County, FL"
86,2020,Mar,730238,698720,31518,4.3,"Palm Beach County, FL"
87,2020,Apr,655759,567937,87822,13.4,"Palm Beach County, FL"
88,2020,May,709720,610473,99247,14.0,"Palm Beach County, FL"
89,2020,Jun,713966,630943,83023,11.6,"Palm Beach County, FL"
90,2020,Jul,728198,637982,90216,12.4,"Palm Beach County, FL"
91,2020,Aug,713034,648569,64465,9.0,"Palm Beach County, FL"
92,2020,Sep,718362,660306,58056,8.1,"Palm Beach County, FL"
93,2020,Oct,719253,671660,47593,6.6,"Palm Beach County, FL"
94,2020,Nov,711190,668546,42644,6.0,"Palm Beach County, FL"
95,2020,Dec,712155,672305,39850,5.6,"Palm Beach County, FL"
96,2021,Jan,719157,679588,39569,5.5,"Palm Beach County, FL"
97,2021,Feb,723461,687642,35819,5.0,"Palm Beach County, FL"
98,2021,Mar,726499,692281,34218,4.7,"Palm Beach County, FL"
99,2021,Apr,727088,694706,32382,4.5,"Palm Beach County, FL"
100,2021,May,732989,701533,31456,4.3,"Palm Beach County, FL"
101,2021,Jun,735108,698761,36347,4.9,"Palm Beach County, FL"
102,2021,Jul,739705,704974,34731,4.7,"Palm Beach County, FL"
103,2021,Aug,739494,705799,33695,4.6,"Palm Beach County, FL"
104,2021,Sep,741080,710675,30405,4.1,"Palm Beach County, FL"
105,2021,Oct,745036,716352,28684,3.9,"Palm Beach County, FL"
106,2021,Nov,746473,720166,26307,3.5,"Palm Beach County, FL"
107,2021,Dec,746835,724069,22766,3.0,"Palm Beach County, FL"
108,2022,Jan,753700,725945,27755,3.7,"Palm Beach County, FL"
109,2022,Feb,752571,728354,24217,3.2,"Palm Beach County, FL"
110,2022,Mar,756902,734968,21934,2.9,"Palm Beach County, FL"
111,2022,Apr,759864,739778,20086,2.6,"Palm Beach County, FL"
112,2022,May,766194,745412,20782,2.7,"Palm Beach County, FL"
113,2022,Jun,765613,741275,24338,3.2,"Palm Beach County, FL"
114,2022,Jul,765040,741493,23547,3.1,"Palm Beach County, FL"
115,2022,Aug,766384,742520,23864,3.1,"Palm Beach County, FL"
116,2022,Sep,767870,746533,21337,2.8,"Palm Beach County, FL"
117,2022,Oct,771021,749979,21042,2.7,"Palm Beach County, FL"
118,2022,Nov,765182,745291,19891,2.6,"Palm Beach County, FL"
119,2022,Dec,765740,748620,17120,2.2,"Palm Beach County, FL"
120,2023,Jan,765906,746255,19651,2.6,"Palm Beach County, FL"
121,2023,Feb,768650,748847,19803,2.6,"Palm Beach County, FL"
122,2023,Mar,774074,753692,20382,2.6,"Palm Beach County, FL"
123,2023,Apr,776369,758518,17851,2.3,"Palm Beach County, FL"
124,2023,May,780060,759140,20920,2.7,"Palm Beach County, FL"
125,2023,Jun,780364,756069,24295,3.1,"Palm Beach County, FL"
126,2023,Jul,786087,760516,25571,3.3,"Palm Beach County, FL"
127,2023,Aug,785467,759168,26299,3.3,"Palm Beach County, FL"
128,2023,Sep,789172,763374,25798,3.3,"Palm Beach County, FL"
129,2023,Oct,792420,766779,25641,3.2,"Palm Beach County, FL"
0,2013,Jan,17852,15871,1981,11.1,"Hendry County, FL"
1,2013,Feb,17613,15753,1860,10.6,"Hendry County, FL"
2,2013,Mar,17623,15880,1743,9.9,"Hendry County, FL"
3,2013,Apr,17475,15765,1710,9.8,"Hendry County, FL"
4,2013,May,16884,14991,1893,11.2,"Hendry County, FL"
5,2013,Jun,15876,13599,2277,14.3,"Hendry County, FL"
6,2013,Jul,15384,12873,2511,16.3,"Hendry County, FL"
7,2013,Aug,15393,12861,2532,16.4,"Hendry County, FL"
8,2013,Sep,15544,13163,2381,15.3,"Hendry County, FL"
9,2013,Oct,16409,14211,2198,13.4,"Hendry County, FL"
10,2013,Nov,16626,14654,1972,11.9,"Hendry County, FL"
11,2013,Dec,17044,15266,1778,10.4,"Hendry County, FL"
12,2014,Jan,16545,14741,1804,10.9,"Hendry County, FL"
13,2014,Feb,16234,14490,1744,10.7,"Hendry County, FL"
14,2014,Mar,16484,14814,1670,10.1,"Hendry County, FL"
15,2014,Apr,16548,15003,1545,9.3,"Hendry County, FL"
16,2014,May,16146,14415,1731,10.7,"Hendry County, FL"
17,2014,Jun,15347,13383,1964,12.8,"Hendry County, FL"
18,2014,Jul,14892,12710,2182,14.7,"Hendry County, FL"
19,2014,Aug,14861,12642,2219,14.9,"Hendry County, FL"
20,2014,Sep,15146,13066,2080,13.7,"Hendry County, FL"
21,2014,Oct,15802,13963,1839,11.6,"Hendry County, FL"
22,2014,Nov,15688,13915,1773,11.3,"Hendry County, FL"
23,2014,Dec,16211,14665,1546,9.5,"Hendry County, FL"
24,2015,Jan,16159,14583,1576,9.8,"Hendry County, FL"
25,2015,Feb,15824,14376,1448,9.2,"Hendry County, FL"
26,2015,Mar,15839,14482,1357,8.6,"Hendry County, FL"
27,2015,Apr,15725,14390,1335,8.5,"Hendry County, FL"
28,2015,May,15471,13915,1556,10.1,"Hendry County, FL"
29,2015,Jun,14592,12799,1793,12.3,"Hendry County, FL"
30,2015,Jul,14119,12047,2072,14.7,"Hendry County, FL"
31,2015,Aug,14248,12301,1947,13.7,"Hendry County, FL"
32,2015,Sep,14383,12541,1842,12.8,"Hendry County, FL"
33,2015,Oct,14959,13299,1660,11.1,"Hendry County, FL"
34,2015,Nov,15130,13580,1550,10.2,"Hendry County, FL"
35,2015,Dec,15486,14104,1382,8.9,"Hendry County, FL"
36,2016,Jan,16454,15086,1368,8.3,"Hendry County, FL"
37,2016,Feb,16246,14984,1262,7.8,"Hendry County, FL"
38,2016,Mar,16210,15028,1182,7.3,"Hendry County, FL"
39,2016,Apr,15811,14698,1113,7.0,"Hendry County, FL"
40,2016,May,15570,14462,1108,7.1,"Hendry County, FL"
41,2016,Jun,14526,13114,1412,9.7,"Hendry County, FL"
42,2016,Jul,14205,12672,1533,10.8,"Hendry County, FL"
43,2016,Aug,14735,13116,1619,11.0,"Hendry County, FL"
44,2016,Sep,14976,13381,1595,10.7,"Hendry County, FL"
45,2016,Oct,15441,14089,1352,8.8,"Hendry County, FL"
46,2016,Nov,15475,14228,1247,8.1,"Hendry County, FL"
47,2016,Dec,15885,14733,1152,7.3,"Hendry County, FL"
48,2017,Jan,17869,16686,1183,6.6,"Hendry County, FL"
49,2017,Feb,17393,16336,1057,6.1,"Hendry County, FL"
50,2017,Mar,17147,16150,997,5.8,"Hendry County, FL"
51,2017,Apr,16055,15130,925,5.8,"Hendry County, FL"
52,2017,May,15584,14584,1000,6.4,"Hendry County, FL"
53,2017,Jun,14696,13349,1347,9.2,"Hendry County, FL"
54,2017,Jul,14474,12968,1506,10.4,"Hendry County, FL"
55,2017,Aug,15169,13654,1515,10.0,"Hendry County, FL"
56,2017,Sep,14992,13616,1376,9.2,"Hendry County, FL"
57,2017,Oct,15730,14577,1153,7.3,"Hendry County, FL"
58,2017,Nov,15537,14458,1079,6.9,"Hendry County, FL"
59,2017,Dec,16010,15033,977,6.1,"Hendry County, FL"
60,2018,Jan,16034,15034,1000,6.2,"Hendry County, FL"
61,2018,Feb,15927,15021,906,5.7,"Hendry County, FL"
62,2018,Mar,15944,15082,862,5.4,"Hendry County, FL"
63,2018,Apr,15939,15167,772,4.8,"Hendry County, FL"
64,2018,May,16053,15260,793,4.9,"Hendry County, FL"
65,2018,Jun,14590,13515,1075,7.4,"Hendry County, FL"
66,2018,Jul,14582,13330,1252,8.6,"Hendry County, FL"
67,2018,Aug,15058,13818,1240,8.2,"Hendry County, FL"
68,2018,Sep,15466,14332,1134,7.3,"Hendry County, FL"
69,2018,Oct,15633,14657,976,6.2,"Hendry County, FL"
70,2018,Nov,15429,14573,856,5.5,"Hendry County, FL"
71,2018,Dec,15710,14885,825,5.3,"Hendry County, FL"
72,2019,Jan,15544,14630,914,5.9,"Hendry County, FL"
73,2019,Feb,15469,14694,775,5.0,"Hendry County, FL"
74,2019,Mar,15425,14689,736,4.8,"Hendry County, FL"
75,2019,Apr,15367,14729,638,4.2,"Hendry County, FL"
76,2019,May,15570,14841,729,4.7,"Hendry County, FL"
77,2019,Jun,14272,13285,987,6.9,"Hendry County, FL"
78,2019,Jul,14580,13305,1275,8.7,"Hendry County, FL"
79,2019,Aug,15162,13877,1285,8.5,"Hendry County, FL"
80,2019,Sep,15283,14099,1184,7.7,"Hendry County, FL"
81,2019,Oct,15593,14586,1007,6.5,"Hendry County, FL"
82,2019,Nov,15368,14505,863,5.6,"Hendry County, FL"
83,2019,Dec,15575,14785,790,5.1,"Hendry County, FL"
84,2020,Jan,15768,14927,841,5.3,"Hendry County, FL"
85,2020,Feb,15501,14801,700,4.5,"Hendry County, FL"
86,2020,Mar,15929,14886,1043,6.5,"Hendry County, FL"
87,2020,Apr,14345,13072,1273,8.9,"Hendry County, FL"
88,2020,May,15543,13881,1662,10.7,"Hendry County, FL"
89,2020,Jun,14622,12919,1703,11.6,"Hendry County, FL"
90,2020,Jul,15117,12825,2292,15.2,"Hendry County, FL"
91,2020,Aug,15351,13638,1713,11.2,"Hendry County, FL"
92,2020,Sep,15559,13970,1589,10.2,"Hendry County, FL"
93,2020,Oct,15524,14326,1198,7.7,"Hendry County, FL"
94,2020,Nov,15005,13921,1084,7.2,"Hendry County, FL"
95,2020,Dec,15313,14292,1021,6.7,"Hendry County, FL"
96,2021,Jan,15062,14008,1054,7.0,"Hendry County, FL"
97,2021,Feb,15131,14171,960,6.3,"Hendry County, FL"
98,2021,Mar,15369,14486,883,5.7,"Hendry County, FL"
99,2021,Apr,15476,14619,857,5.5,"Hendry County, FL"
100,2021,May,15459,14619,840,5.4,"Hendry County, FL"
101,2021,Jun,15271,14156,1115,7.3,"Hendry County, FL"
102,2021,Jul,15153,13971,1182,7.8,"Hendry County, FL"
103,2021,Aug,15332,14164,1168,7.6,"Hendry County, FL"
104,2021,Sep,15606,14531,1075,6.9,"Hendry County, FL"
105,2021,Oct,15644,14632,1012,6.5,"Hendry County, FL"
106,2021,Nov,15370,14504,866,5.6,"Hendry County, FL"
107,2021,Dec,15285,14571,714,4.7,"Hendry County, FL"
108,2022,Jan,15782,14956,826,5.2,"Hendry County, FL"
109,2022,Feb,15619,14903,716,4.6,"Hendry County, FL"
110,2022,Mar,15589,14968,621,4.0,"Hendry County, FL"
111,2022,Apr,15654,15051,603,3.9,"Hendry County, FL"
112,2022,May,15657,15042,615,3.9,"Hendry County, FL"
113,2022,Jun,15514,14655,859,5.5,"Hendry County, FL"
114,2022,Jul,15236,14294,942,6.2,"Hendry County, FL"
115,2022,Aug,15509,14566,943,6.1,"Hendry County, FL"
116,2022,Sep,15387,14599,788,5.1,"Hendry County, FL"
117,2022,Oct,15540,14807,733,4.7,"Hendry County, FL"
118,2022,Nov,15251,14599,652,4.3,"Hendry County, FL"
119,2022,Dec,15227,14719,508,3.3,"Hendry County, FL"
120,2023,Jan,15538,14981,557,3.6,"Hendry County, FL"
121,2023,Feb,15602,15030,572,3.7,"Hendry County, FL"
122,2023,Mar,15663,15092,571,3.6,"Hendry County, FL"
123,2023,Apr,15571,15052,519,3.3,"Hendry County, FL"
124,2023,May,15651,15009,642,4.1,"Hendry County, FL"
125,2023,Jun,15374,14480,894,5.8,"Hendry County, FL"
126,2023,Jul,15289,14290,999,6.5,"Hendry County, FL"
127,2023,Aug,15987,14970,1017,6.4,"Hendry County, FL"
128,2023,Sep,15978,15084,894,5.6,"Hendry County, FL"
129,2023,Oct,16053,15232,821,5.1,"Hendry County, FL"
0,2013,Jan,203101,168232,34869,17.2,"Tulare County, CA"
1,2013,Feb,203772,170538,33234,16.3,"Tulare County, CA"
2,2013,Mar,199957,167311,32646,16.3,"Tulare County, CA"
3,2013,Apr,204239,175156,29083,14.2,"Tulare County, CA"
4,2013,May,204938,177636,27302,13.3,"Tulare County, CA"
5,2013,Jun,205456,176552,28904,14.1,"Tulare County, CA"
6,2013,Jul,200266,171500,28766,14.4,"Tulare County, CA"
7,2013,Aug,200672,173147,27525,13.7,"Tulare County, CA"
8,2013,Sep,197391,171352,26039,13.2,"Tulare County, CA"
9,2013,Oct,195431,168661,26770,13.7,"Tulare County, CA"
10,2013,Nov,195574,168901,26673,13.6,"Tulare County, CA"
11,2013,Dec,195080,167209,27871,14.3,"Tulare County, CA"
12,2014,Jan,199005,167999,31006,15.6,"Tulare County, CA"
13,2014,Feb,198741,167697,31044,15.6,"Tulare County, CA"
14,2014,Mar,198715,167010,31705,16.0,"Tulare County, CA"
15,2014,Apr,199676,172852,26824,13.4,"Tulare County, CA"
16,2014,May,200841,176149,24692,12.3,"Tulare County, CA"
17,2014,Jun,199334,174234,25100,12.6,"Tulare County, CA"
18,2014,Jul,198405,172447,25958,13.1,"Tulare County, CA"
19,2014,Aug,197328,172778,24550,12.4,"Tulare County, CA"
20,2014,Sep,196909,174416,22493,11.4,"Tulare County, CA"
21,2014,Oct,193440,170388,23052,11.9,"Tulare County, CA"
22,2014,Nov,196179,172260,23919,12.2,"Tulare County, CA"
23,2014,Dec,196391,171335,25056,12.8,"Tulare County, CA"
24,2015,Jan,202335,174378,27957,13.8,"Tulare County, CA"
25,2015,Feb,202321,175033,27288,13.5,"Tulare County, CA"
26,2015,Mar,201226,173705,27521,13.7,"Tulare County, CA"
27,2015,Apr,205165,181424,23741,11.6,"Tulare County, CA"
28,2015,May,207108,184743,22365,10.8,"Tulare County, CA"
29,2015,Jun,204397,181170,23227,11.4,"Tulare County, CA"
30,2015,Jul,205182,181611,23571,11.5,"Tulare County, CA"
31,2015,Aug,202235,180499,21736,10.7,"Tulare County, CA"
32,2015,Sep,200464,180295,20169,10.1,"Tulare County, CA"
33,2015,Oct,196322,175416,20906,10.6,"Tulare County, CA"
34,2015,Nov,199701,178031,21670,10.9,"Tulare County, CA"
35,2015,Dec,199063,175589,23474,11.8,"Tulare County, CA"
36,2016,Jan,203291,177484,25807,12.7,"Tulare County, CA"
37,2016,Feb,204691,179035,25656,12.5,"Tulare County, CA"
38,2016,Mar,203555,177220,26335,12.9,"Tulare County, CA"
39,2016,Apr,207382,184671,22711,11.0,"Tulare County, CA"
40,2016,May,206355,186397,19958,9.7,"Tulare County, CA"
41,2016,Jun,205181,183480,21701,10.6,"Tulare County, CA"
42,2016,Jul,204072,181650,22422,11.0,"Tulare County, CA"
43,2016,Aug,202855,181410,21445,10.6,"Tulare County, CA"
44,2016,Sep,202267,181609,20658,10.2,"Tulare County, CA"
45,2016,Oct,199060,177629,21431,10.8,"Tulare County, CA"
46,2016,Nov,199637,177981,21656,10.8,"Tulare County, CA"
47,2016,Dec,201164,177472,23692,11.8,"Tulare County, CA"
48,2017,Jan,202716,177014,25702,12.7,"Tulare County, CA"
49,2017,Feb,205601,179369,26232,12.8,"Tulare County, CA"
50,2017,Mar,204124,178436,25688,12.6,"Tulare County, CA"
51,2017,Apr,210594,188662,21932,10.4,"Tulare County, CA"
52,2017,May,211584,191952,19632,9.3,"Tulare County, CA"
53,2017,Jun,208880,188294,20586,9.9,"Tulare County, CA"
54,2017,Jul,203310,182298,21012,10.3,"Tulare County, CA"
55,2017,Aug,204190,183705,20485,10.0,"Tulare County, CA"
56,2017,Sep,203659,185260,18399,9.0,"Tulare County, CA"
57,2017,Oct,198610,180059,18551,9.3,"Tulare County, CA"
58,2017,Nov,200339,181499,18840,9.4,"Tulare County, CA"
59,2017,Dec,199880,178948,20932,10.5,"Tulare County, CA"
60,2018,Jan,201369,178501,22868,11.4,"Tulare County, CA"
61,2018,Feb,205396,181690,23706,11.5,"Tulare County, CA"
62,2018,Mar,201697,178100,23597,11.7,"Tulare County, CA"
63,2018,Apr,204115,183895,20220,9.9,"Tulare County, CA"
64,2018,May,207457,189566,17891,8.6,"Tulare County, CA"
65,2018,Jun,206556,186749,19807,9.6,"Tulare County, CA"
66,2018,Jul,200945,181199,19746,9.8,"Tulare County, CA"
67,2018,Aug,202784,184260,18524,9.1,"Tulare County, CA"
68,2018,Sep,202797,186142,16655,8.2,"Tulare County, CA"
69,2018,Oct,198927,181755,17172,8.6,"Tulare County, CA"
70,2018,Nov,202185,184215,17970,8.9,"Tulare County, CA"
71,2018,Dec,201605,181471,20134,10.0,"Tulare County, CA"
72,2019,Jan,203879,180142,23737,11.6,"Tulare County, CA"
73,2019,Feb,204080,180743,23337,11.4,"Tulare County, CA"
74,2019,Mar,202330,178631,23699,11.7,"Tulare County, CA"
75,2019,Apr,203369,183258,20111,9.9,"Tulare County, CA"
76,2019,May,205010,187709,17301,8.4,"Tulare County, CA"
77,2019,Jun,204181,185423,18758,9.2,"Tulare County, CA"
78,2019,Jul,200641,180765,19876,9.9,"Tulare County, CA"
79,2019,Aug,203491,184675,18816,9.2,"Tulare County, CA"
80,2019,Sep,202395,185975,16420,8.1,"Tulare County, CA"
81,2019,Oct,199725,182596,17129,8.6,"Tulare County, CA"
82,2019,Nov,200632,182432,18200,9.1,"Tulare County, CA"
83,2019,Dec,199760,179985,19775,9.9,"Tulare County, CA"
84,2020,Jan,206870,184022,22848,11.0,"Tulare County, CA"
85,2020,Feb,209290,185785,23505,11.2,"Tulare County, CA"
86,2020,Mar,212927,178733,34194,16.1,"Tulare County, CA"
87,2020,Apr,204739,166224,38515,18.8,"Tulare County, CA"
88,2020,May,205173,170881,34292,16.7,"Tulare County, CA"
89,2020,Jun,206614,176148,30466,14.7,"Tulare County, CA"
90,2020,Jul,199582,169763,29819,14.9,"Tulare County, CA"
91,2020,Aug,200163,175341,24822,12.4,"Tulare County, CA"
92,2020,Sep,198252,174761,23491,11.8,"Tulare County, CA"
93,2020,Oct,195613,174225,21388,10.9,"Tulare County, CA"
94,2020,Nov,197929,176286,21643,10.9,"Tulare County, CA"
95,2020,Dec,197217,174629,22588,11.5,"Tulare County, CA"
96,2021,Jan,198344,174242,24102,12.2,"Tulare County, CA"
97,2021,Feb,200501,175487,25014,12.5,"Tulare County, CA"
98,2021,Mar,198971,173989,24982,12.6,"Tulare County, CA"
99,2021,Apr,201905,177990,23915,11.8,"Tulare County, CA"
100,2021,May,203640,181752,21888,10.7,"Tulare County, CA"
101,2021,Jun,202907,179098,23809,11.7,"Tulare County, CA"
102,2021,Jul,202151,179631,22520,11.1,"Tulare County, CA"
103,2021,Aug,202418,181495,20923,10.3,"Tulare County, CA"
104,2021,Sep,202268,184061,18207,9.0,"Tulare County, CA"
105,2021,Oct,199910,182152,17758,8.9,"Tulare County, CA"
106,2021,Nov,201786,185260,16526,8.2,"Tulare County, CA"
107,2021,Dec,199941,183544,16397,8.2,"Tulare County, CA"
108,2022,Jan,204319,184981,19338,9.5,"Tulare County, CA"
109,2022,Feb,205690,186570,19120,9.3,"Tulare County, CA"
110,2022,Mar,204405,186372,18033,8.8,"Tulare County, CA"
111,2022,Apr,208117,192082,16035,7.7,"Tulare County, CA"
112,2022,May,210264,195459,14805,7.0,"Tulare County, CA"
113,2022,Jun,208863,192753,16110,7.7,"Tulare County, CA"
114,2022,Jul,205680,189311,16369,8.0,"Tulare County, CA"
115,2022,Aug,209078,192415,16663,8.0,"Tulare County, CA"
116,2022,Sep,208565,193263,15302,7.3,"Tulare County, CA"
117,2022,Oct,207355,190757,16598,8.0,"Tulare County, CA"
118,2022,Nov,209242,191939,17303,8.3,"Tulare County, CA"
119,2022,Dec,208051,190413,17638,8.5,"Tulare County, CA"
120,2023,Jan,209430,188684,20746,9.9,"Tulare County, CA"
121,2023,Feb,213153,190100,23053,10.8,"Tulare County, CA"
122,2023,Mar,212536,188380,24156,11.4,"Tulare County, CA"
123,2023,Apr,213956,193006,20950,9.8,"Tulare County, CA"
124,2023,May,216249,194551,21698,10.0,"Tulare County, CA"
125,2023,Jun,212871,191367,21504,10.1,"Tulare County, CA"
126,2023,Jul,207903,187282,20621,9.9,"Tulare County, CA"
127,2023,Aug,209675,188981,20694,9.9,"Tulare County, CA"
128,2023,Sep,208915,190316,18599,8.9,"Tulare County, CA"
129,2023,Oct,209072,188958,20114,9.6,"Tulare County, CA"
0,2013,Jan,146974,136523,10451,7.1,"Leon County, FL"
1,2013,Feb,147058,137468,9590,6.5,"Leon County, FL"
2,2013,Mar,146482,137369,9113,6.2,"Leon County, FL"
3,2013,Apr,147362,138695,8667,5.9,"Leon County, FL"
4,2013,May,145967,136628,9339,6.4,"Leon County, FL"
5,2013,Jun,147304,136879,10425,7.1,"Leon County, FL"
6,2013,Jul,147890,137595,10295,7.0,"Leon County, FL"
7,2013,Aug,147153,137584,9569,6.5,"Leon County, FL"
8,2013,Sep,150827,141509,9318,6.2,"Leon County, FL"
9,2013,Oct,150175,141349,8826,5.9,"Leon County, FL"
10,2013,Nov,149117,140364,8753,5.9,"Leon County, FL"
11,2013,Dec,147378,138953,8425,5.7,"Leon County, FL"
12,2014,Jan,148009,139017,8992,6.1,"Leon County, FL"
13,2014,Feb,149349,140675,8674,5.8,"Leon County, FL"
14,2014,Mar,149116,140638,8478,5.7,"Leon County, FL"
15,2014,Apr,148893,141275,7618,5.1,"Leon County, FL"
16,2014,May,148040,139650,8390,5.7,"Leon County, FL"
17,2014,Jun,148721,139538,9183,6.2,"Leon County, FL"
18,2014,Jul,149552,139943,9609,6.4,"Leon County, FL"
19,2014,Aug,148975,139863,9112,6.1,"Leon County, FL"
20,2014,Sep,152860,144324,8536,5.6,"Leon County, FL"
21,2014,Oct,152728,144612,8116,5.3,"Leon County, FL"
22,2014,Nov,150373,142200,8173,5.4,"Leon County, FL"
23,2014,Dec,148705,141148,7557,5.1,"Leon County, FL"
24,2015,Jan,148949,140606,8343,5.6,"Leon County, FL"
25,2015,Feb,148672,141164,7508,5.1,"Leon County, FL"
26,2015,Mar,148070,140870,7200,4.9,"Leon County, FL"
27,2015,Apr,148084,141066,7018,4.7,"Leon County, FL"
28,2015,May,146854,139205,7649,5.2,"Leon County, FL"
29,2015,Jun,147376,139192,8184,5.6,"Leon County, FL"
30,2015,Jul,147144,139096,8048,5.5,"Leon County, FL"
31,2015,Aug,147158,139472,7686,5.2,"Leon County, FL"
32,2015,Sep,150159,142735,7424,4.9,"Leon County, FL"
33,2015,Oct,149978,142876,7102,4.7,"Leon County, FL"
34,2015,Nov,147926,140728,7198,4.9,"Leon County, FL"
35,2015,Dec,147127,140275,6852,4.7,"Leon County, FL"
36,2016,Jan,147661,140411,7250,4.9,"Leon County, FL"
37,2016,Feb,149283,142830,6453,4.3,"Leon County, FL"
38,2016,Mar,149213,142684,6529,4.4,"Leon County, FL"
39,2016,Apr,149959,143629,6330,4.2,"Leon County, FL"
40,2016,May,148977,142734,6243,4.2,"Leon County, FL"
41,2016,Jun,149835,142253,7582,5.1,"Leon County, FL"
42,2016,Jul,150781,143282,7499,5.0,"Leon County, FL"
43,2016,Aug,150758,143376,7382,4.9,"Leon County, FL"
44,2016,Sep,154974,147581,7393,4.8,"Leon County, FL"
45,2016,Oct,154425,147453,6972,4.5,"Leon County, FL"
46,2016,Nov,152219,145558,6661,4.4,"Leon County, FL"
47,2016,Dec,150347,143909,6438,4.3,"Leon County, FL"
48,2017,Jan,149273,142178,7095,4.8,"Leon County, FL"
49,2017,Feb,150586,144401,6185,4.1,"Leon County, FL"
50,2017,Mar,150224,144309,5915,3.9,"Leon County, FL"
51,2017,Apr,151647,146067,5580,3.7,"Leon County, FL"
52,2017,May,150721,145087,5634,3.7,"Leon County, FL"
53,2017,Jun,150203,143711,6492,4.3,"Leon County, FL"
54,2017,Jul,150719,144212,6507,4.3,"Leon County, FL"
55,2017,Aug,148705,142395,6310,4.2,"Leon County, FL"
56,2017,Sep,153945,148165,5780,3.8,"Leon County, FL"
57,2017,Oct,153267,147671,5596,3.7,"Leon County, FL"
58,2017,Nov,151982,146284,5698,3.7,"Leon County, FL"
59,2017,Dec,150292,145093,5199,3.5,"Leon County, FL"
60,2018,Jan,151625,145692,5933,3.9,"Leon County, FL"
61,2018,Feb,152766,147399,5367,3.5,"Leon County, FL"
62,2018,Mar,152027,146813,5214,3.4,"Leon County, FL"
63,2018,Apr,153067,148124,4943,3.2,"Leon County, FL"
64,2018,May,152201,147424,4777,3.1,"Leon County, FL"
65,2018,Jun,151872,145903,5969,3.9,"Leon County, FL"
66,2018,Jul,152636,146829,5807,3.8,"Leon County, FL"
67,2018,Aug,150808,145315,5493,3.6,"Leon County, FL"
68,2018,Sep,155273,150178,5095,3.3,"Leon County, FL"
69,2018,Oct,155245,150065,5180,3.3,"Leon County, FL"
70,2018,Nov,154577,149678,4899,3.2,"Leon County, FL"
71,2018,Dec,153067,148164,4903,3.2,"Leon County, FL"
72,2019,Jan,153065,147299,5766,3.8,"Leon County, FL"
73,2019,Feb,153166,148393,4773,3.1,"Leon County, FL"
74,2019,Mar,153176,148463,4713,3.1,"Leon County, FL"
75,2019,Apr,153928,149715,4213,2.7,"Leon County, FL"
76,2019,May,152734,148289,4445,2.9,"Leon County, FL"
77,2019,Jun,152250,146847,5403,3.5,"Leon County, FL"
78,2019,Jul,153522,147769,5753,3.7,"Leon County, FL"
79,2019,Aug,152534,147233,5301,3.5,"Leon County, FL"
80,2019,Sep,156889,152039,4850,3.1,"Leon County, FL"
81,2019,Oct,156978,152183,4795,3.1,"Leon County, FL"
82,2019,Nov,155511,151110,4401,2.8,"Leon County, FL"
83,2019,Dec,154333,150212,4121,2.7,"Leon County, FL"
84,2020,Jan,154941,150036,4905,3.2,"Leon County, FL"
85,2020,Feb,154966,150950,4016,2.6,"Leon County, FL"
86,2020,Mar,151909,145848,6061,4.0,"Leon County, FL"
87,2020,Apr,139105,127775,11330,8.1,"Leon County, FL"
88,2020,May,146161,133231,12930,8.8,"Leon County, FL"
89,2020,Jun,146876,134633,12243,8.3,"Leon County, FL"
90,2020,Jul,151781,136760,15021,9.9,"Leon County, FL"
91,2020,Aug,151313,140774,10539,7.0,"Leon County, FL"
92,2020,Sep,153816,144099,9717,6.3,"Leon County, FL"
93,2020,Oct,155708,147028,8680,5.6,"Leon County, FL"
94,2020,Nov,153611,145366,8245,5.4,"Leon County, FL"
95,2020,Dec,150955,142989,7966,5.3,"Leon County, FL"
96,2021,Jan,152866,144489,8377,5.5,"Leon County, FL"
97,2021,Feb,153425,145878,7547,4.9,"Leon County, FL"
98,2021,Mar,153578,146734,6844,4.5,"Leon County, FL"
99,2021,Apr,154469,147981,6488,4.2,"Leon County, FL"
100,2021,May,153442,147179,6263,4.1,"Leon County, FL"
101,2021,Jun,154286,146910,7376,4.8,"Leon County, FL"
102,2021,Jul,154718,147468,7250,4.7,"Leon County, FL"
103,2021,Aug,154314,147499,6815,4.4,"Leon County, FL"
104,2021,Sep,158738,152650,6088,3.8,"Leon County, FL"
105,2021,Oct,159389,153348,6041,3.8,"Leon County, FL"
106,2021,Nov,158414,153028,5386,3.4,"Leon County, FL"
107,2021,Dec,156409,151617,4792,3.1,"Leon County, FL"
108,2022,Jan,157669,151675,5994,3.8,"Leon County, FL"
109,2022,Feb,158088,152890,5198,3.3,"Leon County, FL"
110,2022,Mar,158235,153540,4695,3.0,"Leon County, FL"
111,2022,Apr,159730,155269,4461,2.8,"Leon County, FL"
112,2022,May,159005,154462,4543,2.9,"Leon County, FL"
113,2022,Jun,159312,154101,5211,3.3,"Leon County, FL"
114,2022,Jul,159700,154705,4995,3.1,"Leon County, FL"
115,2022,Aug,159300,154461,4839,3.0,"Leon County, FL"
116,2022,Sep,163251,158862,4389,2.7,"Leon County, FL"
117,2022,Oct,163588,159046,4542,2.8,"Leon County, FL"
118,2022,Nov,161723,157318,4405,2.7,"Leon County, FL"
119,2022,Dec,160044,156396,3648,2.3,"Leon County, FL"
120,2023,Jan,160735,156476,4259,2.6,"Leon County, FL"
121,2023,Feb,162413,158135,4278,2.6,"Leon County, FL"
122,2023,Mar,162844,158555,4289,2.6,"Leon County, FL"
123,2023,Apr,163008,159045,3963,2.4,"Leon County, FL"
124,2023,May,162660,157995,4665,2.9,"Leon County, FL"
125,2023,Jun,164222,158873,5349,3.3,"Leon County, FL"
126,2023,Jul,165546,160027,5519,3.3,"Leon County, FL"
127,2023,Aug,166350,160985,5365,3.2,"Leon County, FL"
128,2023,Sep,169183,164029,5154,3.0,"Leon County, FL"
129,2023,Oct,169522,163844,5678,3.3,"Leon County, FL"
0,2013,Jan,296962,271346,25616,8.6,"Lee County, FL"
1,2013,Feb,296025,272564,23461,7.9,"Lee County, FL"
2,2013,Mar,296666,274327,22339,7.5,"Lee County, FL"
3,2013,Apr,297573,275876,21697,7.3,"Lee County, FL"
4,2013,May,299167,276628,22539,7.5,"Lee County, FL"
5,2013,Jun,297090,272986,24104,8.1,"Lee County, FL"
6,2013,Jul,295745,271834,23911,8.1,"Lee County, FL"
7,2013,Aug,295569,272187,23382,7.9,"Lee County, FL"
8,2013,Sep,298760,276103,22657,7.6,"Lee County, FL"
9,2013,Oct,300484,278510,21974,7.3,"Lee County, FL"
10,2013,Nov,302904,282149,20755,6.9,"Lee County, FL"
11,2013,Dec,303236,283759,19477,6.4,"Lee County, FL"
12,2014,Jan,306505,285932,20573,6.7,"Lee County, FL"
13,2014,Feb,308881,288987,19894,6.4,"Lee County, FL"
14,2014,Mar,310747,291069,19678,6.3,"Lee County, FL"
15,2014,Apr,308870,291223,17647,5.7,"Lee County, FL"
16,2014,May,309822,290597,19225,6.2,"Lee County, FL"
17,2014,Jun,306452,286427,20025,6.5,"Lee County, FL"
18,2014,Jul,307007,285994,21013,6.8,"Lee County, FL"
19,2014,Aug,306059,285474,20585,6.7,"Lee County, FL"
20,2014,Sep,309190,290039,19151,6.2,"Lee County, FL"
21,2014,Oct,313877,295535,18342,5.8,"Lee County, FL"
22,2014,Nov,315235,297205,18030,5.7,"Lee County, FL"
23,2014,Dec,315671,298998,16673,5.3,"Lee County, FL"
24,2015,Jan,319681,301391,18290,5.7,"Lee County, FL"
25,2015,Feb,318841,302010,16831,5.3,"Lee County, FL"
26,2015,Mar,319315,303152,16163,5.1,"Lee County, FL"
27,2015,Apr,319159,303426,15733,4.9,"Lee County, FL"
28,2015,May,319807,302841,16966,5.3,"Lee County, FL"
29,2015,Jun,318285,300836,17449,5.5,"Lee County, FL"
30,2015,Jul,317196,299232,17964,5.7,"Lee County, FL"
31,2015,Aug,316673,299312,17361,5.5,"Lee County, FL"
32,2015,Sep,318830,302322,16508,5.2,"Lee County, FL"
33,2015,Oct,324854,308635,16219,5.0,"Lee County, FL"
34,2015,Nov,326159,310301,15858,4.9,"Lee County, FL"
35,2015,Dec,328236,313248,14988,4.6,"Lee County, FL"
36,2016,Jan,329337,313334,16003,4.9,"Lee County, FL"
37,2016,Feb,330897,315965,14932,4.5,"Lee County, FL"
38,2016,Mar,331943,317181,14762,4.4,"Lee County, FL"
39,2016,Apr,329854,315585,14269,4.3,"Lee County, FL"
40,2016,May,329350,315045,14305,4.3,"Lee County, FL"
41,2016,Jun,328135,312135,16000,4.9,"Lee County, FL"
42,2016,Jul,327466,310878,16588,5.1,"Lee County, FL"
43,2016,Aug,327000,310608,16392,5.0,"Lee County, FL"
44,2016,Sep,331023,314729,16294,4.9,"Lee County, FL"
45,2016,Oct,332735,316952,15783,4.7,"Lee County, FL"
46,2016,Nov,332966,317917,15049,4.5,"Lee County, FL"
47,2016,Dec,334067,319546,14521,4.3,"Lee County, FL"
48,2017,Jan,333473,317615,15858,4.8,"Lee County, FL"
49,2017,Feb,335876,321354,14522,4.3,"Lee County, FL"
50,2017,Mar,337759,324135,13624,4.0,"Lee County, FL"
51,2017,Apr,333962,321196,12766,3.8,"Lee County, FL"
52,2017,May,333192,319845,13347,4.0,"Lee County, FL"
53,2017,Jun,331528,317128,14400,4.3,"Lee County, FL"
54,2017,Jul,330755,315954,14801,4.5,"Lee County, FL"
55,2017,Aug,330184,315512,14672,4.4,"Lee County, FL"
56,2017,Sep,322044,307877,14167,4.4,"Lee County, FL"
57,2017,Oct,332727,319527,13200,4.0,"Lee County, FL"
58,2017,Nov,334705,321737,12968,3.9,"Lee County, FL"
59,2017,Dec,335462,323413,12049,3.6,"Lee County, FL"
60,2018,Jan,337726,324463,13263,3.9,"Lee County, FL"
61,2018,Feb,341183,329006,12177,3.6,"Lee County, FL"
62,2018,Mar,341395,329683,11712,3.4,"Lee County, FL"
63,2018,Apr,339000,327954,11046,3.3,"Lee County, FL"
64,2018,May,337459,326469,10990,3.3,"Lee County, FL"
65,2018,Jun,337394,324174,13220,3.9,"Lee County, FL"
66,2018,Jul,337295,324493,12802,3.8,"Lee County, FL"
67,2018,Aug,335360,322752,12608,3.8,"Lee County, FL"
68,2018,Sep,338454,326868,11586,3.4,"Lee County, FL"
69,2018,Oct,340574,328876,11698,3.4,"Lee County, FL"
70,2018,Nov,341130,329948,11182,3.3,"Lee County, FL"
71,2018,Dec,342595,331524,11071,3.2,"Lee County, FL"
72,2019,Jan,343716,330785,12931,3.8,"Lee County, FL"
73,2019,Feb,346505,335212,11293,3.3,"Lee County, FL"
74,2019,Mar,347241,336086,11155,3.2,"Lee County, FL"
75,2019,Apr,345079,335016,10063,2.9,"Lee County, FL"
76,2019,May,344024,333490,10534,3.1,"Lee County, FL"
77,2019,Jun,344305,332019,12286,3.6,"Lee County, FL"
78,2019,Jul,344427,332063,12364,3.6,"Lee County, FL"
79,2019,Aug,344378,332088,12290,3.6,"Lee County, FL"
80,2019,Sep,347016,335985,11031,3.2,"Lee County, FL"
81,2019,Oct,351350,340504,10846,3.1,"Lee County, FL"
82,2019,Nov,351862,341487,10375,2.9,"Lee County, FL"
83,2019,Dec,352489,342946,9543,2.7,"Lee County, FL"
84,2020,Jan,354365,343025,11340,3.2,"Lee County, FL"
85,2020,Feb,356213,346392,9821,2.8,"Lee County, FL"
86,2020,Mar,350422,335781,14641,4.2,"Lee County, FL"
87,2020,Apr,319431,275538,43893,13.7,"Lee County, FL"
88,2020,May,342904,296064,46840,13.7,"Lee County, FL"
89,2020,Jun,343511,305106,38405,11.2,"Lee County, FL"
90,2020,Jul,348695,308070,40625,11.7,"Lee County, FL"
91,2020,Aug,343020,314606,28414,8.3,"Lee County, FL"
92,2020,Sep,345190,319219,25971,7.5,"Lee County, FL"
93,2020,Oct,348950,327163,21787,6.2,"Lee County, FL"
94,2020,Nov,346210,326314,19896,5.7,"Lee County, FL"
95,2020,Dec,347517,328945,18572,5.3,"Lee County, FL"
96,2021,Jan,350776,332370,18406,5.2,"Lee County, FL"
97,2021,Feb,353823,337108,16715,4.7,"Lee County, FL"
98,2021,Mar,356970,340739,16231,4.5,"Lee County, FL"
99,2021,Apr,356590,341297,15293,4.3,"Lee County, FL"
100,2021,May,356616,341815,14801,4.2,"Lee County, FL"
101,2021,Jun,357722,340549,17173,4.8,"Lee County, FL"
102,2021,Jul,357940,341622,16318,4.6,"Lee County, FL"
103,2021,Aug,359286,343401,15885,4.4,"Lee County, FL"
104,2021,Sep,361616,347316,14300,4.0,"Lee County, FL"
105,2021,Oct,364726,351128,13598,3.7,"Lee County, FL"
106,2021,Nov,365696,352934,12762,3.5,"Lee County, FL"
107,2021,Dec,366341,355239,11102,3.0,"Lee County, FL"
108,2022,Jan,369493,355756,13737,3.7,"Lee County, FL"
109,2022,Feb,371508,359663,11845,3.2,"Lee County, FL"
110,2022,Mar,374190,363514,10676,2.9,"Lee County, FL"
111,2022,Apr,372457,362947,9510,2.6,"Lee County, FL"
112,2022,May,373187,363218,9969,2.7,"Lee County, FL"
113,2022,Jun,372244,360631,11613,3.1,"Lee County, FL"
114,2022,Jul,373036,362093,10943,2.9,"Lee County, FL"
115,2022,Aug,374686,363610,11076,3.0,"Lee County, FL"
116,2022,Sep,377077,366913,10164,2.7,"Lee County, FL"
117,2022,Oct,382264,366575,15689,4.1,"Lee County, FL"
118,2022,Nov,380847,367178,13669,3.6,"Lee County, FL"
119,2022,Dec,384222,372810,11412,3.0,"Lee County, FL"
120,2023,Jan,381816,370446,11370,3.0,"Lee County, FL"
121,2023,Feb,384989,374135,10854,2.8,"Lee County, FL"
122,2023,Mar,390532,379527,11005,2.8,"Lee County, FL"
123,2023,Apr,389096,379656,9440,2.4,"Lee County, FL"
124,2023,May,389743,378812,10931,2.8,"Lee County, FL"
125,2023,Jun,390090,378099,11991,3.1,"Lee County, FL"
126,2023,Jul,390029,377567,12462,3.2,"Lee County, FL"
127,2023,Aug,394721,381858,12863,3.3,"Lee County, FL"
128,2023,Sep,396938,384124,12814,3.2,"Lee County, FL"
129,2023,Oct,395206,382524,12682,3.2,"Lee County, FL"
0,2013,Jan,63442,57223,6219,9.8,"Humboldt County, CA"
1,2013,Feb,63481,57641,5840,9.2,"Humboldt County, CA"
2,2013,Mar,63262,57628,5634,8.9,"Humboldt County, CA"
3,2013,Apr,62834,57710,5124,8.2,"Humboldt County, CA"
4,2013,May,63606,58746,4860,7.6,"Humboldt County, CA"
5,2013,Jun,63174,57827,5347,8.5,"Humboldt County, CA"
6,2013,Jul,62141,56809,5332,8.6,"Humboldt County, CA"
7,2013,Aug,61958,56887,5071,8.2,"Humboldt County, CA"
8,2013,Sep,62885,58182,4703,7.5,"Humboldt County, CA"
9,2013,Oct,62309,57590,4719,7.6,"Humboldt County, CA"
10,2013,Nov,62593,57978,4615,7.4,"Humboldt County, CA"
11,2013,Dec,62274,57834,4440,7.1,"Humboldt County, CA"
12,2014,Jan,61744,56936,4808,7.8,"Humboldt County, CA"
13,2014,Feb,62410,57487,4923,7.9,"Humboldt County, CA"
14,2014,Mar,62733,57853,4880,7.8,"Humboldt County, CA"
15,2014,Apr,62127,58032,4095,6.6,"Humboldt County, CA"
16,2014,May,62616,58696,3920,6.3,"Humboldt County, CA"
17,2014,Jun,62512,58346,4166,6.7,"Humboldt County, CA"
18,2014,Jul,61479,57054,4425,7.2,"Humboldt County, CA"
19,2014,Aug,61583,57402,4181,6.8,"Humboldt County, CA"
20,2014,Sep,62546,58805,3741,6.0,"Humboldt County, CA"
21,2014,Oct,62732,58993,3739,6.0,"Humboldt County, CA"
22,2014,Nov,62655,58826,3829,6.1,"Humboldt County, CA"
23,2014,Dec,61675,57996,3679,6.0,"Humboldt County, CA"
24,2015,Jan,61987,57808,4179,6.7,"Humboldt County, CA"
25,2015,Feb,62482,58534,3948,6.3,"Humboldt County, CA"
26,2015,Mar,62462,58593,3869,6.2,"Humboldt County, CA"
27,2015,Apr,62213,58737,3476,5.6,"Humboldt County, CA"
28,2015,May,62750,59448,3302,5.3,"Humboldt County, CA"
29,2015,Jun,62274,58758,3516,5.6,"Humboldt County, CA"
30,2015,Jul,61718,58001,3717,6.0,"Humboldt County, CA"
31,2015,Aug,61624,58177,3447,5.6,"Humboldt County, CA"
32,2015,Sep,62610,59580,3030,4.8,"Humboldt County, CA"
33,2015,Oct,62388,59287,3101,5.0,"Humboldt County, CA"
34,2015,Nov,62941,59742,3199,5.1,"Humboldt County, CA"
35,2015,Dec,62026,58717,3309,5.3,"Humboldt County, CA"
36,2016,Jan,61839,58258,3581,5.8,"Humboldt County, CA"
37,2016,Feb,62615,59174,3441,5.5,"Humboldt County, CA"
38,2016,Mar,63105,59620,3485,5.5,"Humboldt County, CA"
39,2016,Apr,62741,59698,3043,4.9,"Humboldt County, CA"
40,2016,May,62657,59989,2668,4.3,"Humboldt County, CA"
41,2016,Jun,62468,59314,3154,5.0,"Humboldt County, CA"
42,2016,Jul,61453,58242,3211,5.2,"Humboldt County, CA"
43,2016,Aug,61734,58612,3122,5.1,"Humboldt County, CA"
44,2016,Sep,62924,60070,2854,4.5,"Humboldt County, CA"
45,2016,Oct,62976,60099,2877,4.6,"Humboldt County, CA"
46,2016,Nov,62533,59748,2785,4.5,"Humboldt County, CA"
47,2016,Dec,62037,59227,2810,4.5,"Humboldt County, CA"
48,2017,Jan,61960,58754,3206,5.2,"Humboldt County, CA"
49,2017,Feb,62955,59869,3086,4.9,"Humboldt County, CA"
50,2017,Mar,62894,59984,2910,4.6,"Humboldt County, CA"
51,2017,Apr,62622,59987,2635,4.2,"Humboldt County, CA"
52,2017,May,62856,60473,2383,3.8,"Humboldt County, CA"
53,2017,Jun,62520,59736,2784,4.5,"Humboldt County, CA"
54,2017,Jul,61498,58593,2905,4.7,"Humboldt County, CA"
55,2017,Aug,61618,58808,2810,4.6,"Humboldt County, CA"
56,2017,Sep,63054,60747,2307,3.7,"Humboldt County, CA"
57,2017,Oct,62949,60703,2246,3.6,"Humboldt County, CA"
58,2017,Nov,62560,60327,2233,3.6,"Humboldt County, CA"
59,2017,Dec,62354,60128,2226,3.6,"Humboldt County, CA"
60,2018,Jan,61325,58754,2571,4.2,"Humboldt County, CA"
61,2018,Feb,62328,59821,2507,4.0,"Humboldt County, CA"
62,2018,Mar,62474,60048,2426,3.9,"Humboldt County, CA"
63,2018,Apr,62414,60224,2190,3.5,"Humboldt County, CA"
64,2018,May,62852,60949,1903,3.0,"Humboldt County, CA"
65,2018,Jun,62317,59924,2393,3.8,"Humboldt County, CA"
66,2018,Jul,61582,59175,2407,3.9,"Humboldt County, CA"
67,2018,Aug,61798,59513,2285,3.7,"Humboldt County, CA"
68,2018,Sep,63231,61230,2001,3.2,"Humboldt County, CA"
69,2018,Oct,63543,61460,2083,3.3,"Humboldt County, CA"
70,2018,Nov,63592,61455,2137,3.4,"Humboldt County, CA"
71,2018,Dec,63004,60711,2293,3.6,"Humboldt County, CA"
72,2019,Jan,62145,59220,2925,4.7,"Humboldt County, CA"
73,2019,Feb,62754,60106,2648,4.2,"Humboldt County, CA"
74,2019,Mar,62897,60330,2567,4.1,"Humboldt County, CA"
75,2019,Apr,62085,59915,2170,3.5,"Humboldt County, CA"
76,2019,May,62321,60406,1915,3.1,"Humboldt County, CA"
77,2019,Jun,61779,59511,2268,3.7,"Humboldt County, CA"
78,2019,Jul,61303,58864,2439,4.0,"Humboldt County, CA"
79,2019,Aug,61480,59156,2324,3.8,"Humboldt County, CA"
80,2019,Sep,62498,60640,1858,3.0,"Humboldt County, CA"
81,2019,Oct,62791,60808,1983,3.2,"Humboldt County, CA"
82,2019,Nov,62631,60603,2028,3.2,"Humboldt County, CA"
83,2019,Dec,62196,60180,2016,3.2,"Humboldt County, CA"
84,2020,Jan,61468,58919,2549,4.1,"Humboldt County, CA"
85,2020,Feb,62393,60012,2381,3.8,"Humboldt County, CA"
86,2020,Mar,62284,58841,3443,5.5,"Humboldt County, CA"
87,2020,Apr,59474,50283,9191,15.5,"Humboldt County, CA"
88,2020,May,58027,50387,7640,13.2,"Humboldt County, CA"
89,2020,Jun,59683,52875,6808,11.4,"Humboldt County, CA"
90,2020,Jul,58951,52656,6295,10.7,"Humboldt County, CA"
91,2020,Aug,58758,53514,5244,8.9,"Humboldt County, CA"
92,2020,Sep,59670,54888,4782,8.0,"Humboldt County, CA"
93,2020,Oct,59849,55568,4281,7.2,"Humboldt County, CA"
94,2020,Nov,59299,55027,4272,7.2,"Humboldt County, CA"
95,2020,Dec,58597,54117,4480,7.6,"Humboldt County, CA"
96,2021,Jan,58355,53730,4625,7.9,"Humboldt County, CA"
97,2021,Feb,58260,53718,4542,7.8,"Humboldt County, CA"
98,2021,Mar,58888,54503,4385,7.4,"Humboldt County, CA"
99,2021,Apr,58300,54204,4096,7.0,"Humboldt County, CA"
100,2021,May,58805,55185,3620,6.2,"Humboldt County, CA"
101,2021,Jun,59148,55034,4114,7.0,"Humboldt County, CA"
102,2021,Jul,58821,54841,3980,6.8,"Humboldt County, CA"
103,2021,Aug,58311,54548,3763,6.5,"Humboldt County, CA"
104,2021,Sep,59920,56851,3069,5.1,"Humboldt County, CA"
105,2021,Oct,59750,56787,2963,5.0,"Humboldt County, CA"
106,2021,Nov,59537,56727,2810,4.7,"Humboldt County, CA"
107,2021,Dec,58795,56202,2593,4.4,"Humboldt County, CA"
108,2022,Jan,59167,56170,2997,5.1,"Humboldt County, CA"
109,2022,Feb,59640,56893,2747,4.6,"Humboldt County, CA"
110,2022,Mar,60077,57580,2497,4.2,"Humboldt County, CA"
111,2022,Apr,59228,57015,2213,3.7,"Humboldt County, CA"
112,2022,May,59512,57494,2018,3.4,"Humboldt County, CA"
113,2022,Jun,59472,57125,2347,3.9,"Humboldt County, CA"
114,2022,Jul,58437,56108,2329,4.0,"Humboldt County, CA"
115,2022,Aug,58403,55982,2421,4.1,"Humboldt County, CA"
116,2022,Sep,60050,57967,2083,3.5,"Humboldt County, CA"
117,2022,Oct,60229,57988,2241,3.7,"Humboldt County, CA"
118,2022,Nov,60222,57873,2349,3.9,"Humboldt County, CA"
119,2022,Dec,59806,57569,2237,3.7,"Humboldt County, CA"
120,2023,Jan,59404,56532,2872,4.8,"Humboldt County, CA"
121,2023,Feb,60061,57176,2885,4.8,"Humboldt County, CA"
122,2023,Mar,60471,57612,2859,4.7,"Humboldt County, CA"
123,2023,Apr,59503,57010,2493,4.2,"Humboldt County, CA"
124,2023,May,59693,57147,2546,4.3,"Humboldt County, CA"
125,2023,Jun,59546,56767,2779,4.7,"Humboldt County, CA"
126,2023,Jul,58913,56201,2712,4.6,"Humboldt County, CA"
127,2023,Aug,58833,55898,2935,5.0,"Humboldt County, CA"
128,2023,Sep,60924,58301,2623,4.3,"Humboldt County, CA"
129,2023,Oct,60953,58246,2707,4.4,"Humboldt County, CA"
0,2013,Jan,393298,338103,55195,14.0,"Kern County, CA"
1,2013,Feb,389519,336388,53131,13.6,"Kern County, CA"
2,2013,Mar,382820,330245,52575,13.7,"Kern County, CA"
3,2013,Apr,386252,338610,47642,12.3,"Kern County, CA"
4,2013,May,393083,347785,45298,11.5,"Kern County, CA"
5,2013,Jun,394770,346678,48092,12.2,"Kern County, CA"
6,2013,Jul,398022,351676,46346,11.6,"Kern County, CA"
7,2013,Aug,397698,353834,43864,11.0,"Kern County, CA"
8,2013,Sep,398158,356797,41361,10.4,"Kern County, CA"
9,2013,Oct,395025,353344,41681,10.6,"Kern County, CA"
10,2013,Nov,390973,349775,41198,10.5,"Kern County, CA"
11,2013,Dec,386838,343532,43306,11.2,"Kern County, CA"
12,2014,Jan,390098,342505,47593,12.2,"Kern County, CA"
13,2014,Feb,389683,341532,48151,12.4,"Kern County, CA"
14,2014,Mar,385491,335625,49866,12.9,"Kern County, CA"
15,2014,Apr,387118,344238,42880,11.1,"Kern County, CA"
16,2014,May,395721,355266,40455,10.2,"Kern County, CA"
17,2014,Jun,391773,350135,41638,10.6,"Kern County, CA"
18,2014,Jul,395808,354470,41338,10.4,"Kern County, CA"
19,2014,Aug,397963,359365,38598,9.7,"Kern County, CA"
20,2014,Sep,396466,361358,35108,8.9,"Kern County, CA"
21,2014,Oct,396160,361275,34885,8.8,"Kern County, CA"
22,2014,Nov,391656,355324,36332,9.3,"Kern County, CA"
23,2014,Dec,384811,346445,38366,10.0,"Kern County, CA"
24,2015,Jan,393153,348838,44315,11.3,"Kern County, CA"
25,2015,Feb,392960,348307,44653,11.4,"Kern County, CA"
26,2015,Mar,384951,339056,45895,11.9,"Kern County, CA"
27,2015,Apr,388610,346812,41798,10.8,"Kern County, CA"
28,2015,May,394547,354206,40341,10.2,"Kern County, CA"
29,2015,Jun,389677,347949,41728,10.7,"Kern County, CA"
30,2015,Jul,391479,351274,40205,10.3,"Kern County, CA"
31,2015,Aug,393854,356786,37068,9.4,"Kern County, CA"
32,2015,Sep,391712,357328,34384,8.8,"Kern County, CA"
33,2015,Oct,390681,355767,34914,8.9,"Kern County, CA"
34,2015,Nov,386361,350065,36296,9.4,"Kern County, CA"
35,2015,Dec,383673,344209,39464,10.3,"Kern County, CA"
36,2016,Jan,391265,347492,43773,11.2,"Kern County, CA"
37,2016,Feb,390253,345501,44752,11.5,"Kern County, CA"
38,2016,Mar,383741,336273,47468,12.4,"Kern County, CA"
39,2016,Apr,387299,344781,42518,11.0,"Kern County, CA"
40,2016,May,388621,349768,38853,10.0,"Kern County, CA"
41,2016,Jun,389693,348058,41635,10.7,"Kern County, CA"
42,2016,Jul,388193,347871,40322,10.4,"Kern County, CA"
43,2016,Aug,389791,351739,38052,9.8,"Kern County, CA"
44,2016,Sep,390806,354660,36146,9.2,"Kern County, CA"
45,2016,Oct,390631,355000,35631,9.1,"Kern County, CA"
46,2016,Nov,385789,349556,36233,9.4,"Kern County, CA"
47,2016,Dec,381232,341606,39626,10.4,"Kern County, CA"
48,2017,Jan,384782,341756,43026,11.2,"Kern County, CA"
49,2017,Feb,384957,341251,43706,11.4,"Kern County, CA"
50,2017,Mar,381627,338071,43556,11.4,"Kern County, CA"
51,2017,Apr,382874,344869,38005,9.9,"Kern County, CA"
52,2017,May,385548,351351,34197,8.9,"Kern County, CA"
53,2017,Jun,386566,350355,36211,9.4,"Kern County, CA"
54,2017,Jul,383949,348301,35648,9.3,"Kern County, CA"
55,2017,Aug,386723,353272,33451,8.6,"Kern County, CA"
56,2017,Sep,387758,358261,29497,7.6,"Kern County, CA"
57,2017,Oct,385758,357348,28410,7.4,"Kern County, CA"
58,2017,Nov,382462,353459,29003,7.6,"Kern County, CA"
59,2017,Dec,375875,343625,32250,8.6,"Kern County, CA"
60,2018,Jan,381399,345450,35949,9.4,"Kern County, CA"
61,2018,Feb,384594,347254,37340,9.7,"Kern County, CA"
62,2018,Mar,376380,338742,37638,10.0,"Kern County, CA"
63,2018,Apr,380916,348080,32836,8.6,"Kern County, CA"
64,2018,May,385261,355730,29531,7.7,"Kern County, CA"
65,2018,Jun,386665,353898,32767,8.5,"Kern County, CA"
66,2018,Jul,387593,355863,31730,8.2,"Kern County, CA"
67,2018,Aug,389749,360975,28774,7.4,"Kern County, CA"
68,2018,Sep,389804,363843,25961,6.7,"Kern County, CA"
69,2018,Oct,392029,366255,25774,6.6,"Kern County, CA"
70,2018,Nov,389283,363299,25984,6.7,"Kern County, CA"
71,2018,Dec,385075,355257,29818,7.7,"Kern County, CA"
72,2019,Jan,391034,355068,35966,9.2,"Kern County, CA"
73,2019,Feb,390223,354527,35696,9.1,"Kern County, CA"
74,2019,Mar,382649,346086,36563,9.6,"Kern County, CA"
75,2019,Apr,383576,352194,31382,8.2,"Kern County, CA"
76,2019,May,385606,357384,28222,7.3,"Kern County, CA"
77,2019,Jun,389116,358123,30993,8.0,"Kern County, CA"
78,2019,Jul,382638,350427,32211,8.4,"Kern County, CA"
79,2019,Aug,394918,366062,28856,7.3,"Kern County, CA"
80,2019,Sep,394905,369990,24915,6.3,"Kern County, CA"
81,2019,Oct,394682,369348,25334,6.4,"Kern County, CA"
82,2019,Nov,389028,362907,26121,6.7,"Kern County, CA"
83,2019,Dec,387374,358447,28927,7.5,"Kern County, CA"
84,2020,Jan,394315,359736,34579,8.8,"Kern County, CA"
85,2020,Feb,392589,356776,35813,9.1,"Kern County, CA"
86,2020,Mar,394061,340716,53345,13.5,"Kern County, CA"
87,2020,Apr,377844,306420,71424,18.9,"Kern County, CA"
88,2020,May,381430,315612,65818,17.3,"Kern County, CA"
89,2020,Jun,386123,326059,60064,15.6,"Kern County, CA"
90,2020,Jul,384092,325492,58600,15.3,"Kern County, CA"
91,2020,Aug,390008,341768,48240,12.4,"Kern County, CA"
92,2020,Sep,388973,343332,45641,11.7,"Kern County, CA"
93,2020,Oct,388945,348418,40527,10.4,"Kern County, CA"
94,2020,Nov,386238,346121,40117,10.4,"Kern County, CA"
95,2020,Dec,380722,338822,41900,11.0,"Kern County, CA"
96,2021,Jan,383401,339667,43734,11.4,"Kern County, CA"
97,2021,Feb,382464,337620,44844,11.7,"Kern County, CA"
98,2021,Mar,374012,329167,44845,12.0,"Kern County, CA"
99,2021,Apr,381863,338311,43552,11.4,"Kern County, CA"
100,2021,May,386743,346630,40113,10.4,"Kern County, CA"
101,2021,Jun,387294,343332,43962,11.4,"Kern County, CA"
102,2021,Jul,389305,348248,41057,10.5,"Kern County, CA"
103,2021,Aug,389782,352022,37760,9.7,"Kern County, CA"
104,2021,Sep,389269,356840,32429,8.3,"Kern County, CA"
105,2021,Oct,391786,361019,30767,7.9,"Kern County, CA"
106,2021,Nov,390262,362105,28157,7.2,"Kern County, CA"
107,2021,Dec,384033,355899,28134,7.3,"Kern County, CA"
108,2022,Jan,390440,357809,32631,8.4,"Kern County, CA"
109,2022,Feb,391512,359621,31891,8.1,"Kern County, CA"
110,2022,Mar,382827,352540,30287,7.9,"Kern County, CA"
111,2022,Apr,386358,359399,26959,7.0,"Kern County, CA"
112,2022,May,385892,360874,25018,6.5,"Kern County, CA"
113,2022,Jun,387869,360600,27269,7.0,"Kern County, CA"
114,2022,Jul,390934,364386,26548,6.8,"Kern County, CA"
115,2022,Aug,397201,371459,25742,6.5,"Kern County, CA"
116,2022,Sep,397796,374588,23208,5.8,"Kern County, CA"
117,2022,Oct,398887,374416,24471,6.1,"Kern County, CA"
118,2022,Nov,397974,372637,25337,6.4,"Kern County, CA"
119,2022,Dec,393145,366569,26576,6.8,"Kern County, CA"
120,2023,Jan,393275,361336,31939,8.1,"Kern County, CA"
121,2023,Feb,399538,363519,36019,9.0,"Kern County, CA"
122,2023,Mar,392455,354784,37671,9.6,"Kern County, CA"
123,2023,Apr,395530,362705,32825,8.3,"Kern County, CA"
124,2023,May,398028,363854,34174,8.6,"Kern County, CA"
125,2023,Jun,394784,359945,34839,8.8,"Kern County, CA"
126,2023,Jul,394717,362179,32538,8.2,"Kern County, CA"
127,2023,Aug,398435,366395,32040,8.0,"Kern County, CA"
128,2023,Sep,398766,370241,28525,7.2,"Kern County, CA"
129,2023,Oct,401271,371129,30142,7.5,"Kern County, CA"
0,2013,Jan,132674,120837,11837,8.9,"Lake County, FL"
1,2013,Feb,132683,121860,10823,8.2,"Lake County, FL"
2,2013,Mar,132884,122583,10301,7.8,"Lake County, FL"
3,2013,Apr,133275,123330,9945,7.5,"Lake County, FL"
4,2013,May,135592,125233,10359,7.6,"Lake County, FL"
5,2013,Jun,136735,125778,10957,8.0,"Lake County, FL"
6,2013,Jul,137057,126182,10875,7.9,"Lake County, FL"
7,2013,Aug,137005,126342,10663,7.8,"Lake County, FL"
8,2013,Sep,137258,126942,10316,7.5,"Lake County, FL"
9,2013,Oct,136186,126052,10134,7.4,"Lake County, FL"
10,2013,Nov,135266,125543,9723,7.2,"Lake County, FL"
11,2013,Dec,134868,125684,9184,6.8,"Lake County, FL"
12,2014,Jan,135717,125943,9774,7.2,"Lake County, FL"
13,2014,Feb,136252,126790,9462,6.9,"Lake County, FL"
14,2014,Mar,137216,127868,9348,6.8,"Lake County, FL"
15,2014,Apr,136341,127907,8434,6.2,"Lake County, FL"
16,2014,May,138651,129577,9074,6.5,"Lake County, FL"
17,2014,Jun,138956,129627,9329,6.7,"Lake County, FL"
18,2014,Jul,139804,130061,9743,7.0,"Lake County, FL"
19,2014,Aug,139756,130241,9515,6.8,"Lake County, FL"
20,2014,Sep,139815,130889,8926,6.4,"Lake County, FL"
21,2014,Oct,139511,130797,8714,6.2,"Lake County, FL"
22,2014,Nov,138113,129456,8657,6.3,"Lake County, FL"
23,2014,Dec,137465,129427,8038,5.8,"Lake County, FL"
24,2015,Jan,138470,129641,8829,6.4,"Lake County, FL"
25,2015,Feb,138540,130418,8122,5.9,"Lake County, FL"
26,2015,Mar,138921,131192,7729,5.6,"Lake County, FL"
27,2015,Apr,139830,132286,7544,5.4,"Lake County, FL"
28,2015,May,141966,133937,8029,5.7,"Lake County, FL"
29,2015,Jun,142585,134440,8145,5.7,"Lake County, FL"
30,2015,Jul,142891,134551,8340,5.8,"Lake County, FL"
31,2015,Aug,142685,134698,7987,5.6,"Lake County, FL"
32,2015,Sep,142945,135363,7582,5.3,"Lake County, FL"
33,2015,Oct,142908,135350,7558,5.3,"Lake County, FL"
34,2015,Nov,142078,134634,7444,5.2,"Lake County, FL"
35,2015,Dec,142289,135188,7101,5.0,"Lake County, FL"
36,2016,Jan,143232,135662,7570,5.3,"Lake County, FL"
37,2016,Feb,144080,137055,7025,4.9,"Lake County, FL"
38,2016,Mar,144792,137771,7021,4.8,"Lake County, FL"
39,2016,Apr,144820,137995,6825,4.7,"Lake County, FL"
40,2016,May,146444,139670,6774,4.6,"Lake County, FL"
41,2016,Jun,147397,139884,7513,5.1,"Lake County, FL"
42,2016,Jul,148305,140677,7628,5.1,"Lake County, FL"
43,2016,Aug,148088,140617,7471,5.0,"Lake County, FL"
44,2016,Sep,149009,141580,7429,5.0,"Lake County, FL"
45,2016,Oct,148516,141209,7307,4.9,"Lake County, FL"
46,2016,Nov,147095,140129,6966,4.7,"Lake County, FL"
47,2016,Dec,147150,140424,6726,4.6,"Lake County, FL"
48,2017,Jan,146956,139507,7449,5.1,"Lake County, FL"
49,2017,Feb,147718,140923,6795,4.6,"Lake County, FL"
50,2017,Mar,148246,141847,6399,4.3,"Lake County, FL"
51,2017,Apr,148673,142645,6028,4.1,"Lake County, FL"
52,2017,May,149657,143418,6239,4.2,"Lake County, FL"
53,2017,Jun,150907,144274,6633,4.4,"Lake County, FL"
54,2017,Jul,151159,144402,6757,4.5,"Lake County, FL"
55,2017,Aug,150615,143869,6746,4.5,"Lake County, FL"
56,2017,Sep,151796,145625,6171,4.1,"Lake County, FL"
57,2017,Oct,151357,145342,6015,4.0,"Lake County, FL"
58,2017,Nov,150652,144637,6015,4.0,"Lake County, FL"
59,2017,Dec,150575,144946,5629,3.7,"Lake County, FL"
60,2018,Jan,151538,145258,6280,4.1,"Lake County, FL"
61,2018,Feb,152420,146628,5792,3.8,"Lake County, FL"
62,2018,Mar,152767,147211,5556,3.6,"Lake County, FL"
63,2018,Apr,153123,147870,5253,3.4,"Lake County, FL"
64,2018,May,154110,148875,5235,3.4,"Lake County, FL"
65,2018,Jun,155703,149460,6243,4.0,"Lake County, FL"
66,2018,Jul,156163,150149,6014,3.9,"Lake County, FL"
67,2018,Aug,155356,149451,5905,3.8,"Lake County, FL"
68,2018,Sep,156144,150720,5424,3.5,"Lake County, FL"
69,2018,Oct,156897,151453,5444,3.5,"Lake County, FL"
70,2018,Nov,155509,150263,5246,3.4,"Lake County, FL"
71,2018,Dec,155041,149794,5247,3.4,"Lake County, FL"
72,2019,Jan,157433,151263,6170,3.9,"Lake County, FL"
73,2019,Feb,158402,153034,5368,3.4,"Lake County, FL"
74,2019,Mar,158736,153484,5252,3.3,"Lake County, FL"
75,2019,Apr,159077,154362,4715,3.0,"Lake County, FL"
76,2019,May,160120,155183,4937,3.1,"Lake County, FL"
77,2019,Jun,161657,155924,5733,3.5,"Lake County, FL"
78,2019,Jul,162234,156400,5834,3.6,"Lake County, FL"
79,2019,Aug,162362,156656,5706,3.5,"Lake County, FL"
80,2019,Sep,162872,157814,5058,3.1,"Lake County, FL"
81,2019,Oct,162969,157913,5056,3.1,"Lake County, FL"
82,2019,Nov,161859,156927,4932,3.0,"Lake County, FL"
83,2019,Dec,161795,157228,4567,2.8,"Lake County, FL"
84,2020,Jan,163924,158520,5404,3.3,"Lake County, FL"
85,2020,Feb,164435,159819,4616,2.8,"Lake County, FL"
86,2020,Mar,162009,155046,6963,4.3,"Lake County, FL"
87,2020,Apr,149106,128502,20604,13.8,"Lake County, FL"
88,2020,May,156795,126679,30116,19.2,"Lake County, FL"
89,2020,Jun,155333,130982,24351,15.7,"Lake County, FL"
90,2020,Jul,157171,135740,21431,13.6,"Lake County, FL"
91,2020,Aug,154104,139356,14748,9.6,"Lake County, FL"
92,2020,Sep,154697,141057,13640,8.8,"Lake County, FL"
93,2020,Oct,155437,144122,11315,7.3,"Lake County, FL"
94,2020,Nov,155265,144945,10320,6.6,"Lake County, FL"
95,2020,Dec,154745,145103,9642,6.2,"Lake County, FL"
96,2021,Jan,152734,143409,9325,6.1,"Lake County, FL"
97,2021,Feb,153491,145102,8389,5.5,"Lake County, FL"
98,2021,Mar,154697,146570,8127,5.3,"Lake County, FL"
99,2021,Apr,155938,148241,7697,4.9,"Lake County, FL"
100,2021,May,157158,149690,7468,4.8,"Lake County, FL"
101,2021,Jun,159910,151335,8575,5.4,"Lake County, FL"
102,2021,Jul,161835,153797,8038,5.0,"Lake County, FL"
103,2021,Aug,162896,155128,7768,4.8,"Lake County, FL"
104,2021,Sep,164094,157127,6967,4.2,"Lake County, FL"
105,2021,Oct,165400,158755,6645,4.0,"Lake County, FL"
106,2021,Nov,165521,159195,6326,3.8,"Lake County, FL"
107,2021,Dec,165412,159897,5515,3.3,"Lake County, FL"
108,2022,Jan,166594,159882,6712,4.0,"Lake County, FL"
109,2022,Feb,167288,161487,5801,3.5,"Lake County, FL"
110,2022,Mar,168579,163309,5270,3.1,"Lake County, FL"
111,2022,Apr,168687,163955,4732,2.8,"Lake County, FL"
112,2022,May,170193,165333,4860,2.9,"Lake County, FL"
113,2022,Jun,171708,166155,5553,3.2,"Lake County, FL"
114,2022,Jul,172377,167105,5272,3.1,"Lake County, FL"
115,2022,Aug,173230,167938,5292,3.1,"Lake County, FL"
116,2022,Sep,174376,169496,4880,2.8,"Lake County, FL"
117,2022,Oct,173733,168882,4851,2.8,"Lake County, FL"
118,2022,Nov,172905,168154,4751,2.7,"Lake County, FL"
119,2022,Dec,172924,168754,4170,2.4,"Lake County, FL"
120,2023,Jan,172776,168004,4772,2.8,"Lake County, FL"
121,2023,Feb,174310,169574,4736,2.7,"Lake County, FL"
122,2023,Mar,175643,170796,4847,2.8,"Lake County, FL"
123,2023,Apr,175787,171534,4253,2.4,"Lake County, FL"
124,2023,May,176237,171277,4960,2.8,"Lake County, FL"
125,2023,Jun,178259,172717,5542,3.1,"Lake County, FL"
126,2023,Jul,179079,173257,5822,3.3,"Lake County, FL"
127,2023,Aug,180286,174215,6071,3.4,"Lake County, FL"
128,2023,Sep,180862,174849,6013,3.3,"Lake County, FL"
129,2023,Oct,180134,174059,6075,3.4,"Lake County, FL"
0,2013,Jan,153091,140896,12195,8.0,"Manatee County, FL"
1,2013,Feb,153267,142165,11102,7.2,"Manatee County, FL"
2,2013,Mar,153453,142918,10535,6.9,"Manatee County, FL"
3,2013,Apr,153516,143399,10117,6.6,"Manatee County, FL"
4,2013,May,156048,145371,10677,6.8,"Manatee County, FL"
5,2013,Jun,155539,144110,11429,7.3,"Manatee County, FL"
6,2013,Jul,154817,143154,11663,7.5,"Manatee County, FL"
7,2013,Aug,154319,142988,11331,7.3,"Manatee County, FL"
8,2013,Sep,155106,144093,11013,7.1,"Manatee County, FL"
9,2013,Oct,155360,144711,10649,6.9,"Manatee County, FL"
10,2013,Nov,156832,146859,9973,6.4,"Manatee County, FL"
11,2013,Dec,157445,148041,9404,6.0,"Manatee County, FL"
12,2014,Jan,157934,147990,9944,6.3,"Manatee County, FL"
13,2014,Feb,158788,149157,9631,6.1,"Manatee County, FL"
14,2014,Mar,160170,150611,9559,6.0,"Manatee County, FL"
15,2014,Apr,158751,150248,8503,5.4,"Manatee County, FL"
16,2014,May,160430,151147,9283,5.8,"Manatee County, FL"
17,2014,Jun,159655,149999,9656,6.0,"Manatee County, FL"
18,2014,Jul,159735,149375,10360,6.5,"Manatee County, FL"
19,2014,Aug,159708,149466,10242,6.4,"Manatee County, FL"
20,2014,Sep,160459,150875,9584,6.0,"Manatee County, FL"
21,2014,Oct,162241,152996,9245,5.7,"Manatee County, FL"
22,2014,Nov,162358,153379,8979,5.5,"Manatee County, FL"
23,2014,Dec,163077,154728,8349,5.1,"Manatee County, FL"
24,2015,Jan,164636,155391,9245,5.6,"Manatee County, FL"
25,2015,Feb,164211,155690,8521,5.2,"Manatee County, FL"
26,2015,Mar,165297,157099,8198,5.0,"Manatee County, FL"
27,2015,Apr,165024,157164,7860,4.8,"Manatee County, FL"
28,2015,May,166901,158442,8459,5.1,"Manatee County, FL"
29,2015,Jun,166089,157447,8642,5.2,"Manatee County, FL"
30,2015,Jul,164972,155790,9182,5.6,"Manatee County, FL"
31,2015,Aug,164634,155705,8929,5.4,"Manatee County, FL"
32,2015,Sep,164875,156410,8465,5.1,"Manatee County, FL"
33,2015,Oct,166096,157722,8374,5.0,"Manatee County, FL"
34,2015,Nov,166193,158048,8145,4.9,"Manatee County, FL"
35,2015,Dec,167402,159708,7694,4.6,"Manatee County, FL"
36,2016,Jan,169502,161264,8238,4.9,"Manatee County, FL"
37,2016,Feb,170689,163044,7645,4.5,"Manatee County, FL"
38,2016,Mar,171398,163774,7624,4.4,"Manatee County, FL"
39,2016,Apr,170167,162853,7314,4.3,"Manatee County, FL"
40,2016,May,171252,164044,7208,4.2,"Manatee County, FL"
41,2016,Jun,170598,162566,8032,4.7,"Manatee County, FL"
42,2016,Jul,170764,162323,8441,4.9,"Manatee County, FL"
43,2016,Aug,170393,162063,8330,4.9,"Manatee County, FL"
44,2016,Sep,171417,163086,8331,4.9,"Manatee County, FL"
45,2016,Oct,172332,164277,8055,4.7,"Manatee County, FL"
46,2016,Nov,172383,164648,7735,4.5,"Manatee County, FL"
47,2016,Dec,172876,165425,7451,4.3,"Manatee County, FL"
48,2017,Jan,172629,164519,8110,4.7,"Manatee County, FL"
49,2017,Feb,173273,165832,7441,4.3,"Manatee County, FL"
50,2017,Mar,174530,167595,6935,4.0,"Manatee County, FL"
51,2017,Apr,173239,166788,6451,3.7,"Manatee County, FL"
52,2017,May,173771,167111,6660,3.8,"Manatee County, FL"
53,2017,Jun,173475,166290,7185,4.1,"Manatee County, FL"
54,2017,Jul,173328,165839,7489,4.3,"Manatee County, FL"
55,2017,Aug,173072,165453,7619,4.4,"Manatee County, FL"
56,2017,Sep,172764,165823,6941,4.0,"Manatee County, FL"
57,2017,Oct,173678,166991,6687,3.9,"Manatee County, FL"
58,2017,Nov,173538,166899,6639,3.8,"Manatee County, FL"
59,2017,Dec,173823,167659,6164,3.5,"Manatee County, FL"
60,2018,Jan,175575,168714,6861,3.9,"Manatee County, FL"
61,2018,Feb,176984,170622,6362,3.6,"Manatee County, FL"
62,2018,Mar,177370,171321,6049,3.4,"Manatee County, FL"
63,2018,Apr,176286,170563,5723,3.2,"Manatee County, FL"
64,2018,May,176847,171143,5704,3.2,"Manatee County, FL"
65,2018,Jun,177222,170434,6788,3.8,"Manatee County, FL"
66,2018,Jul,176599,169965,6634,3.8,"Manatee County, FL"
67,2018,Aug,176591,170021,6570,3.7,"Manatee County, FL"
68,2018,Sep,176392,170330,6062,3.4,"Manatee County, FL"
69,2018,Oct,178218,172165,6053,3.4,"Manatee County, FL"
70,2018,Nov,177635,171835,5800,3.3,"Manatee County, FL"
71,2018,Dec,177107,171402,5705,3.2,"Manatee County, FL"
72,2019,Jan,178850,172197,6653,3.7,"Manatee County, FL"
73,2019,Feb,179432,173700,5732,3.2,"Manatee County, FL"
74,2019,Mar,179528,173889,5639,3.1,"Manatee County, FL"
75,2019,Apr,178422,173317,5105,2.9,"Manatee County, FL"
76,2019,May,179274,173909,5365,3.0,"Manatee County, FL"
77,2019,Jun,179335,173102,6233,3.5,"Manatee County, FL"
78,2019,Jul,179150,172726,6424,3.6,"Manatee County, FL"
79,2019,Aug,178596,172212,6384,3.6,"Manatee County, FL"
80,2019,Sep,180181,174439,5742,3.2,"Manatee County, FL"
81,2019,Oct,180417,174798,5619,3.1,"Manatee County, FL"
82,2019,Nov,180824,175418,5406,3.0,"Manatee County, FL"
83,2019,Dec,181533,176545,4988,2.7,"Manatee County, FL"
84,2020,Jan,180721,174902,5819,3.2,"Manatee County, FL"
85,2020,Feb,181499,176463,5036,2.8,"Manatee County, FL"
86,2020,Mar,178896,171379,7517,4.2,"Manatee County, FL"
87,2020,Apr,161585,140972,20613,12.8,"Manatee County, FL"
88,2020,May,174470,152778,21692,12.4,"Manatee County, FL"
89,2020,Jun,175998,158768,17230,9.8,"Manatee County, FL"
90,2020,Jul,177459,158720,18739,10.6,"Manatee County, FL"
91,2020,Aug,175517,162475,13042,7.4,"Manatee County, FL"
92,2020,Sep,176037,163881,12156,6.9,"Manatee County, FL"
93,2020,Oct,176863,166523,10340,5.8,"Manatee County, FL"
94,2020,Nov,175782,166250,9532,5.4,"Manatee County, FL"
95,2020,Dec,176276,167261,9015,5.1,"Manatee County, FL"
96,2021,Jan,176734,167910,8824,5.0,"Manatee County, FL"
97,2021,Feb,178036,169999,8037,4.5,"Manatee County, FL"
98,2021,Mar,179121,171316,7805,4.4,"Manatee County, FL"
99,2021,Apr,179187,171923,7264,4.1,"Manatee County, FL"
100,2021,May,179863,172850,7013,3.9,"Manatee County, FL"
101,2021,Jun,181658,173272,8386,4.6,"Manatee County, FL"
102,2021,Jul,180727,172683,8044,4.5,"Manatee County, FL"
103,2021,Aug,181079,173284,7795,4.3,"Manatee County, FL"
104,2021,Sep,181673,174803,6870,3.8,"Manatee County, FL"
105,2021,Oct,182673,176167,6506,3.6,"Manatee County, FL"
106,2021,Nov,183195,177042,6153,3.4,"Manatee County, FL"
107,2021,Dec,184336,178928,5408,2.9,"Manatee County, FL"
108,2022,Jan,184398,177697,6701,3.6,"Manatee County, FL"
109,2022,Feb,184651,178826,5825,3.2,"Manatee County, FL"
110,2022,Mar,185660,180390,5270,2.8,"Manatee County, FL"
111,2022,Apr,185465,180794,4671,2.5,"Manatee County, FL"
112,2022,May,187008,182053,4955,2.6,"Manatee County, FL"
113,2022,Jun,187875,182013,5862,3.1,"Manatee County, FL"
114,2022,Jul,187241,181688,5553,3.0,"Manatee County, FL"
115,2022,Aug,187201,181564,5637,3.0,"Manatee County, FL"
116,2022,Sep,187259,182066,5193,2.8,"Manatee County, FL"
117,2022,Oct,187288,182207,5081,2.7,"Manatee County, FL"
118,2022,Nov,187555,182660,4895,2.6,"Manatee County, FL"
119,2022,Dec,187674,183383,4291,2.3,"Manatee County, FL"
120,2023,Jan,189413,184392,5021,2.7,"Manatee County, FL"
121,2023,Feb,190278,185284,4994,2.6,"Manatee County, FL"
122,2023,Mar,191971,186851,5120,2.7,"Manatee County, FL"
123,2023,Apr,191556,187059,4497,2.3,"Manatee County, FL"
124,2023,May,191902,186675,5227,2.7,"Manatee County, FL"
125,2023,Jun,193551,187660,5891,3.0,"Manatee County, FL"
126,2023,Jul,194568,188357,6211,3.2,"Manatee County, FL"
127,2023,Aug,194300,187807,6493,3.3,"Manatee County, FL"
128,2023,Sep,193313,186779,6534,3.4,"Manatee County, FL"
129,2023,Oct,193760,187242,6518,3.4,"Manatee County, FL"
0,2013,Jan,683817,613429,70388,10.3,"Sacramento County, CA"
1,2013,Feb,682266,616084,66182,9.7,"Sacramento County, CA"
2,2013,Mar,680125,616390,63735,9.4,"Sacramento County, CA"
3,2013,Apr,674252,615541,58711,8.7,"Sacramento County, CA"
4,2013,May,675852,617218,58634,8.7,"Sacramento County, CA"
5,2013,Jun,679957,616176,63781,9.4,"Sacramento County, CA"
6,2013,Jul,682007,618380,63627,9.3,"Sacramento County, CA"
7,2013,Aug,677511,616645,60866,9.0,"Sacramento County, CA"
8,2013,Sep,678170,620013,58157,8.6,"Sacramento County, CA"
9,2013,Oct,672974,614790,58184,8.6,"Sacramento County, CA"
10,2013,Nov,674956,619272,55684,8.3,"Sacramento County, CA"
11,2013,Dec,672082,618677,53405,7.9,"Sacramento County, CA"
12,2014,Jan,675510,619118,56392,8.3,"Sacramento County, CA"
13,2014,Feb,677099,621000,56099,8.3,"Sacramento County, CA"
14,2014,Mar,679417,623230,56187,8.3,"Sacramento County, CA"
15,2014,Apr,671067,622850,48217,7.2,"Sacramento County, CA"
16,2014,May,674941,626992,47949,7.1,"Sacramento County, CA"
17,2014,Jun,680087,629454,50633,7.4,"Sacramento County, CA"
18,2014,Jul,681564,628376,53188,7.8,"Sacramento County, CA"
19,2014,Aug,678258,627355,50903,7.5,"Sacramento County, CA"
20,2014,Sep,677818,631045,46773,6.9,"Sacramento County, CA"
21,2014,Oct,680608,634346,46262,6.8,"Sacramento County, CA"
22,2014,Nov,681056,635408,45648,6.7,"Sacramento County, CA"
23,2014,Dec,674921,632204,42717,6.3,"Sacramento County, CA"
24,2015,Jan,681853,635025,46828,6.9,"Sacramento County, CA"
25,2015,Feb,681872,637160,44712,6.6,"Sacramento County, CA"
26,2015,Mar,683129,639308,43821,6.4,"Sacramento County, CA"
27,2015,Apr,679856,639528,40328,5.9,"Sacramento County, CA"
28,2015,May,683151,642922,40229,5.9,"Sacramento County, CA"
29,2015,Jun,686343,643643,42700,6.2,"Sacramento County, CA"
30,2015,Jul,689380,645598,43782,6.4,"Sacramento County, CA"
31,2015,Aug,685461,644346,41115,6.0,"Sacramento County, CA"
32,2015,Sep,683620,645283,38337,5.6,"Sacramento County, CA"
33,2015,Oct,685808,647107,38701,5.6,"Sacramento County, CA"
34,2015,Nov,686913,648863,38050,5.5,"Sacramento County, CA"
35,2015,Dec,687542,650756,36786,5.4,"Sacramento County, CA"
36,2016,Jan,689931,650677,39254,5.7,"Sacramento County, CA"
37,2016,Feb,693545,654939,38606,5.6,"Sacramento County, CA"
38,2016,Mar,695432,655601,39831,5.7,"Sacramento County, CA"
39,2016,Apr,688570,652111,36459,5.3,"Sacramento County, CA"
40,2016,May,689826,656120,33706,4.9,"Sacramento County, CA"
41,2016,Jun,695449,655981,39468,5.7,"Sacramento County, CA"
42,2016,Jul,700031,659685,40346,5.8,"Sacramento County, CA"
43,2016,Aug,697592,658469,39123,5.6,"Sacramento County, CA"
44,2016,Sep,697096,659626,37470,5.4,"Sacramento County, CA"
45,2016,Oct,694641,657461,37180,5.4,"Sacramento County, CA"
46,2016,Nov,693588,658493,35095,5.1,"Sacramento County, CA"
47,2016,Dec,692048,657153,34895,5.0,"Sacramento County, CA"
48,2017,Jan,693713,655206,38507,5.6,"Sacramento County, CA"
49,2017,Feb,695449,658312,37137,5.3,"Sacramento County, CA"
50,2017,Mar,696618,661294,35324,5.1,"Sacramento County, CA"
51,2017,Apr,691567,659442,32125,4.6,"Sacramento County, CA"
52,2017,May,692685,662497,30188,4.4,"Sacramento County, CA"
53,2017,Jun,696821,662789,34032,4.9,"Sacramento County, CA"
54,2017,Jul,702295,666873,35422,5.0,"Sacramento County, CA"
55,2017,Aug,697699,663268,34431,4.9,"Sacramento County, CA"
56,2017,Sep,699590,669227,30363,4.3,"Sacramento County, CA"
57,2017,Oct,697540,668300,29240,4.2,"Sacramento County, CA"
58,2017,Nov,697179,668752,28427,4.1,"Sacramento County, CA"
59,2017,Dec,696442,668765,27677,4.0,"Sacramento County, CA"
60,2018,Jan,696949,666329,30620,4.4,"Sacramento County, CA"
61,2018,Feb,702168,672696,29472,4.2,"Sacramento County, CA"
62,2018,Mar,701903,673510,28393,4.0,"Sacramento County, CA"
63,2018,Apr,697032,671534,25498,3.7,"Sacramento County, CA"
64,2018,May,700522,677078,23444,3.3,"Sacramento County, CA"
65,2018,Jun,704485,675639,28846,4.1,"Sacramento County, CA"
66,2018,Jul,711041,682201,28840,4.1,"Sacramento County, CA"
67,2018,Aug,705738,677429,28309,4.0,"Sacramento County, CA"
68,2018,Sep,707387,681551,25836,3.7,"Sacramento County, CA"
69,2018,Oct,707739,681436,26303,3.7,"Sacramento County, CA"
70,2018,Nov,707954,682132,25822,3.6,"Sacramento County, CA"
71,2018,Dec,708008,681318,26690,3.8,"Sacramento County, CA"
72,2019,Jan,711423,679518,31905,4.5,"Sacramento County, CA"
73,2019,Feb,714318,685674,28644,4.0,"Sacramento County, CA"
74,2019,Mar,714212,685293,28919,4.0,"Sacramento County, CA"
75,2019,Apr,703569,679437,24132,3.4,"Sacramento County, CA"
76,2019,May,705768,682674,23094,3.3,"Sacramento County, CA"
77,2019,Jun,707287,679993,27294,3.9,"Sacramento County, CA"
78,2019,Jul,715789,686859,28930,4.0,"Sacramento County, CA"
79,2019,Aug,713507,686008,27499,3.9,"Sacramento County, CA"
80,2019,Sep,713679,690110,23569,3.3,"Sacramento County, CA"
81,2019,Oct,715601,690987,24614,3.4,"Sacramento County, CA"
82,2019,Nov,713725,689132,24593,3.4,"Sacramento County, CA"
83,2019,Dec,712092,688025,24067,3.4,"Sacramento County, CA"
84,2020,Jan,715296,686952,28344,4.0,"Sacramento County, CA"
85,2020,Feb,720976,694159,26817,3.7,"Sacramento County, CA"
86,2020,Mar,715624,676897,38727,5.4,"Sacramento County, CA"
87,2020,Apr,702307,595846,106461,15.2,"Sacramento County, CA"
88,2020,May,693890,592284,101606,14.6,"Sacramento County, CA"
89,2020,Jun,717264,625833,91431,12.7,"Sacramento County, CA"
90,2020,Jul,720902,633538,87364,12.1,"Sacramento County, CA"
91,2020,Aug,714082,640262,73820,10.3,"Sacramento County, CA"
92,2020,Sep,714597,643847,70750,9.9,"Sacramento County, CA"
93,2020,Oct,713278,651107,62171,8.7,"Sacramento County, CA"
94,2020,Nov,709746,649255,60491,8.5,"Sacramento County, CA"
95,2020,Dec,708319,647943,60376,8.5,"Sacramento County, CA"
96,2021,Jan,713042,652183,60859,8.5,"Sacramento County, CA"
97,2021,Feb,716927,657876,59051,8.2,"Sacramento County, CA"
98,2021,Mar,717910,661151,56759,7.9,"Sacramento County, CA"
99,2021,Apr,714323,659580,54743,7.7,"Sacramento County, CA"
100,2021,May,714643,663999,50644,7.1,"Sacramento County, CA"
101,2021,Jun,720288,663910,56378,7.8,"Sacramento County, CA"
102,2021,Jul,727972,674476,53496,7.3,"Sacramento County, CA"
103,2021,Aug,724385,674017,50368,7.0,"Sacramento County, CA"
104,2021,Sep,722325,679093,43232,6.0,"Sacramento County, CA"
105,2021,Oct,722453,680966,41487,5.7,"Sacramento County, CA"
106,2021,Nov,722233,684896,37337,5.2,"Sacramento County, CA"
107,2021,Dec,720155,686065,34090,4.7,"Sacramento County, CA"
108,2022,Jan,722133,683928,38205,5.3,"Sacramento County, CA"
109,2022,Feb,726051,692334,33717,4.6,"Sacramento County, CA"
110,2022,Mar,729457,699430,30027,4.1,"Sacramento County, CA"
111,2022,Apr,721213,695326,25887,3.6,"Sacramento County, CA"
112,2022,May,724228,700526,23702,3.3,"Sacramento County, CA"
113,2022,Jun,722542,694918,27624,3.8,"Sacramento County, CA"
114,2022,Jul,730788,703191,27597,3.8,"Sacramento County, CA"
115,2022,Aug,733202,704832,28370,3.9,"Sacramento County, CA"
116,2022,Sep,732316,706742,25574,3.5,"Sacramento County, CA"
117,2022,Oct,734382,707012,27370,3.7,"Sacramento County, CA"
118,2022,Nov,732375,704273,28102,3.8,"Sacramento County, CA"
119,2022,Dec,731032,704770,26262,3.6,"Sacramento County, CA"
120,2023,Jan,729692,697153,32539,4.5,"Sacramento County, CA"
121,2023,Feb,736498,703373,33125,4.5,"Sacramento County, CA"
122,2023,Mar,739062,705437,33625,4.5,"Sacramento County, CA"
123,2023,Apr,732132,703159,28973,4.0,"Sacramento County, CA"
124,2023,May,732126,702088,30038,4.1,"Sacramento County, CA"
125,2023,Jun,729514,696511,33003,4.5,"Sacramento County, CA"
126,2023,Jul,736458,704146,32312,4.4,"Sacramento County, CA"
127,2023,Aug,732634,698052,34582,4.7,"Sacramento County, CA"
128,2023,Sep,738207,705730,32477,4.4,"Sacramento County, CA"
129,2023,Oct,738852,705330,33522,4.5,"Sacramento County, CA"
0,2013,Jan,11199,8019,3180,28.4,"Colusa County, CA"
1,2013,Feb,11192,8278,2914,26.0,"Colusa County, CA"
2,2013,Mar,10998,8334,2664,24.2,"Colusa County, CA"
3,2013,Apr,11369,9084,2285,20.1,"Colusa County, CA"
4,2013,May,11232,9305,1927,17.2,"Colusa County, CA"
5,2013,Jun,11395,9407,1988,17.4,"Colusa County, CA"
6,2013,Jul,11647,9896,1751,15.0,"Colusa County, CA"
7,2013,Aug,11696,10088,1608,13.7,"Colusa County, CA"
8,2013,Sep,11553,10049,1504,13.0,"Colusa County, CA"
9,2013,Oct,11247,9669,1578,14.0,"Colusa County, CA"
10,2013,Nov,10928,8796,2132,19.5,"Colusa County, CA"
11,2013,Dec,10757,8430,2327,21.6,"Colusa County, CA"
12,2014,Jan,10926,8117,2809,25.7,"Colusa County, CA"
13,2014,Feb,10927,8281,2646,24.2,"Colusa County, CA"
14,2014,Mar,11071,8353,2718,24.6,"Colusa County, CA"
15,2014,Apr,10927,8749,2178,19.9,"Colusa County, CA"
16,2014,May,10880,9118,1762,16.2,"Colusa County, CA"
17,2014,Jun,10937,9187,1750,16.0,"Colusa County, CA"
18,2014,Jul,11495,9909,1586,13.8,"Colusa County, CA"
19,2014,Aug,11604,10207,1397,12.0,"Colusa County, CA"
20,2014,Sep,11339,10078,1261,11.1,"Colusa County, CA"
21,2014,Oct,11564,10306,1258,10.9,"Colusa County, CA"
22,2014,Nov,10791,8986,1805,16.7,"Colusa County, CA"
23,2014,Dec,10479,8281,2198,21.0,"Colusa County, CA"
24,2015,Jan,10738,8196,2542,23.7,"Colusa County, CA"
25,2015,Feb,10903,8390,2513,23.0,"Colusa County, CA"
26,2015,Mar,10789,8448,2341,21.7,"Colusa County, CA"
27,2015,Apr,10756,8989,1767,16.4,"Colusa County, CA"
28,2015,May,11116,9622,1494,13.4,"Colusa County, CA"
29,2015,Jun,11184,9719,1465,13.1,"Colusa County, CA"
30,2015,Jul,11525,10206,1319,11.4,"Colusa County, CA"
31,2015,Aug,11629,10493,1136,9.8,"Colusa County, CA"
32,2015,Sep,11489,10448,1041,9.1,"Colusa County, CA"
33,2015,Oct,11196,9998,1198,10.7,"Colusa County, CA"
34,2015,Nov,10598,8924,1674,15.8,"Colusa County, CA"
35,2015,Dec,10687,8665,2022,18.9,"Colusa County, CA"
36,2016,Jan,10791,8285,2506,23.2,"Colusa County, CA"
37,2016,Feb,10958,8517,2441,22.3,"Colusa County, CA"
38,2016,Mar,11067,8696,2371,21.4,"Colusa County, CA"
39,2016,Apr,10944,9143,1801,16.5,"Colusa County, CA"
40,2016,May,11052,9681,1371,12.4,"Colusa County, CA"
41,2016,Jun,11163,9720,1443,12.9,"Colusa County, CA"
42,2016,Jul,11059,9710,1349,12.2,"Colusa County, CA"
43,2016,Aug,10990,9857,1133,10.3,"Colusa County, CA"
44,2016,Sep,10895,9837,1058,9.7,"Colusa County, CA"
45,2016,Oct,10816,9622,1194,11.0,"Colusa County, CA"
46,2016,Nov,10608,8935,1673,15.8,"Colusa County, CA"
47,2016,Dec,10553,8458,2095,19.9,"Colusa County, CA"
48,2017,Jan,10530,8194,2336,22.2,"Colusa County, CA"
49,2017,Feb,10668,8191,2477,23.2,"Colusa County, CA"
50,2017,Mar,10792,8493,2299,21.3,"Colusa County, CA"
51,2017,Apr,10441,8658,1783,17.1,"Colusa County, CA"
52,2017,May,10655,9316,1339,12.6,"Colusa County, CA"
53,2017,Jun,10718,9414,1304,12.2,"Colusa County, CA"
54,2017,Jul,10852,9595,1257,11.6,"Colusa County, CA"
55,2017,Aug,11080,10040,1040,9.4,"Colusa County, CA"
56,2017,Sep,11046,10148,898,8.1,"Colusa County, CA"
57,2017,Oct,11352,10436,916,8.1,"Colusa County, CA"
58,2017,Nov,10828,9552,1276,11.8,"Colusa County, CA"
59,2017,Dec,10831,9172,1659,15.3,"Colusa County, CA"
60,2018,Jan,10590,8632,1958,18.5,"Colusa County, CA"
61,2018,Feb,11115,8968,2147,19.3,"Colusa County, CA"
62,2018,Mar,11167,9064,2103,18.8,"Colusa County, CA"
63,2018,Apr,10931,9282,1649,15.1,"Colusa County, CA"
64,2018,May,11152,9924,1228,11.0,"Colusa County, CA"
65,2018,Jun,11016,9768,1248,11.3,"Colusa County, CA"
66,2018,Jul,10941,9769,1172,10.7,"Colusa County, CA"
67,2018,Aug,10854,9923,931,8.6,"Colusa County, CA"
68,2018,Sep,10832,10020,812,7.5,"Colusa County, CA"
69,2018,Oct,10531,9619,912,8.7,"Colusa County, CA"
70,2018,Nov,10605,9289,1316,12.4,"Colusa County, CA"
71,2018,Dec,10402,8685,1717,16.5,"Colusa County, CA"
72,2019,Jan,10680,8535,2145,20.1,"Colusa County, CA"
73,2019,Feb,11044,8805,2239,20.3,"Colusa County, CA"
74,2019,Mar,10995,8797,2198,20.0,"Colusa County, CA"
75,2019,Apr,11152,9461,1691,15.2,"Colusa County, CA"
76,2019,May,11182,10019,1163,10.4,"Colusa County, CA"
77,2019,Jun,10906,9733,1173,10.8,"Colusa County, CA"
78,2019,Jul,10911,9799,1112,10.2,"Colusa County, CA"
79,2019,Aug,11435,10513,922,8.1,"Colusa County, CA"
80,2019,Sep,11005,10236,769,7.0,"Colusa County, CA"
81,2019,Oct,11161,10307,854,7.7,"Colusa County, CA"
82,2019,Nov,10763,9596,1167,10.8,"Colusa County, CA"
83,2019,Dec,10637,9080,1557,14.6,"Colusa County, CA"
84,2020,Jan,10663,8543,2120,19.9,"Colusa County, CA"
85,2020,Feb,10938,8735,2203,20.1,"Colusa County, CA"
86,2020,Mar,11821,8797,3024,25.6,"Colusa County, CA"
87,2020,Apr,11118,8254,2864,25.8,"Colusa County, CA"
88,2020,May,10233,8228,2005,19.6,"Colusa County, CA"
89,2020,Jun,10279,8644,1635,15.9,"Colusa County, CA"
90,2020,Jul,10635,9219,1416,13.3,"Colusa County, CA"
91,2020,Aug,10700,9624,1076,10.1,"Colusa County, CA"
92,2020,Sep,10585,9558,1027,9.7,"Colusa County, CA"
93,2020,Oct,10561,9609,952,9.0,"Colusa County, CA"
94,2020,Nov,10054,8849,1205,12.0,"Colusa County, CA"
95,2020,Dec,10139,8663,1476,14.6,"Colusa County, CA"
96,2021,Jan,10276,8523,1753,17.1,"Colusa County, CA"
97,2021,Feb,10671,8763,1908,17.9,"Colusa County, CA"
98,2021,Mar,10781,8972,1809,16.8,"Colusa County, CA"
99,2021,Apr,10744,9227,1517,14.1,"Colusa County, CA"
100,2021,May,10724,9412,1312,12.2,"Colusa County, CA"
101,2021,Jun,10844,9455,1389,12.8,"Colusa County, CA"
102,2021,Jul,10939,9768,1171,10.7,"Colusa County, CA"
103,2021,Aug,10828,9815,1013,9.4,"Colusa County, CA"
104,2021,Sep,10802,9934,868,8.0,"Colusa County, CA"
105,2021,Oct,10717,9840,877,8.2,"Colusa County, CA"
106,2021,Nov,10371,9223,1148,11.1,"Colusa County, CA"
107,2021,Dec,10330,9040,1290,12.5,"Colusa County, CA"
108,2022,Jan,10209,8488,1721,16.9,"Colusa County, CA"
109,2022,Feb,10470,8736,1734,16.6,"Colusa County, CA"
110,2022,Mar,10417,8857,1560,15.0,"Colusa County, CA"
111,2022,Apr,9945,8702,1243,12.5,"Colusa County, CA"
112,2022,May,10081,9018,1063,10.5,"Colusa County, CA"
113,2022,Jun,10254,9223,1031,10.1,"Colusa County, CA"
114,2022,Jul,10301,9368,933,9.1,"Colusa County, CA"
115,2022,Aug,10529,9702,827,7.9,"Colusa County, CA"
116,2022,Sep,10130,9395,735,7.3,"Colusa County, CA"
117,2022,Oct,10253,9428,825,8.0,"Colusa County, CA"
118,2022,Nov,10010,8875,1135,11.3,"Colusa County, CA"
119,2022,Dec,10045,8625,1420,14.1,"Colusa County, CA"
120,2023,Jan,10109,8323,1786,17.7,"Colusa County, CA"
121,2023,Feb,10491,8525,1966,18.7,"Colusa County, CA"
122,2023,Mar,10729,8668,2061,19.2,"Colusa County, CA"
123,2023,Apr,10241,8713,1528,14.9,"Colusa County, CA"
124,2023,May,10289,8903,1386,13.5,"Colusa County, CA"
125,2023,Jun,10225,8985,1240,12.1,"Colusa County, CA"
126,2023,Jul,10341,9239,1102,10.7,"Colusa County, CA"
127,2023,Aug,10555,9565,990,9.4,"Colusa County, CA"
128,2023,Sep,10419,9577,842,8.1,"Colusa County, CA"
129,2023,Oct,10465,9546,919,8.8,"Colusa County, CA"
0,2013,Jan,510549,477591,32958,6.5,"San Francisco County/city, CA"
1,2013,Feb,512357,481626,30731,6.0,"San Francisco County/city, CA"
2,2013,Mar,511833,482274,29559,5.8,"San Francisco County/city, CA"
3,2013,Apr,509810,482783,27027,5.3,"San Francisco County/city, CA"
4,2013,May,512195,484650,27545,5.4,"San Francisco County/city, CA"
5,2013,Jun,512917,482649,30268,5.9,"San Francisco County/city, CA"
6,2013,Jul,518325,488312,30013,5.8,"San Francisco County/city, CA"
7,2013,Aug,516159,487523,28636,5.5,"San Francisco County/city, CA"
8,2013,Sep,517556,490154,27402,5.3,"San Francisco County/city, CA"
9,2013,Oct,513671,486514,27157,5.3,"San Francisco County/city, CA"
10,2013,Nov,517494,491704,25790,5.0,"San Francisco County/city, CA"
11,2013,Dec,517907,493830,24077,4.6,"San Francisco County/city, CA"
12,2014,Jan,518071,492129,25942,5.0,"San Francisco County/city, CA"
13,2014,Feb,522404,496550,25854,4.9,"San Francisco County/city, CA"
14,2014,Mar,524393,498433,25960,5.0,"San Francisco County/city, CA"
15,2014,Apr,519374,497496,21878,4.2,"San Francisco County/city, CA"
16,2014,May,522794,500518,22276,4.3,"San Francisco County/city, CA"
17,2014,Jun,523620,499947,23673,4.5,"San Francisco County/city, CA"
18,2014,Jul,531740,506641,25099,4.7,"San Francisco County/city, CA"
19,2014,Aug,530616,506186,24430,4.6,"San Francisco County/city, CA"
20,2014,Sep,531964,509790,22174,4.2,"San Francisco County/city, CA"
21,2014,Oct,534502,512750,21752,4.1,"San Francisco County/city, CA"
22,2014,Nov,534223,512774,21449,4.0,"San Francisco County/city, CA"
23,2014,Dec,534137,514596,19541,3.7,"San Francisco County/city, CA"
24,2015,Jan,534183,511930,22253,4.2,"San Francisco County/city, CA"
25,2015,Feb,536808,515729,21079,3.9,"San Francisco County/city, CA"
26,2015,Mar,538150,517232,20918,3.9,"San Francisco County/city, CA"
27,2015,Apr,535371,516127,19244,3.6,"San Francisco County/city, CA"
28,2015,May,538778,519484,19294,3.6,"San Francisco County/city, CA"
29,2015,Jun,538699,518104,20595,3.8,"San Francisco County/city, CA"
30,2015,Jul,545936,524607,21329,3.9,"San Francisco County/city, CA"
31,2015,Aug,545501,525503,19998,3.7,"San Francisco County/city, CA"
32,2015,Sep,544901,526457,18444,3.4,"San Francisco County/city, CA"
33,2015,Oct,545593,526715,18878,3.5,"San Francisco County/city, CA"
34,2015,Nov,545843,527467,18376,3.4,"San Francisco County/city, CA"
35,2015,Dec,547198,529472,17726,3.2,"San Francisco County/city, CA"
36,2016,Jan,549524,530597,18927,3.4,"San Francisco County/city, CA"
37,2016,Feb,553676,534994,18682,3.4,"San Francisco County/city, CA"
38,2016,Mar,555990,536775,19215,3.5,"San Francisco County/city, CA"
39,2016,Apr,550214,532533,17681,3.2,"San Francisco County/city, CA"
40,2016,May,550838,534557,16281,3.0,"San Francisco County/city, CA"
41,2016,Jun,552853,533776,19077,3.5,"San Francisco County/city, CA"
42,2016,Jul,560158,540423,19735,3.5,"San Francisco County/city, CA"
43,2016,Aug,558772,539527,19245,3.4,"San Francisco County/city, CA"
44,2016,Sep,559482,541070,18412,3.3,"San Francisco County/city, CA"
45,2016,Oct,558053,539465,18588,3.3,"San Francisco County/city, CA"
46,2016,Nov,557782,540319,17463,3.1,"San Francisco County/city, CA"
47,2016,Dec,556455,539628,16827,3.0,"San Francisco County/city, CA"
48,2017,Jan,560399,541264,19135,3.4,"San Francisco County/city, CA"
49,2017,Feb,563969,546064,17905,3.2,"San Francisco County/city, CA"
50,2017,Mar,564007,546809,17198,3.0,"San Francisco County/city, CA"
51,2017,Apr,558702,542892,15810,2.8,"San Francisco County/city, CA"
52,2017,May,558853,543317,15536,2.8,"San Francisco County/city, CA"
53,2017,Jun,560185,542506,17679,3.2,"San Francisco County/city, CA"
54,2017,Jul,568171,549732,18439,3.2,"San Francisco County/city, CA"
55,2017,Aug,564857,546623,18234,3.2,"San Francisco County/city, CA"
56,2017,Sep,566887,551275,15612,2.8,"San Francisco County/city, CA"
57,2017,Oct,563462,548229,15233,2.7,"San Francisco County/city, CA"
58,2017,Nov,564171,549720,14451,2.6,"San Francisco County/city, CA"
59,2017,Dec,562888,548848,14040,2.5,"San Francisco County/city, CA"
60,2018,Jan,558692,543198,15494,2.8,"San Francisco County/city, CA"
61,2018,Feb,564968,550311,14657,2.6,"San Francisco County/city, CA"
62,2018,Mar,566363,552307,14056,2.5,"San Francisco County/city, CA"
63,2018,Apr,561790,549279,12511,2.2,"San Francisco County/city, CA"
64,2018,May,564146,552316,11830,2.1,"San Francisco County/city, CA"
65,2018,Jun,566345,551711,14634,2.6,"San Francisco County/city, CA"
66,2018,Jul,574235,559971,14264,2.5,"San Francisco County/city, CA"
67,2018,Aug,570689,556478,14211,2.5,"San Francisco County/city, CA"
68,2018,Sep,572483,559477,13006,2.3,"San Francisco County/city, CA"
69,2018,Oct,574375,561098,13277,2.3,"San Francisco County/city, CA"
70,2018,Nov,575324,562453,12871,2.2,"San Francisco County/city, CA"
71,2018,Dec,575289,562427,12862,2.2,"San Francisco County/city, CA"
72,2019,Jan,574315,558928,15387,2.7,"San Francisco County/city, CA"
73,2019,Feb,580193,566436,13757,2.4,"San Francisco County/city, CA"
74,2019,Mar,580331,566290,14041,2.4,"San Francisco County/city, CA"
75,2019,Apr,574265,562674,11591,2.0,"San Francisco County/city, CA"
76,2019,May,574982,563844,11138,1.9,"San Francisco County/city, CA"
77,2019,Jun,576278,562807,13471,2.3,"San Francisco County/city, CA"
78,2019,Jul,586296,572231,14065,2.4,"San Francisco County/city, CA"
79,2019,Aug,584257,570728,13529,2.3,"San Francisco County/city, CA"
80,2019,Sep,585446,574047,11399,1.9,"San Francisco County/city, CA"
81,2019,Oct,585312,573111,12201,2.1,"San Francisco County/city, CA"
82,2019,Nov,584158,572038,12120,2.1,"San Francisco County/city, CA"
83,2019,Dec,585141,573459,11682,2.0,"San Francisco County/city, CA"
84,2020,Jan,585118,571494,13624,2.3,"San Francisco County/city, CA"
85,2020,Feb,590867,577746,13121,2.2,"San Francisco County/city, CA"
86,2020,Mar,580619,560489,20130,3.5,"San Francisco County/city, CA"
87,2020,Apr,556981,483506,73475,13.2,"San Francisco County/city, CA"
88,2020,May,548650,477346,71304,13.0,"San Francisco County/city, CA"
89,2020,Jun,562087,495425,66662,11.9,"San Francisco County/city, CA"
90,2020,Jul,562162,500383,61779,11.0,"San Francisco County/city, CA"
91,2020,Aug,555379,504585,50794,9.1,"San Francisco County/city, CA"
92,2020,Sep,552508,503910,48598,8.8,"San Francisco County/city, CA"
93,2020,Oct,546565,505668,40897,7.5,"San Francisco County/city, CA"
94,2020,Nov,540419,502956,37463,6.9,"San Francisco County/city, CA"
95,2020,Dec,539802,504062,35740,6.6,"San Francisco County/city, CA"
96,2021,Jan,535622,500657,34965,6.5,"San Francisco County/city, CA"
97,2021,Feb,538899,505750,33149,6.2,"San Francisco County/city, CA"
98,2021,Mar,540195,508351,31844,5.9,"San Francisco County/city, CA"
99,2021,Apr,536815,505049,31766,5.9,"San Francisco County/city, CA"
100,2021,May,539707,510458,29249,5.4,"San Francisco County/city, CA"
101,2021,Jun,545013,512918,32095,5.9,"San Francisco County/city, CA"
102,2021,Jul,554211,524322,29889,5.4,"San Francisco County/city, CA"
103,2021,Aug,554039,526013,28026,5.1,"San Francisco County/city, CA"
104,2021,Sep,555942,532606,23336,4.2,"San Francisco County/city, CA"
105,2021,Oct,559011,536859,22152,4.0,"San Francisco County/city, CA"
106,2021,Nov,560660,540884,19776,3.5,"San Francisco County/city, CA"
107,2021,Dec,563263,545585,17678,3.1,"San Francisco County/city, CA"
108,2022,Jan,563787,543846,19941,3.5,"San Francisco County/city, CA"
109,2022,Feb,567326,549732,17594,3.1,"San Francisco County/city, CA"
110,2022,Mar,570261,554623,15638,2.7,"San Francisco County/city, CA"
111,2022,Apr,564833,551536,13297,2.4,"San Francisco County/city, CA"
112,2022,May,569225,557058,12167,2.1,"San Francisco County/city, CA"
113,2022,Jun,572593,558316,14277,2.5,"San Francisco County/city, CA"
114,2022,Jul,576970,562863,14107,2.4,"San Francisco County/city, CA"
115,2022,Aug,575857,561137,14720,2.6,"San Francisco County/city, CA"
116,2022,Sep,576715,563734,12981,2.3,"San Francisco County/city, CA"
117,2022,Oct,578192,564501,13691,2.4,"San Francisco County/city, CA"
118,2022,Nov,576267,562407,13860,2.4,"San Francisco County/city, CA"
119,2022,Dec,578965,566040,12925,2.2,"San Francisco County/city, CA"
120,2023,Jan,576820,560605,16215,2.8,"San Francisco County/city, CA"
121,2023,Feb,579642,562555,17087,2.9,"San Francisco County/city, CA"
122,2023,Mar,581860,564449,17411,3.0,"San Francisco County/city, CA"
123,2023,Apr,575444,559708,15736,2.7,"San Francisco County/city, CA"
124,2023,May,576602,559368,17234,3.0,"San Francisco County/city, CA"
125,2023,Jun,576684,557875,18809,3.3,"San Francisco County/city, CA"
126,2023,Jul,583483,564334,19149,3.3,"San Francisco County/city, CA"
127,2023,Aug,577812,556999,20813,3.6,"San Francisco County/city, CA"
128,2023,Sep,577051,557651,19400,3.4,"San Francisco County/city, CA"
129,2023,Oct,576664,556995,19669,3.4,"San Francisco County/city, CA"
0,2013,Jan,14306,12532,1774,12.4,"Amador County, CA"
1,2013,Feb,14349,12663,1686,11.7,"Amador County, CA"
2,2013,Mar,14341,12734,1607,11.2,"Amador County, CA"
3,2013,Apr,14298,12800,1498,10.5,"Amador County, CA"
4,2013,May,14518,13062,1456,10.0,"Amador County, CA"
5,2013,Jun,14662,13113,1549,10.6,"Amador County, CA"
6,2013,Jul,14742,13228,1514,10.3,"Amador County, CA"
7,2013,Aug,14557,13132,1425,9.8,"Amador County, CA"
8,2013,Sep,14568,13173,1395,9.6,"Amador County, CA"
9,2013,Oct,14290,12879,1411,9.9,"Amador County, CA"
10,2013,Nov,14142,12759,1383,9.8,"Amador County, CA"
11,2013,Dec,14026,12694,1332,9.5,"Amador County, CA"
12,2014,Jan,14166,12749,1417,10.0,"Amador County, CA"
13,2014,Feb,14291,12864,1427,10.0,"Amador County, CA"
14,2014,Mar,14388,12966,1422,9.9,"Amador County, CA"
15,2014,Apr,14050,12852,1198,8.5,"Amador County, CA"
16,2014,May,14310,13146,1164,8.1,"Amador County, CA"
17,2014,Jun,14395,13199,1196,8.3,"Amador County, CA"
18,2014,Jul,14537,13312,1225,8.4,"Amador County, CA"
19,2014,Aug,14507,13345,1162,8.0,"Amador County, CA"
20,2014,Sep,14557,13477,1080,7.4,"Amador County, CA"
21,2014,Oct,14394,13352,1042,7.2,"Amador County, CA"
22,2014,Nov,14220,13153,1067,7.5,"Amador County, CA"
23,2014,Dec,14038,12997,1041,7.4,"Amador County, CA"
24,2015,Jan,14225,13083,1142,8.0,"Amador County, CA"
25,2015,Feb,14246,13167,1079,7.6,"Amador County, CA"
26,2015,Mar,14307,13242,1065,7.4,"Amador County, CA"
27,2015,Apr,14323,13353,970,6.8,"Amador County, CA"
28,2015,May,14464,13534,930,6.4,"Amador County, CA"
29,2015,Jun,14511,13559,952,6.6,"Amador County, CA"
30,2015,Jul,14536,13572,964,6.6,"Amador County, CA"
31,2015,Aug,14453,13562,891,6.2,"Amador County, CA"
32,2015,Sep,14352,13533,819,5.7,"Amador County, CA"
33,2015,Oct,14254,13397,857,6.0,"Amador County, CA"
34,2015,Nov,14129,13250,879,6.2,"Amador County, CA"
35,2015,Dec,13999,13136,863,6.2,"Amador County, CA"
36,2016,Jan,14071,13106,965,6.9,"Amador County, CA"
37,2016,Feb,14307,13356,951,6.6,"Amador County, CA"
38,2016,Mar,14443,13463,980,6.8,"Amador County, CA"
39,2016,Apr,14398,13531,867,6.0,"Amador County, CA"
40,2016,May,14500,13718,782,5.4,"Amador County, CA"
41,2016,Jun,14749,13896,853,5.8,"Amador County, CA"
42,2016,Jul,14734,13846,888,6.0,"Amador County, CA"
43,2016,Aug,14701,13863,838,5.7,"Amador County, CA"
44,2016,Sep,14862,14053,809,5.4,"Amador County, CA"
45,2016,Oct,14677,13869,808,5.5,"Amador County, CA"
46,2016,Nov,14466,13657,809,5.6,"Amador County, CA"
47,2016,Dec,14385,13534,851,5.9,"Amador County, CA"
48,2017,Jan,14440,13511,929,6.4,"Amador County, CA"
49,2017,Feb,14543,13644,899,6.2,"Amador County, CA"
50,2017,Mar,14665,13835,830,5.7,"Amador County, CA"
51,2017,Apr,14610,13868,742,5.1,"Amador County, CA"
52,2017,May,14733,14060,673,4.6,"Amador County, CA"
53,2017,Jun,14898,14165,733,4.9,"Amador County, CA"
54,2017,Jul,14901,14141,760,5.1,"Amador County, CA"
55,2017,Aug,14838,14105,733,4.9,"Amador County, CA"
56,2017,Sep,14954,14314,640,4.3,"Amador County, CA"
57,2017,Oct,14734,14102,632,4.3,"Amador County, CA"
58,2017,Nov,14602,13974,628,4.3,"Amador County, CA"
59,2017,Dec,14408,13778,630,4.4,"Amador County, CA"
60,2018,Jan,14539,13826,713,4.9,"Amador County, CA"
61,2018,Feb,14636,13934,702,4.8,"Amador County, CA"
62,2018,Mar,14599,13916,683,4.7,"Amador County, CA"
63,2018,Apr,14515,13913,602,4.1,"Amador County, CA"
64,2018,May,14743,14219,524,3.6,"Amador County, CA"
65,2018,Jun,14750,14140,610,4.1,"Amador County, CA"
66,2018,Jul,14790,14198,592,4.0,"Amador County, CA"
67,2018,Aug,14686,14106,580,3.9,"Amador County, CA"
68,2018,Sep,14750,14219,531,3.6,"Amador County, CA"
69,2018,Oct,14864,14306,558,3.8,"Amador County, CA"
70,2018,Nov,14647,14103,544,3.7,"Amador County, CA"
71,2018,Dec,14553,13965,588,4.0,"Amador County, CA"
72,2019,Jan,14569,13828,741,5.1,"Amador County, CA"
73,2019,Feb,14686,13998,688,4.7,"Amador County, CA"
74,2019,Mar,14761,14080,681,4.6,"Amador County, CA"
75,2019,Apr,14761,14209,552,3.7,"Amador County, CA"
76,2019,May,14886,14392,494,3.3,"Amador County, CA"
77,2019,Jun,14933,14372,561,3.8,"Amador County, CA"
78,2019,Jul,14940,14349,591,4.0,"Amador County, CA"
79,2019,Aug,15034,14476,558,3.7,"Amador County, CA"
80,2019,Sep,14995,14519,476,3.2,"Amador County, CA"
81,2019,Oct,15011,14497,514,3.4,"Amador County, CA"
82,2019,Nov,14758,14224,534,3.6,"Amador County, CA"
83,2019,Dec,14669,14103,566,3.9,"Amador County, CA"
84,2020,Jan,14809,14096,713,4.8,"Amador County, CA"
85,2020,Feb,14955,14302,653,4.4,"Amador County, CA"
86,2020,Mar,14939,14027,912,6.1,"Amador County, CA"
87,2020,Apr,14335,12120,2215,15.5,"Amador County, CA"
88,2020,May,14007,11808,2199,15.7,"Amador County, CA"
89,2020,Jun,14661,12896,1765,12.0,"Amador County, CA"
90,2020,Jul,14549,12849,1700,11.7,"Amador County, CA"
91,2020,Aug,14519,13150,1369,9.4,"Amador County, CA"
92,2020,Sep,14463,13178,1285,8.9,"Amador County, CA"
93,2020,Oct,14416,13258,1158,8.0,"Amador County, CA"
94,2020,Nov,14184,13024,1160,8.2,"Amador County, CA"
95,2020,Dec,14187,12998,1189,8.4,"Amador County, CA"
96,2021,Jan,14176,12911,1265,8.9,"Amador County, CA"
97,2021,Feb,14337,13105,1232,8.6,"Amador County, CA"
98,2021,Mar,14454,13268,1186,8.2,"Amador County, CA"
99,2021,Apr,14257,13158,1099,7.7,"Amador County, CA"
100,2021,May,14332,13352,980,6.8,"Amador County, CA"
101,2021,Jun,14535,13449,1086,7.5,"Amador County, CA"
102,2021,Jul,14537,13509,1028,7.1,"Amador County, CA"
103,2021,Aug,14574,13577,997,6.8,"Amador County, CA"
104,2021,Sep,14515,13661,854,5.9,"Amador County, CA"
105,2021,Oct,14494,13653,841,5.8,"Amador County, CA"
106,2021,Nov,14362,13575,787,5.5,"Amador County, CA"
107,2021,Dec,14208,13480,728,5.1,"Amador County, CA"
108,2022,Jan,14367,13515,852,5.9,"Amador County, CA"
109,2022,Feb,14477,13715,762,5.3,"Amador County, CA"
110,2022,Mar,14515,13818,697,4.8,"Amador County, CA"
111,2022,Apr,14210,13627,583,4.1,"Amador County, CA"
112,2022,May,14348,13835,513,3.6,"Amador County, CA"
113,2022,Jun,14414,13826,588,4.1,"Amador County, CA"
114,2022,Jul,14245,13662,583,4.1,"Amador County, CA"
115,2022,Aug,14373,13775,598,4.2,"Amador County, CA"
116,2022,Sep,14413,13848,565,3.9,"Amador County, CA"
117,2022,Oct,14375,13765,610,4.2,"Amador County, CA"
118,2022,Nov,14278,13635,643,4.5,"Amador County, CA"
119,2022,Dec,14190,13572,618,4.4,"Amador County, CA"
120,2023,Jan,14226,13426,800,5.6,"Amador County, CA"
121,2023,Feb,14450,13648,802,5.6,"Amador County, CA"
122,2023,Mar,14579,13735,844,5.8,"Amador County, CA"
123,2023,Apr,14230,13536,694,4.9,"Amador County, CA"
124,2023,May,14304,13616,688,4.8,"Amador County, CA"
125,2023,Jun,14466,13768,698,4.8,"Amador County, CA"
126,2023,Jul,14438,13749,689,4.8,"Amador County, CA"
127,2023,Aug,14574,13834,740,5.1,"Amador County, CA"
128,2023,Sep,14693,13997,696,4.7,"Amador County, CA"
129,2023,Oct,14597,13882,715,4.9,"Amador County, CA"
0,2013,Jan,1540302,1403261,137041,8.9,"San Diego County, CA"
1,2013,Feb,1538182,1408705,129477,8.4,"San Diego County, CA"
2,2013,Mar,1536919,1411477,125442,8.2,"San Diego County, CA"
3,2013,Apr,1527982,1411663,116319,7.6,"San Diego County, CA"
4,2013,May,1531882,1414598,117284,7.7,"San Diego County, CA"
5,2013,Jun,1541598,1412898,128700,8.3,"San Diego County, CA"
6,2013,Jul,1550093,1420128,129965,8.4,"San Diego County, CA"
7,2013,Aug,1538628,1414394,124234,8.1,"San Diego County, CA"
8,2013,Sep,1539293,1420874,118419,7.7,"San Diego County, CA"
9,2013,Oct,1534500,1415525,118975,7.8,"San Diego County, CA"
10,2013,Nov,1538592,1426121,112471,7.3,"San Diego County, CA"
11,2013,Dec,1533755,1427851,105904,6.9,"San Diego County, CA"
12,2014,Jan,1525634,1414415,111219,7.3,"San Diego County, CA"
13,2014,Feb,1534585,1423559,111026,7.2,"San Diego County, CA"
14,2014,Mar,1539898,1429077,110821,7.2,"San Diego County, CA"
15,2014,Apr,1519158,1424092,95066,6.3,"San Diego County, CA"
16,2014,May,1526984,1430965,96019,6.3,"San Diego County, CA"
17,2014,Jun,1536896,1434680,102216,6.7,"San Diego County, CA"
18,2014,Jul,1547633,1439244,108389,7.0,"San Diego County, CA"
19,2014,Aug,1541939,1438235,103704,6.7,"San Diego County, CA"
20,2014,Sep,1539141,1443983,95158,6.2,"San Diego County, CA"
21,2014,Oct,1546513,1453133,93380,6.0,"San Diego County, CA"
22,2014,Nov,1550031,1458896,91135,5.9,"San Diego County, CA"
23,2014,Dec,1541731,1458496,83235,5.4,"San Diego County, CA"
24,2015,Jan,1540969,1449788,91181,5.9,"San Diego County, CA"
25,2015,Feb,1543648,1457339,86309,5.6,"San Diego County, CA"
26,2015,Mar,1544231,1459180,85051,5.5,"San Diego County, CA"
27,2015,Apr,1536351,1457888,78463,5.1,"San Diego County, CA"
28,2015,May,1547695,1469012,78683,5.1,"San Diego County, CA"
29,2015,Jun,1548047,1464595,83452,5.4,"San Diego County, CA"
30,2015,Jul,1559459,1472550,86909,5.6,"San Diego County, CA"
31,2015,Aug,1551555,1469643,81912,5.3,"San Diego County, CA"
32,2015,Sep,1547616,1471709,75907,4.9,"San Diego County, CA"
33,2015,Oct,1553449,1475899,77550,5.0,"San Diego County, CA"
34,2015,Nov,1557544,1482102,75442,4.8,"San Diego County, CA"
35,2015,Dec,1554969,1482532,72437,4.7,"San Diego County, CA"
36,2016,Jan,1550997,1474720,76277,4.9,"San Diego County, CA"
37,2016,Feb,1561366,1485527,75839,4.9,"San Diego County, CA"
38,2016,Mar,1564757,1487104,77653,5.0,"San Diego County, CA"
39,2016,Apr,1551429,1479350,72079,4.6,"San Diego County, CA"
40,2016,May,1554921,1488274,66647,4.3,"San Diego County, CA"
41,2016,Jun,1560614,1482432,78182,5.0,"San Diego County, CA"
42,2016,Jul,1572293,1491834,80459,5.1,"San Diego County, CA"
43,2016,Aug,1567266,1489178,78088,5.0,"San Diego County, CA"
44,2016,Sep,1570501,1496225,74276,4.7,"San Diego County, CA"
45,2016,Oct,1569563,1495562,74001,4.7,"San Diego County, CA"
46,2016,Nov,1570232,1501163,69069,4.4,"San Diego County, CA"
47,2016,Dec,1565016,1498345,66671,4.3,"San Diego County, CA"
48,2017,Jan,1568413,1494360,74053,4.7,"San Diego County, CA"
49,2017,Feb,1573816,1504083,69733,4.4,"San Diego County, CA"
50,2017,Mar,1571027,1504253,66774,4.3,"San Diego County, CA"
51,2017,Apr,1560732,1500070,60662,3.9,"San Diego County, CA"
52,2017,May,1561624,1503028,58596,3.8,"San Diego County, CA"
53,2017,Jun,1568848,1501537,67311,4.3,"San Diego County, CA"
54,2017,Jul,1579651,1509210,70441,4.5,"San Diego County, CA"
55,2017,Aug,1570447,1502147,68300,4.3,"San Diego County, CA"
56,2017,Sep,1577407,1517414,59993,3.8,"San Diego County, CA"
57,2017,Oct,1573005,1515107,57898,3.7,"San Diego County, CA"
58,2017,Nov,1575494,1519329,56165,3.6,"San Diego County, CA"
59,2017,Dec,1569035,1515624,53411,3.4,"San Diego County, CA"
60,2018,Jan,1569653,1511161,58492,3.7,"San Diego County, CA"
61,2018,Feb,1582783,1526815,55968,3.5,"San Diego County, CA"
62,2018,Mar,1582497,1529344,53153,3.4,"San Diego County, CA"
63,2018,Apr,1569291,1520871,48420,3.1,"San Diego County, CA"
64,2018,May,1573055,1527829,45226,2.9,"San Diego County, CA"
65,2018,Jun,1578054,1521461,56593,3.6,"San Diego County, CA"
66,2018,Jul,1589959,1533204,56755,3.6,"San Diego County, CA"
67,2018,Aug,1575346,1519612,55734,3.5,"San Diego County, CA"
68,2018,Sep,1579866,1528678,51188,3.2,"San Diego County, CA"
69,2018,Oct,1584364,1531779,52585,3.3,"San Diego County, CA"
70,2018,Nov,1587408,1535717,51691,3.3,"San Diego County, CA"
71,2018,Dec,1585165,1532991,52174,3.3,"San Diego County, CA"
72,2019,Jan,1587255,1525352,61903,3.9,"San Diego County, CA"
73,2019,Feb,1593198,1538703,54495,3.4,"San Diego County, CA"
74,2019,Mar,1589882,1534988,54894,3.5,"San Diego County, CA"
75,2019,Apr,1569163,1523527,45636,2.9,"San Diego County, CA"
76,2019,May,1571452,1527190,44262,2.8,"San Diego County, CA"
77,2019,Jun,1573723,1520484,53239,3.4,"San Diego County, CA"
78,2019,Jul,1589530,1532817,56713,3.6,"San Diego County, CA"
79,2019,Aug,1580040,1525891,54149,3.4,"San Diego County, CA"
80,2019,Sep,1582828,1536107,46721,3.0,"San Diego County, CA"
81,2019,Oct,1589022,1540212,48810,3.1,"San Diego County, CA"
82,2019,Nov,1589905,1541085,48820,3.1,"San Diego County, CA"
83,2019,Dec,1586940,1540170,46770,2.9,"San Diego County, CA"
84,2020,Jan,1586771,1532798,53973,3.4,"San Diego County, CA"
85,2020,Feb,1601943,1551026,50917,3.2,"San Diego County, CA"
86,2020,Mar,1578792,1504402,74390,4.7,"San Diego County, CA"
87,2020,Apr,1528084,1281634,246450,16.1,"San Diego County, CA"
88,2020,May,1504269,1265465,238804,15.9,"San Diego County, CA"
89,2020,Jun,1555514,1348285,207229,13.3,"San Diego County, CA"
90,2020,Jul,1554874,1362134,192740,12.4,"San Diego County, CA"
91,2020,Aug,1536696,1377887,158809,10.3,"San Diego County, CA"
92,2020,Sep,1535295,1389378,145917,9.5,"San Diego County, CA"
93,2020,Oct,1537297,1409410,127887,8.3,"San Diego County, CA"
94,2020,Nov,1528060,1405758,122302,8.0,"San Diego County, CA"
95,2020,Dec,1520298,1394898,125400,8.2,"San Diego County, CA"
96,2021,Jan,1515252,1387398,127854,8.4,"San Diego County, CA"
97,2021,Feb,1533162,1413361,119801,7.8,"San Diego County, CA"
98,2021,Mar,1534990,1420987,114003,7.4,"San Diego County, CA"
99,2021,Apr,1527860,1417144,110716,7.2,"San Diego County, CA"
100,2021,May,1533462,1431507,101955,6.6,"San Diego County, CA"
101,2021,Jun,1543689,1430445,113244,7.3,"San Diego County, CA"
102,2021,Jul,1561508,1453458,108050,6.9,"San Diego County, CA"
103,2021,Aug,1556707,1455117,101590,6.5,"San Diego County, CA"
104,2021,Sep,1560466,1474887,85579,5.5,"San Diego County, CA"
105,2021,Oct,1566372,1484638,81734,5.2,"San Diego County, CA"
106,2021,Nov,1572187,1499137,73050,4.6,"San Diego County, CA"
107,2021,Dec,1568289,1502394,65895,4.2,"San Diego County, CA"
108,2022,Jan,1573905,1500742,73163,4.6,"San Diego County, CA"
109,2022,Feb,1583030,1518472,64558,4.1,"San Diego County, CA"
110,2022,Mar,1589441,1531966,57475,3.6,"San Diego County, CA"
111,2022,Apr,1573804,1524112,49692,3.2,"San Diego County, CA"
112,2022,May,1581087,1535400,45687,2.9,"San Diego County, CA"
113,2022,Jun,1580475,1526316,54159,3.4,"San Diego County, CA"
114,2022,Jul,1589923,1535963,53960,3.4,"San Diego County, CA"
115,2022,Aug,1591557,1536112,55445,3.5,"San Diego County, CA"
116,2022,Sep,1599976,1550579,49397,3.1,"San Diego County, CA"
117,2022,Oct,1600480,1548039,52441,3.3,"San Diego County, CA"
118,2022,Nov,1603979,1551106,52873,3.3,"San Diego County, CA"
119,2022,Dec,1606945,1558813,48132,3.0,"San Diego County, CA"
120,2023,Jan,1600536,1541801,58735,3.7,"San Diego County, CA"
121,2023,Feb,1611438,1551477,59961,3.7,"San Diego County, CA"
122,2023,Mar,1618219,1558734,59485,3.7,"San Diego County, CA"
123,2023,Apr,1598923,1546146,52777,3.3,"San Diego County, CA"
124,2023,May,1595034,1539280,55754,3.5,"San Diego County, CA"
125,2023,Jun,1591607,1528239,63368,4.0,"San Diego County, CA"
126,2023,Jul,1596570,1533668,62902,3.9,"San Diego County, CA"
127,2023,Aug,1592765,1524264,68501,4.3,"San Diego County, CA"
128,2023,Sep,1604403,1539381,65022,4.1,"San Diego County, CA"
129,2023,Oct,1602560,1535798,66762,4.2,"San Diego County, CA"
0,2013,Jan,25804,23732,2072,8.0,"Walton County, FL"
1,2013,Feb,25857,23995,1862,7.2,"Walton County, FL"
2,2013,Mar,26444,24740,1704,6.4,"Walton County, FL"
3,2013,Apr,26686,25075,1611,6.0,"Walton County, FL"
4,2013,May,27443,25773,1670,6.1,"Walton County, FL"
5,2013,Jun,28129,26350,1779,6.3,"Walton County, FL"
6,2013,Jul,28301,26542,1759,6.2,"Walton County, FL"
7,2013,Aug,27777,26077,1700,6.1,"Walton County, FL"
8,2013,Sep,27293,25649,1644,6.0,"Walton County, FL"
9,2013,Oct,26691,25085,1606,6.0,"Walton County, FL"
10,2013,Nov,26302,24698,1604,6.1,"Walton County, FL"
11,2013,Dec,25960,24422,1538,5.9,"Walton County, FL"
12,2014,Jan,26258,24594,1664,6.3,"Walton County, FL"
13,2014,Feb,26463,24831,1632,6.2,"Walton County, FL"
14,2014,Mar,27209,25690,1519,5.6,"Walton County, FL"
15,2014,Apr,27190,25859,1331,4.9,"Walton County, FL"
16,2014,May,27894,26442,1452,5.2,"Walton County, FL"
17,2014,Jun,28483,26981,1502,5.3,"Walton County, FL"
18,2014,Jul,28572,27001,1571,5.5,"Walton County, FL"
19,2014,Aug,28059,26508,1551,5.5,"Walton County, FL"
20,2014,Sep,27569,26130,1439,5.2,"Walton County, FL"
21,2014,Oct,27168,25754,1414,5.2,"Walton County, FL"
22,2014,Nov,26519,25093,1426,5.4,"Walton County, FL"
23,2014,Dec,26220,24845,1375,5.2,"Walton County, FL"
24,2015,Jan,26788,25252,1536,5.7,"Walton County, FL"
25,2015,Feb,26825,25415,1410,5.3,"Walton County, FL"
26,2015,Mar,27395,26092,1303,4.8,"Walton County, FL"
27,2015,Apr,27768,26533,1235,4.4,"Walton County, FL"
28,2015,May,28493,27161,1332,4.7,"Walton County, FL"
29,2015,Jun,28973,27635,1338,4.6,"Walton County, FL"
30,2015,Jul,29274,27886,1388,4.7,"Walton County, FL"
31,2015,Aug,28736,27405,1331,4.6,"Walton County, FL"
32,2015,Sep,28177,26922,1255,4.5,"Walton County, FL"
33,2015,Oct,28070,26813,1257,4.5,"Walton County, FL"
34,2015,Nov,27535,26268,1267,4.6,"Walton County, FL"
35,2015,Dec,27353,26088,1265,4.6,"Walton County, FL"
36,2016,Jan,27763,26389,1374,4.9,"Walton County, FL"
37,2016,Feb,27971,26715,1256,4.5,"Walton County, FL"
38,2016,Mar,28660,27421,1239,4.3,"Walton County, FL"
39,2016,Apr,28850,27668,1182,4.1,"Walton County, FL"
40,2016,May,29326,28163,1163,4.0,"Walton County, FL"
41,2016,Jun,30203,28912,1291,4.3,"Walton County, FL"
42,2016,Jul,30451,29123,1328,4.4,"Walton County, FL"
43,2016,Aug,29936,28641,1295,4.3,"Walton County, FL"
44,2016,Sep,29468,28178,1290,4.4,"Walton County, FL"
45,2016,Oct,29129,27878,1251,4.3,"Walton County, FL"
46,2016,Nov,28494,27286,1208,4.2,"Walton County, FL"
47,2016,Dec,28164,26935,1229,4.4,"Walton County, FL"
48,2017,Jan,28645,27269,1376,4.8,"Walton County, FL"
49,2017,Feb,28789,27558,1231,4.3,"Walton County, FL"
50,2017,Mar,29443,28326,1117,3.8,"Walton County, FL"
51,2017,Apr,29694,28650,1044,3.5,"Walton County, FL"
52,2017,May,30074,29010,1064,3.5,"Walton County, FL"
53,2017,Jun,30943,29822,1121,3.6,"Walton County, FL"
54,2017,Jul,30965,29835,1130,3.6,"Walton County, FL"
55,2017,Aug,30532,29401,1131,3.7,"Walton County, FL"
56,2017,Sep,30479,29421,1058,3.5,"Walton County, FL"
57,2017,Oct,29831,28799,1032,3.5,"Walton County, FL"
58,2017,Nov,29342,28291,1051,3.6,"Walton County, FL"
59,2017,Dec,28922,27919,1003,3.5,"Walton County, FL"
60,2018,Jan,29608,28445,1163,3.9,"Walton County, FL"
61,2018,Feb,29917,28849,1068,3.6,"Walton County, FL"
62,2018,Mar,30646,29644,1002,3.3,"Walton County, FL"
63,2018,Apr,30777,29870,907,2.9,"Walton County, FL"
64,2018,May,31203,30288,915,2.9,"Walton County, FL"
65,2018,Jun,31955,30875,1080,3.4,"Walton County, FL"
66,2018,Jul,32035,31019,1016,3.2,"Walton County, FL"
67,2018,Aug,31408,30402,1006,3.2,"Walton County, FL"
68,2018,Sep,30954,30035,919,3.0,"Walton County, FL"
69,2018,Oct,30726,29792,934,3.0,"Walton County, FL"
70,2018,Nov,30401,29449,952,3.1,"Walton County, FL"
71,2018,Dec,30088,29121,967,3.2,"Walton County, FL"
72,2019,Jan,30803,29670,1133,3.7,"Walton County, FL"
73,2019,Feb,30924,29957,967,3.1,"Walton County, FL"
74,2019,Mar,31522,30568,954,3.0,"Walton County, FL"
75,2019,Apr,31614,30765,849,2.7,"Walton County, FL"
76,2019,May,32349,31478,871,2.7,"Walton County, FL"
77,2019,Jun,33054,32047,1007,3.0,"Walton County, FL"
78,2019,Jul,33142,32127,1015,3.1,"Walton County, FL"
79,2019,Aug,32649,31658,991,3.0,"Walton County, FL"
80,2019,Sep,32252,31374,878,2.7,"Walton County, FL"
81,2019,Oct,31993,31141,852,2.7,"Walton County, FL"
82,2019,Nov,31530,30665,865,2.7,"Walton County, FL"
83,2019,Dec,31299,30469,830,2.7,"Walton County, FL"
84,2020,Jan,32080,31095,985,3.1,"Walton County, FL"
85,2020,Feb,32234,31408,826,2.6,"Walton County, FL"
86,2020,Mar,32161,30990,1171,3.6,"Walton County, FL"
87,2020,Apr,30003,25969,4034,13.4,"Walton County, FL"
88,2020,May,32139,28608,3531,11.0,"Walton County, FL"
89,2020,Jun,32648,30166,2482,7.6,"Walton County, FL"
90,2020,Jul,33458,30825,2633,7.9,"Walton County, FL"
91,2020,Aug,33031,31240,1791,5.4,"Walton County, FL"
92,2020,Sep,32777,31061,1716,5.2,"Walton County, FL"
93,2020,Oct,33082,31546,1536,4.6,"Walton County, FL"
94,2020,Nov,32572,31068,1504,4.6,"Walton County, FL"
95,2020,Dec,32648,31131,1517,4.6,"Walton County, FL"
96,2021,Jan,32582,31050,1532,4.7,"Walton County, FL"
97,2021,Feb,32826,31444,1382,4.2,"Walton County, FL"
98,2021,Mar,33506,32188,1318,3.9,"Walton County, FL"
99,2021,Apr,33656,32456,1200,3.6,"Walton County, FL"
100,2021,May,34173,33046,1127,3.3,"Walton County, FL"
101,2021,Jun,34943,33566,1377,3.9,"Walton County, FL"
102,2021,Jul,35035,33711,1324,3.8,"Walton County, FL"
103,2021,Aug,34471,33188,1283,3.7,"Walton County, FL"
104,2021,Sep,34089,32962,1127,3.3,"Walton County, FL"
105,2021,Oct,34056,32991,1065,3.1,"Walton County, FL"
106,2021,Nov,33632,32609,1023,3.0,"Walton County, FL"
107,2021,Dec,33617,32705,912,2.7,"Walton County, FL"
108,2022,Jan,33934,32782,1152,3.4,"Walton County, FL"
109,2022,Feb,34016,33026,990,2.9,"Walton County, FL"
110,2022,Mar,34654,33745,909,2.6,"Walton County, FL"
111,2022,Apr,34791,34004,787,2.3,"Walton County, FL"
112,2022,May,35477,34655,822,2.3,"Walton County, FL"
113,2022,Jun,35889,34926,963,2.7,"Walton County, FL"
114,2022,Jul,36018,35100,918,2.5,"Walton County, FL"
115,2022,Aug,35615,34687,928,2.6,"Walton County, FL"
116,2022,Sep,35338,34480,858,2.4,"Walton County, FL"
117,2022,Oct,35158,34311,847,2.4,"Walton County, FL"
118,2022,Nov,34695,33871,824,2.4,"Walton County, FL"
119,2022,Dec,34700,33969,731,2.1,"Walton County, FL"
120,2023,Jan,34866,33998,868,2.5,"Walton County, FL"
121,2023,Feb,35112,34236,876,2.5,"Walton County, FL"
122,2023,Mar,35705,34839,866,2.4,"Walton County, FL"
123,2023,Apr,35736,34977,759,2.1,"Walton County, FL"
124,2023,May,36046,35171,875,2.4,"Walton County, FL"
125,2023,Jun,36715,35755,960,2.6,"Walton County, FL"
126,2023,Jul,37100,36068,1032,2.8,"Walton County, FL"
127,2023,Aug,36979,35903,1076,2.9,"Walton County, FL"
128,2023,Sep,36836,35742,1094,3.0,"Walton County, FL"
129,2023,Oct,36530,35452,1078,3.0,"Walton County, FL"
0,2013,Jan,137244,125257,11987,8.7,"Escambia County, FL"
1,2013,Feb,136507,125438,11069,8.1,"Escambia County, FL"
2,2013,Mar,137328,126711,10617,7.7,"Escambia County, FL"
3,2013,Apr,137406,127436,9970,7.3,"Escambia County, FL"
4,2013,May,139359,129028,10331,7.4,"Escambia County, FL"
5,2013,Jun,140606,129466,11140,7.9,"Escambia County, FL"
6,2013,Jul,141534,130619,10915,7.7,"Escambia County, FL"
7,2013,Aug,141277,130758,10519,7.4,"Escambia County, FL"
8,2013,Sep,140755,130497,10258,7.3,"Escambia County, FL"
9,2013,Oct,138438,128511,9927,7.2,"Escambia County, FL"
10,2013,Nov,136766,127039,9727,7.1,"Escambia County, FL"
11,2013,Dec,136473,127172,9301,6.8,"Escambia County, FL"
12,2014,Jan,136803,126785,10018,7.3,"Escambia County, FL"
13,2014,Feb,137105,127407,9698,7.1,"Escambia County, FL"
14,2014,Mar,138271,128725,9546,6.9,"Escambia County, FL"
15,2014,Apr,138200,129569,8631,6.2,"Escambia County, FL"
16,2014,May,140085,130892,9193,6.6,"Escambia County, FL"
17,2014,Jun,140552,130869,9683,6.9,"Escambia County, FL"
18,2014,Jul,141723,131713,10010,7.1,"Escambia County, FL"
19,2014,Aug,141284,131758,9526,6.7,"Escambia County, FL"
20,2014,Sep,140823,131936,8887,6.3,"Escambia County, FL"
21,2014,Oct,139939,131370,8569,6.1,"Escambia County, FL"
22,2014,Nov,137815,129188,8627,6.3,"Escambia County, FL"
23,2014,Dec,136936,128793,8143,5.9,"Escambia County, FL"
24,2015,Jan,136310,127512,8798,6.5,"Escambia County, FL"
25,2015,Feb,135812,127653,8159,6.0,"Escambia County, FL"
26,2015,Mar,136459,128755,7704,5.6,"Escambia County, FL"
27,2015,Apr,138172,130720,7452,5.4,"Escambia County, FL"
28,2015,May,140296,132253,8043,5.7,"Escambia County, FL"
29,2015,Jun,140608,132294,8314,5.9,"Escambia County, FL"
30,2015,Jul,140978,132697,8281,5.9,"Escambia County, FL"
31,2015,Aug,141067,133248,7819,5.5,"Escambia County, FL"
32,2015,Sep,140019,132572,7447,5.3,"Escambia County, FL"
33,2015,Oct,139340,131936,7404,5.3,"Escambia County, FL"
34,2015,Nov,137727,130312,7415,5.4,"Escambia County, FL"
35,2015,Dec,137256,130161,7095,5.2,"Escambia County, FL"
36,2016,Jan,138042,130517,7525,5.5,"Escambia County, FL"
37,2016,Feb,138645,131713,6932,5.0,"Escambia County, FL"
38,2016,Mar,140093,133211,6882,4.9,"Escambia County, FL"
39,2016,Apr,139879,133260,6619,4.7,"Escambia County, FL"
40,2016,May,141770,135190,6580,4.6,"Escambia County, FL"
41,2016,Jun,142706,135149,7557,5.3,"Escambia County, FL"
42,2016,Jul,143375,135837,7538,5.3,"Escambia County, FL"
43,2016,Aug,144034,136629,7405,5.1,"Escambia County, FL"
44,2016,Sep,144182,136849,7333,5.1,"Escambia County, FL"
45,2016,Oct,143188,136143,7045,4.9,"Escambia County, FL"
46,2016,Nov,141168,134369,6799,4.8,"Escambia County, FL"
47,2016,Dec,139939,133295,6644,4.7,"Escambia County, FL"
48,2017,Jan,138541,131437,7104,5.1,"Escambia County, FL"
49,2017,Feb,139037,132664,6373,4.6,"Escambia County, FL"
50,2017,Mar,139972,134057,5915,4.2,"Escambia County, FL"
51,2017,Apr,140399,134823,5576,4.0,"Escambia County, FL"
52,2017,May,141017,135312,5705,4.0,"Escambia County, FL"
53,2017,Jun,142432,136093,6339,4.5,"Escambia County, FL"
54,2017,Jul,142500,136135,6365,4.5,"Escambia County, FL"
55,2017,Aug,142232,135960,6272,4.4,"Escambia County, FL"
56,2017,Sep,144435,138715,5720,4.0,"Escambia County, FL"
57,2017,Oct,141765,136120,5645,4.0,"Escambia County, FL"
58,2017,Nov,140415,134727,5688,4.1,"Escambia County, FL"
59,2017,Dec,139053,133711,5342,3.8,"Escambia County, FL"
60,2018,Jan,138931,132746,6185,4.5,"Escambia County, FL"
61,2018,Feb,139805,134352,5453,3.9,"Escambia County, FL"
62,2018,Mar,140472,135231,5241,3.7,"Escambia County, FL"
63,2018,Apr,141447,136567,4880,3.5,"Escambia County, FL"
64,2018,May,142671,137843,4828,3.4,"Escambia County, FL"
65,2018,Jun,143930,138192,5738,4.0,"Escambia County, FL"
66,2018,Jul,144808,139274,5534,3.8,"Escambia County, FL"
67,2018,Aug,144020,138743,5277,3.7,"Escambia County, FL"
68,2018,Sep,144027,139113,4914,3.4,"Escambia County, FL"
69,2018,Oct,143136,138198,4938,3.4,"Escambia County, FL"
70,2018,Nov,141864,137101,4763,3.4,"Escambia County, FL"
71,2018,Dec,140787,135990,4797,3.4,"Escambia County, FL"
72,2019,Jan,140796,135184,5612,4.0,"Escambia County, FL"
73,2019,Feb,141196,136357,4839,3.4,"Escambia County, FL"
74,2019,Mar,142201,137497,4704,3.3,"Escambia County, FL"
75,2019,Apr,142561,138367,4194,2.9,"Escambia County, FL"
76,2019,May,143835,139428,4407,3.1,"Escambia County, FL"
77,2019,Jun,144921,139739,5182,3.6,"Escambia County, FL"
78,2019,Jul,146382,141061,5321,3.6,"Escambia County, FL"
79,2019,Aug,145826,140725,5101,3.5,"Escambia County, FL"
80,2019,Sep,145957,141349,4608,3.2,"Escambia County, FL"
81,2019,Oct,145839,141234,4605,3.2,"Escambia County, FL"
82,2019,Nov,144530,140114,4416,3.1,"Escambia County, FL"
83,2019,Dec,143570,139410,4160,2.9,"Escambia County, FL"
84,2020,Jan,143748,138767,4981,3.5,"Escambia County, FL"
85,2020,Feb,144397,140152,4245,2.9,"Escambia County, FL"
86,2020,Mar,143221,137003,6218,4.3,"Escambia County, FL"
87,2020,Apr,134521,118888,15633,11.6,"Escambia County, FL"
88,2020,May,143346,127479,15867,11.1,"Escambia County, FL"
89,2020,Jun,143956,131116,12840,8.9,"Escambia County, FL"
90,2020,Jul,148450,132725,15725,10.6,"Escambia County, FL"
91,2020,Aug,146880,135694,11186,7.6,"Escambia County, FL"
92,2020,Sep,146157,135813,10344,7.1,"Escambia County, FL"
93,2020,Oct,144912,135792,9120,6.3,"Escambia County, FL"
94,2020,Nov,143622,134960,8662,6.0,"Escambia County, FL"
95,2020,Dec,142708,134464,8244,5.8,"Escambia County, FL"
96,2021,Jan,143115,134687,8428,5.9,"Escambia County, FL"
97,2021,Feb,143591,135939,7652,5.3,"Escambia County, FL"
98,2021,Mar,144112,137060,7052,4.9,"Escambia County, FL"
99,2021,Apr,144891,138197,6694,4.6,"Escambia County, FL"
100,2021,May,145502,139018,6484,4.5,"Escambia County, FL"
101,2021,Jun,146018,138463,7555,5.2,"Escambia County, FL"
102,2021,Jul,148295,141046,7249,4.9,"Escambia County, FL"
103,2021,Aug,147803,140888,6915,4.7,"Escambia County, FL"
104,2021,Sep,147435,141283,6152,4.2,"Escambia County, FL"
105,2021,Oct,146919,141017,5902,4.0,"Escambia County, FL"
106,2021,Nov,145708,140196,5512,3.8,"Escambia County, FL"
107,2021,Dec,145238,140382,4856,3.3,"Escambia County, FL"
108,2022,Jan,146459,140557,5902,4.0,"Escambia County, FL"
109,2022,Feb,145972,140959,5013,3.4,"Escambia County, FL"
110,2022,Mar,147286,142730,4556,3.1,"Escambia County, FL"
111,2022,Apr,148093,143922,4171,2.8,"Escambia County, FL"
112,2022,May,149408,145170,4238,2.8,"Escambia County, FL"
113,2022,Jun,150012,145129,4883,3.3,"Escambia County, FL"
114,2022,Jul,151145,146471,4674,3.1,"Escambia County, FL"
115,2022,Aug,150566,145918,4648,3.1,"Escambia County, FL"
116,2022,Sep,151175,146985,4190,2.8,"Escambia County, FL"
117,2022,Oct,150276,146073,4203,2.8,"Escambia County, FL"
118,2022,Nov,149501,145442,4059,2.7,"Escambia County, FL"
119,2022,Dec,149014,145270,3744,2.5,"Escambia County, FL"
120,2023,Jan,149205,145141,4064,2.7,"Escambia County, FL"
121,2023,Feb,150504,146472,4032,2.7,"Escambia County, FL"
122,2023,Mar,152324,148252,4072,2.7,"Escambia County, FL"
123,2023,Apr,151688,148085,3603,2.4,"Escambia County, FL"
124,2023,May,152358,148129,4229,2.8,"Escambia County, FL"
125,2023,Jun,154517,149660,4857,3.1,"Escambia County, FL"
126,2023,Jul,155356,150305,5051,3.3,"Escambia County, FL"
127,2023,Aug,155830,150740,5090,3.3,"Escambia County, FL"
128,2023,Sep,155779,150783,4996,3.2,"Escambia County, FL"
129,2023,Oct,155345,150143,5202,3.3,"Escambia County, FL"
0,2013,Jan,144792,131077,13715,9.5,"Osceola County, FL"
1,2013,Feb,144876,132177,12699,8.8,"Osceola County, FL"
2,2013,Mar,145243,133160,12083,8.3,"Osceola County, FL"
3,2013,Apr,145329,133616,11713,8.1,"Osceola County, FL"
4,2013,May,147778,135760,12018,8.1,"Osceola County, FL"
5,2013,Jun,149249,136421,12828,8.6,"Osceola County, FL"
6,2013,Jul,149688,137068,12620,8.4,"Osceola County, FL"
7,2013,Aug,149930,137455,12475,8.3,"Osceola County, FL"
8,2013,Sep,150070,137967,12103,8.1,"Osceola County, FL"
9,2013,Oct,148908,137038,11870,8.0,"Osceola County, FL"
10,2013,Nov,147722,136473,11249,7.6,"Osceola County, FL"
11,2013,Dec,147203,136465,10738,7.3,"Osceola County, FL"
12,2014,Jan,149833,138431,11402,7.6,"Osceola County, FL"
13,2014,Feb,150479,139358,11121,7.4,"Osceola County, FL"
14,2014,Mar,151485,140681,10804,7.1,"Osceola County, FL"
15,2014,Apr,150493,140522,9971,6.6,"Osceola County, FL"
16,2014,May,152742,142368,10374,6.8,"Osceola County, FL"
17,2014,Jun,153479,142650,10829,7.1,"Osceola County, FL"
18,2014,Jul,154404,143079,11325,7.3,"Osceola County, FL"
19,2014,Aug,154576,143439,11137,7.2,"Osceola County, FL"
20,2014,Sep,154405,144017,10388,6.7,"Osceola County, FL"
21,2014,Oct,153677,143675,10002,6.5,"Osceola County, FL"
22,2014,Nov,152242,142297,9945,6.5,"Osceola County, FL"
23,2014,Dec,151641,142319,9322,6.1,"Osceola County, FL"
24,2015,Jan,154436,144235,10201,6.6,"Osceola County, FL"
25,2015,Feb,154712,145288,9424,6.1,"Osceola County, FL"
26,2015,Mar,155161,146195,8966,5.8,"Osceola County, FL"
27,2015,Apr,155853,147109,8744,5.6,"Osceola County, FL"
28,2015,May,158330,149072,9258,5.8,"Osceola County, FL"
29,2015,Jun,159347,149660,9687,6.1,"Osceola County, FL"
30,2015,Jul,159746,150039,9707,6.1,"Osceola County, FL"
31,2015,Aug,159595,150209,9386,5.9,"Osceola County, FL"
32,2015,Sep,159948,150938,9010,5.6,"Osceola County, FL"
33,2015,Oct,159659,150760,8899,5.6,"Osceola County, FL"
34,2015,Nov,158800,149994,8806,5.5,"Osceola County, FL"
35,2015,Dec,159125,150772,8353,5.2,"Osceola County, FL"
36,2016,Jan,161097,152330,8767,5.4,"Osceola County, FL"
37,2016,Feb,162149,154032,8117,5.0,"Osceola County, FL"
38,2016,Mar,162761,154718,8043,4.9,"Osceola County, FL"
39,2016,Apr,162506,154759,7747,4.8,"Osceola County, FL"
40,2016,May,164460,156759,7701,4.7,"Osceola County, FL"
41,2016,Jun,165846,157098,8748,5.3,"Osceola County, FL"
42,2016,Jul,166866,158114,8752,5.2,"Osceola County, FL"
43,2016,Aug,166765,158051,8714,5.2,"Osceola County, FL"
44,2016,Sep,167689,159120,8569,5.1,"Osceola County, FL"
45,2016,Oct,166751,158492,8259,5.0,"Osceola County, FL"
46,2016,Nov,165265,157369,7896,4.8,"Osceola County, FL"
47,2016,Dec,165343,157649,7694,4.7,"Osceola County, FL"
48,2017,Jan,168142,159626,8516,5.1,"Osceola County, FL"
49,2017,Feb,169140,161377,7763,4.6,"Osceola County, FL"
50,2017,Mar,169785,162431,7354,4.3,"Osceola County, FL"
51,2017,Apr,170026,163023,7003,4.1,"Osceola County, FL"
52,2017,May,171357,164132,7225,4.2,"Osceola County, FL"
53,2017,Jun,173118,165095,8023,4.6,"Osceola County, FL"
54,2017,Jul,173429,165343,8086,4.7,"Osceola County, FL"
55,2017,Aug,172776,164707,8069,4.7,"Osceola County, FL"
56,2017,Sep,174091,166647,7444,4.3,"Osceola County, FL"
57,2017,Oct,173358,166220,7138,4.1,"Osceola County, FL"
58,2017,Nov,172643,165427,7216,4.2,"Osceola County, FL"
59,2017,Dec,172593,165813,6780,3.9,"Osceola County, FL"
60,2018,Jan,176062,168553,7509,4.3,"Osceola County, FL"
61,2018,Feb,177200,170204,6996,3.9,"Osceola County, FL"
62,2018,Mar,177500,170754,6746,3.8,"Osceola County, FL"
63,2018,Apr,177469,171181,6288,3.5,"Osceola County, FL"
64,2018,May,178810,172516,6294,3.5,"Osceola County, FL"
65,2018,Jun,180846,173465,7381,4.1,"Osceola County, FL"
66,2018,Jul,181628,174321,7307,4.0,"Osceola County, FL"
67,2018,Aug,180680,173578,7102,3.9,"Osceola County, FL"
68,2018,Sep,181484,174981,6503,3.6,"Osceola County, FL"
69,2018,Oct,181952,175445,6507,3.6,"Osceola County, FL"
70,2018,Nov,180221,174120,6101,3.4,"Osceola County, FL"
71,2018,Dec,179643,173566,6077,3.4,"Osceola County, FL"
72,2019,Jan,180616,173477,7139,4.0,"Osceola County, FL"
73,2019,Feb,181824,175597,6227,3.4,"Osceola County, FL"
74,2019,Mar,181966,175939,6027,3.3,"Osceola County, FL"
75,2019,Apr,181887,176428,5459,3.0,"Osceola County, FL"
76,2019,May,183453,177735,5718,3.1,"Osceola County, FL"
77,2019,Jun,185415,178702,6713,3.6,"Osceola County, FL"
78,2019,Jul,186545,179530,7015,3.8,"Osceola County, FL"
79,2019,Aug,186745,179926,6819,3.7,"Osceola County, FL"
80,2019,Sep,187433,181171,6262,3.3,"Osceola County, FL"
81,2019,Oct,187201,181002,6199,3.3,"Osceola County, FL"
82,2019,Nov,185869,180102,5767,3.1,"Osceola County, FL"
83,2019,Dec,185671,180335,5336,2.9,"Osceola County, FL"
84,2020,Jan,188412,182088,6324,3.4,"Osceola County, FL"
85,2020,Feb,189056,183673,5383,2.8,"Osceola County, FL"
86,2020,Mar,186261,177966,8295,4.5,"Osceola County, FL"
87,2020,Apr,184570,146924,37646,20.4,"Osceola County, FL"
88,2020,May,206403,144921,61482,29.8,"Osceola County, FL"
89,2020,Jun,200539,150175,50364,25.1,"Osceola County, FL"
90,2020,Jul,198254,155721,42533,21.5,"Osceola County, FL"
91,2020,Aug,189355,159950,29405,15.5,"Osceola County, FL"
92,2020,Sep,187678,161770,25908,13.8,"Osceola County, FL"
93,2020,Oct,185363,165071,20292,10.9,"Osceola County, FL"
94,2020,Nov,183970,166214,17756,9.7,"Osceola County, FL"
95,2020,Dec,181687,166199,15488,8.5,"Osceola County, FL"
96,2021,Jan,179926,164796,15130,8.4,"Osceola County, FL"
97,2021,Feb,179964,166705,13259,7.4,"Osceola County, FL"
98,2021,Mar,180933,168421,12512,6.9,"Osceola County, FL"
99,2021,Apr,182616,170270,12346,6.8,"Osceola County, FL"
100,2021,May,183816,171727,12089,6.6,"Osceola County, FL"
101,2021,Jun,186965,173729,13236,7.1,"Osceola County, FL"
102,2021,Jul,188563,176508,12055,6.4,"Osceola County, FL"
103,2021,Aug,189618,178287,11331,6.0,"Osceola County, FL"
104,2021,Sep,191041,180608,10433,5.5,"Osceola County, FL"
105,2021,Oct,192001,182243,9758,5.1,"Osceola County, FL"
106,2021,Nov,192139,183110,9029,4.7,"Osceola County, FL"
107,2021,Dec,191541,183844,7697,4.0,"Osceola County, FL"
108,2022,Jan,192748,183809,8939,4.6,"Osceola County, FL"
109,2022,Feb,193248,185606,7642,4.0,"Osceola County, FL"
110,2022,Mar,194546,187707,6839,3.5,"Osceola County, FL"
111,2022,Apr,194661,188301,6360,3.3,"Osceola County, FL"
112,2022,May,196080,189788,6292,3.2,"Osceola County, FL"
113,2022,Jun,198092,191009,7083,3.6,"Osceola County, FL"
114,2022,Jul,199032,192221,6811,3.4,"Osceola County, FL"
115,2022,Aug,200216,193336,6880,3.4,"Osceola County, FL"
116,2022,Sep,200949,194946,6003,3.0,"Osceola County, FL"
117,2022,Oct,200150,193894,6256,3.1,"Osceola County, FL"
118,2022,Nov,199400,193464,5936,3.0,"Osceola County, FL"
119,2022,Dec,199271,194081,5190,2.6,"Osceola County, FL"
120,2023,Jan,198957,193164,5793,2.9,"Osceola County, FL"
121,2023,Feb,200717,194849,5868,2.9,"Osceola County, FL"
122,2023,Mar,202166,196246,5920,2.9,"Osceola County, FL"
123,2023,Apr,202430,196990,5440,2.7,"Osceola County, FL"
124,2023,May,203142,196853,6289,3.1,"Osceola County, FL"
125,2023,Jun,205825,198707,7118,3.5,"Osceola County, FL"
126,2023,Jul,206691,199352,7339,3.6,"Osceola County, FL"
127,2023,Aug,208097,200615,7482,3.6,"Osceola County, FL"
128,2023,Sep,208247,201121,7126,3.4,"Osceola County, FL"
129,2023,Oct,207390,199906,7484,3.6,"Osceola County, FL"
0,2013,Jan,4933076,4397434,535642,10.9,"Los Angeles County, CA"
1,2013,Feb,4947961,4440687,507274,10.3,"Los Angeles County, CA"
2,2013,Mar,4919424,4435904,483520,9.8,"Los Angeles County, CA"
3,2013,Apr,4940090,4475756,464334,9.4,"Los Angeles County, CA"
4,2013,May,4960904,4487059,473845,9.6,"Los Angeles County, CA"
5,2013,Jun,4973838,4466099,507739,10.2,"Los Angeles County, CA"
6,2013,Jul,4983447,4458888,524559,10.5,"Los Angeles County, CA"
7,2013,Aug,4967266,4466761,500505,10.1,"Los Angeles County, CA"
8,2013,Sep,5004374,4525437,478937,9.6,"Los Angeles County, CA"
9,2013,Oct,4950605,4480378,470227,9.5,"Los Angeles County, CA"
10,2013,Nov,4960556,4516663,443893,8.9,"Los Angeles County, CA"
11,2013,Dec,4928127,4505731,422396,8.6,"Los Angeles County, CA"
12,2014,Jan,4932920,4491792,441128,8.9,"Los Angeles County, CA"
13,2014,Feb,4966462,4528375,438087,8.8,"Los Angeles County, CA"
14,2014,Mar,4979418,4549866,429552,8.6,"Los Angeles County, CA"
15,2014,Apr,4959500,4574751,384749,7.8,"Los Angeles County, CA"
16,2014,May,4965151,4566978,398173,8.0,"Los Angeles County, CA"
17,2014,Jun,4962997,4553287,409710,8.3,"Los Angeles County, CA"
18,2014,Jul,5003595,4554827,448768,9.0,"Los Angeles County, CA"
19,2014,Aug,4992582,4558501,434081,8.7,"Los Angeles County, CA"
20,2014,Sep,5025054,4621530,403524,8.0,"Los Angeles County, CA"
21,2014,Oct,5001432,4610767,390665,7.8,"Los Angeles County, CA"
22,2014,Nov,5015346,4632201,383145,7.6,"Los Angeles County, CA"
23,2014,Dec,4984485,4623173,361312,7.2,"Los Angeles County, CA"
24,2015,Jan,4998661,4606821,391840,7.8,"Los Angeles County, CA"
25,2015,Feb,5006806,4634817,371989,7.4,"Los Angeles County, CA"
26,2015,Mar,4985341,4630585,354756,7.1,"Los Angeles County, CA"
27,2015,Apr,4995691,4656778,338913,6.8,"Los Angeles County, CA"
28,2015,May,5009124,4664970,344154,6.9,"Los Angeles County, CA"
29,2015,Jun,4966491,4623115,343376,6.9,"Los Angeles County, CA"
30,2015,Jul,4979621,4618980,360641,7.2,"Los Angeles County, CA"
31,2015,Aug,4931874,4599032,332842,6.7,"Los Angeles County, CA"
32,2015,Sep,4949908,4645244,304664,6.2,"Los Angeles County, CA"
33,2015,Oct,4945012,4650729,294283,6.0,"Los Angeles County, CA"
34,2015,Nov,4975723,4692824,282899,5.7,"Los Angeles County, CA"
35,2015,Dec,4940815,4668747,272068,5.5,"Los Angeles County, CA"
36,2016,Jan,4961623,4675665,285958,5.8,"Los Angeles County, CA"
37,2016,Feb,5000463,4726391,274072,5.5,"Los Angeles County, CA"
38,2016,Mar,5003700,4739281,264419,5.3,"Los Angeles County, CA"
39,2016,Apr,5004059,4753047,251012,5.0,"Los Angeles County, CA"
40,2016,May,4990487,4750214,240273,4.8,"Los Angeles County, CA"
41,2016,Jun,4996938,4725065,271873,5.4,"Los Angeles County, CA"
42,2016,Jul,5047730,4752593,295137,5.8,"Los Angeles County, CA"
43,2016,Aug,5020760,4732734,288026,5.7,"Los Angeles County, CA"
44,2016,Sep,5074790,4795101,279689,5.5,"Los Angeles County, CA"
45,2016,Oct,5042943,4775156,267787,5.3,"Los Angeles County, CA"
46,2016,Nov,5055908,4806409,249499,4.9,"Los Angeles County, CA"
47,2016,Dec,5027638,4782846,244792,4.9,"Los Angeles County, CA"
48,2017,Jan,5065253,4796355,268898,5.3,"Los Angeles County, CA"
49,2017,Feb,5111439,4852845,258594,5.1,"Los Angeles County, CA"
50,2017,Mar,5120580,4880017,240563,4.7,"Los Angeles County, CA"
51,2017,Apr,5109231,4880002,229229,4.5,"Los Angeles County, CA"
52,2017,May,5096976,4870869,226107,4.4,"Los Angeles County, CA"
53,2017,Jun,5086085,4839704,246381,4.8,"Los Angeles County, CA"
54,2017,Jul,5134456,4856570,277886,5.4,"Los Angeles County, CA"
55,2017,Aug,5096249,4823458,272791,5.4,"Los Angeles County, CA"
56,2017,Sep,5159818,4913451,246367,4.8,"Los Angeles County, CA"
57,2017,Oct,5114953,4883230,231723,4.5,"Los Angeles County, CA"
58,2017,Nov,5133365,4906231,227134,4.4,"Los Angeles County, CA"
59,2017,Dec,5089316,4866704,222612,4.4,"Los Angeles County, CA"
60,2018,Jan,5102327,4851622,250705,4.9,"Los Angeles County, CA"
61,2018,Feb,5150589,4908645,241944,4.7,"Los Angeles County, CA"
62,2018,Mar,5148384,4919162,229222,4.5,"Los Angeles County, CA"
63,2018,Apr,5123280,4903424,219856,4.3,"Los Angeles County, CA"
64,2018,May,5105194,4892749,212445,4.2,"Los Angeles County, CA"
65,2018,Jun,5101631,4851668,249963,4.9,"Los Angeles County, CA"
66,2018,Jul,5140320,4873980,266340,5.2,"Los Angeles County, CA"
67,2018,Aug,5071805,4812575,259230,5.1,"Los Angeles County, CA"
68,2018,Sep,5119732,4883925,235807,4.6,"Los Angeles County, CA"
69,2018,Oct,5114827,4882232,232595,4.5,"Los Angeles County, CA"
70,2018,Nov,5145520,4921084,224436,4.4,"Los Angeles County, CA"
71,2018,Dec,5114542,4886874,227668,4.5,"Los Angeles County, CA"
72,2019,Jan,5131043,4875398,255645,5.0,"Los Angeles County, CA"
73,2019,Feb,5138358,4910945,227413,4.4,"Los Angeles County, CA"
74,2019,Mar,5129647,4899262,230385,4.5,"Los Angeles County, CA"
75,2019,Apr,5085715,4877504,208211,4.1,"Los Angeles County, CA"
76,2019,May,5117433,4909419,208014,4.1,"Los Angeles County, CA"
77,2019,Jun,5097671,4864932,232739,4.6,"Los Angeles County, CA"
78,2019,Jul,5155471,4898718,256753,5.0,"Los Angeles County, CA"
79,2019,Aug,5122018,4873233,248785,4.9,"Los Angeles County, CA"
80,2019,Sep,5197257,4968601,228656,4.4,"Los Angeles County, CA"
81,2019,Oct,5182764,4953117,229647,4.4,"Los Angeles County, CA"
82,2019,Nov,5245158,5023312,221846,4.2,"Los Angeles County, CA"
83,2019,Dec,5216016,4995534,220482,4.2,"Los Angeles County, CA"
84,2020,Jan,5268397,5008947,259450,4.9,"Los Angeles County, CA"
85,2020,Feb,5296024,5037619,258405,4.9,"Los Angeles County, CA"
86,2020,Mar,5022339,4685224,337115,6.7,"Los Angeles County, CA"
87,2020,Apr,4773861,3964301,809560,17.0,"Los Angeles County, CA"
88,2020,May,4683090,3793695,889395,19.0,"Los Angeles County, CA"
89,2020,Jun,4920398,4042822,877576,17.8,"Los Angeles County, CA"
90,2020,Jul,5047260,4106297,940963,18.6,"Los Angeles County, CA"
91,2020,Aug,5038699,4180749,857950,17.0,"Los Angeles County, CA"
92,2020,Sep,4823991,4276753,547238,11.3,"Los Angeles County, CA"
93,2020,Oct,4869275,4362860,506415,10.4,"Los Angeles County, CA"
94,2020,Nov,4902789,4395343,507446,10.4,"Los Angeles County, CA"
95,2020,Dec,4877939,4351494,526445,10.8,"Los Angeles County, CA"
96,2021,Jan,4895881,4358505,537376,11.0,"Los Angeles County, CA"
97,2021,Feb,4976240,4455056,521184,10.5,"Los Angeles County, CA"
98,2021,Mar,4991495,4473596,517899,10.4,"Los Angeles County, CA"
99,2021,Apr,4995916,4485635,510281,10.2,"Los Angeles County, CA"
100,2021,May,4993267,4523745,469522,9.4,"Los Angeles County, CA"
101,2021,Jun,4989591,4494146,495445,9.9,"Los Angeles County, CA"
102,2021,Jul,5033302,4553067,480235,9.5,"Los Angeles County, CA"
103,2021,Aug,4985861,4540186,445675,8.9,"Los Angeles County, CA"
104,2021,Sep,5004482,4618625,385857,7.7,"Los Angeles County, CA"
105,2021,Oct,5009265,4646653,362612,7.2,"Los Angeles County, CA"
106,2021,Nov,5044623,4720492,324131,6.4,"Los Angeles County, CA"
107,2021,Dec,5001852,4701620,300232,6.0,"Los Angeles County, CA"
108,2022,Jan,5035535,4707533,328002,6.5,"Los Angeles County, CA"
109,2022,Feb,5065387,4772698,292689,5.8,"Los Angeles County, CA"
110,2022,Mar,5051030,4790465,260565,5.2,"Los Angeles County, CA"
111,2022,Apr,5000847,4761695,239152,4.8,"Los Angeles County, CA"
112,2022,May,4987130,4763298,223832,4.5,"Los Angeles County, CA"
113,2022,Jun,4935287,4694769,240518,4.9,"Los Angeles County, CA"
114,2022,Jul,4957468,4716142,241326,4.9,"Los Angeles County, CA"
115,2022,Aug,4927912,4697244,230668,4.7,"Los Angeles County, CA"
116,2022,Sep,4958064,4744505,213559,4.3,"Los Angeles County, CA"
117,2022,Oct,4947566,4723562,224004,4.5,"Los Angeles County, CA"
118,2022,Nov,4986416,4760132,226284,4.5,"Los Angeles County, CA"
119,2022,Dec,4965511,4747043,218468,4.4,"Los Angeles County, CA"
120,2023,Jan,4982143,4736443,245700,4.9,"Los Angeles County, CA"
121,2023,Feb,5041535,4777999,263536,5.2,"Los Angeles County, CA"
122,2023,Mar,5032959,4782649,250310,5.0,"Los Angeles County, CA"
123,2023,Apr,4990245,4765110,225135,4.5,"Los Angeles County, CA"
124,2023,May,4968555,4728412,240143,4.8,"Los Angeles County, CA"
125,2023,Jun,5023879,4758664,265215,5.3,"Los Angeles County, CA"
126,2023,Jul,5005258,4735531,269727,5.4,"Los Angeles County, CA"
127,2023,Aug,5004763,4713097,291666,5.8,"Los Angeles County, CA"
128,2023,Sep,5028740,4736940,291800,5.8,"Los Angeles County, CA"
129,2023,Oct,4977558,4730138,247420,5.0,"Los Angeles County, CA"
0,2013,Jan,7967,6411,1556,19.5,"Plumas County, CA"
1,2013,Feb,7882,6360,1522,19.3,"Plumas County, CA"
2,2013,Mar,7886,6411,1475,18.7,"Plumas County, CA"
3,2013,Apr,8077,6815,1262,15.6,"Plumas County, CA"
4,2013,May,8430,7344,1086,12.9,"Plumas County, CA"
5,2013,Jun,8693,7636,1057,12.2,"Plumas County, CA"
6,2013,Jul,8729,7698,1031,11.8,"Plumas County, CA"
7,2013,Aug,8646,7699,947,11.0,"Plumas County, CA"
8,2013,Sep,8548,7643,905,10.6,"Plumas County, CA"
9,2013,Oct,8186,7279,907,11.1,"Plumas County, CA"
10,2013,Nov,7988,6973,1015,12.7,"Plumas County, CA"
11,2013,Dec,7756,6694,1062,13.7,"Plumas County, CA"
12,2014,Jan,7798,6513,1285,16.5,"Plumas County, CA"
13,2014,Feb,7813,6528,1285,16.4,"Plumas County, CA"
14,2014,Mar,7921,6615,1306,16.5,"Plumas County, CA"
15,2014,Apr,7883,6838,1045,13.3,"Plumas County, CA"
16,2014,May,8235,7365,870,10.6,"Plumas County, CA"
17,2014,Jun,8548,7725,823,9.6,"Plumas County, CA"
18,2014,Jul,8520,7703,817,9.6,"Plumas County, CA"
19,2014,Aug,8502,7740,762,9.0,"Plumas County, CA"
20,2014,Sep,8390,7697,693,8.3,"Plumas County, CA"
21,2014,Oct,8067,7376,691,8.6,"Plumas County, CA"
22,2014,Nov,7747,6935,812,10.5,"Plumas County, CA"
23,2014,Dec,7621,6687,934,12.3,"Plumas County, CA"
24,2015,Jan,7603,6485,1118,14.7,"Plumas County, CA"
25,2015,Feb,7546,6477,1069,14.2,"Plumas County, CA"
26,2015,Mar,7610,6557,1053,13.8,"Plumas County, CA"
27,2015,Apr,7580,6744,836,11.0,"Plumas County, CA"
28,2015,May,8103,7347,756,9.3,"Plumas County, CA"
29,2015,Jun,8326,7600,726,8.7,"Plumas County, CA"
30,2015,Jul,8301,7598,703,8.5,"Plumas County, CA"
31,2015,Aug,8361,7711,650,7.8,"Plumas County, CA"
32,2015,Sep,8164,7585,579,7.1,"Plumas County, CA"
33,2015,Oct,7945,7336,609,7.7,"Plumas County, CA"
34,2015,Nov,7621,6852,769,10.1,"Plumas County, CA"
35,2015,Dec,7534,6620,914,12.1,"Plumas County, CA"
36,2016,Jan,7479,6396,1083,14.5,"Plumas County, CA"
37,2016,Feb,7592,6505,1087,14.3,"Plumas County, CA"
38,2016,Mar,7597,6504,1093,14.4,"Plumas County, CA"
39,2016,Apr,7561,6713,848,11.2,"Plumas County, CA"
40,2016,May,7954,7304,650,8.2,"Plumas County, CA"
41,2016,Jun,8390,7726,664,7.9,"Plumas County, CA"
42,2016,Jul,8380,7758,622,7.4,"Plumas County, CA"
43,2016,Aug,8355,7781,574,6.9,"Plumas County, CA"
44,2016,Sep,8161,7626,535,6.6,"Plumas County, CA"
45,2016,Oct,7816,7273,543,6.9,"Plumas County, CA"
46,2016,Nov,7515,6850,665,8.8,"Plumas County, CA"
47,2016,Dec,7403,6579,824,11.1,"Plumas County, CA"
48,2017,Jan,7299,6328,971,13.3,"Plumas County, CA"
49,2017,Feb,7459,6420,1039,13.9,"Plumas County, CA"
50,2017,Mar,7513,6525,988,13.2,"Plumas County, CA"
51,2017,Apr,7473,6646,827,11.1,"Plumas County, CA"
52,2017,May,7852,7222,630,8.0,"Plumas County, CA"
53,2017,Jun,8295,7701,594,7.2,"Plumas County, CA"
54,2017,Jul,8432,7844,588,7.0,"Plumas County, CA"
55,2017,Aug,8217,7682,535,6.5,"Plumas County, CA"
56,2017,Sep,8011,7547,464,5.8,"Plumas County, CA"
57,2017,Oct,7867,7400,467,5.9,"Plumas County, CA"
58,2017,Nov,7401,6850,551,7.4,"Plumas County, CA"
59,2017,Dec,7350,6674,676,9.2,"Plumas County, CA"
60,2018,Jan,7289,6494,795,10.9,"Plumas County, CA"
61,2018,Feb,7449,6591,858,11.5,"Plumas County, CA"
62,2018,Mar,7485,6618,867,11.6,"Plumas County, CA"
63,2018,Apr,7524,6828,696,9.3,"Plumas County, CA"
64,2018,May,7881,7371,510,6.5,"Plumas County, CA"
65,2018,Jun,8247,7736,511,6.2,"Plumas County, CA"
66,2018,Jul,8448,7963,485,5.7,"Plumas County, CA"
67,2018,Aug,8348,7914,434,5.2,"Plumas County, CA"
68,2018,Sep,8150,7767,383,4.7,"Plumas County, CA"
69,2018,Oct,7924,7517,407,5.1,"Plumas County, CA"
70,2018,Nov,7562,7066,496,6.6,"Plumas County, CA"
71,2018,Dec,7455,6795,660,8.9,"Plumas County, CA"
72,2019,Jan,7526,6644,882,11.7,"Plumas County, CA"
73,2019,Feb,7562,6632,930,12.3,"Plumas County, CA"
74,2019,Mar,7534,6617,917,12.2,"Plumas County, CA"
75,2019,Apr,7628,6889,739,9.7,"Plumas County, CA"
76,2019,May,8010,7504,506,6.3,"Plumas County, CA"
77,2019,Jun,8298,7795,503,6.1,"Plumas County, CA"
78,2019,Jul,8475,7958,517,6.1,"Plumas County, CA"
79,2019,Aug,8407,7942,465,5.5,"Plumas County, CA"
80,2019,Sep,8134,7746,388,4.8,"Plumas County, CA"
81,2019,Oct,7970,7566,404,5.1,"Plumas County, CA"
82,2019,Nov,7686,7208,478,6.2,"Plumas County, CA"
83,2019,Dec,7470,6866,604,8.1,"Plumas County, CA"
84,2020,Jan,7468,6664,804,10.8,"Plumas County, CA"
85,2020,Feb,7569,6756,813,10.7,"Plumas County, CA"
86,2020,Mar,7858,6712,1146,14.6,"Plumas County, CA"
87,2020,Apr,7460,6039,1421,19.0,"Plumas County, CA"
88,2020,May,7479,6438,1041,13.9,"Plumas County, CA"
89,2020,Jun,7919,7067,852,10.8,"Plumas County, CA"
90,2020,Jul,7973,7166,807,10.1,"Plumas County, CA"
91,2020,Aug,8054,7393,661,8.2,"Plumas County, CA"
92,2020,Sep,7826,7214,612,7.8,"Plumas County, CA"
93,2020,Oct,7629,7059,570,7.5,"Plumas County, CA"
94,2020,Nov,7322,6697,625,8.5,"Plumas County, CA"
95,2020,Dec,7159,6384,775,10.8,"Plumas County, CA"
96,2021,Jan,7126,6205,921,12.9,"Plumas County, CA"
97,2021,Feb,7213,6243,970,13.4,"Plumas County, CA"
98,2021,Mar,7308,6352,956,13.1,"Plumas County, CA"
99,2021,Apr,7516,6721,795,10.6,"Plumas County, CA"
100,2021,May,7803,7162,641,8.2,"Plumas County, CA"
101,2021,Jun,8180,7512,668,8.2,"Plumas County, CA"
102,2021,Jul,8085,7458,627,7.8,"Plumas County, CA"
103,2021,Aug,7506,6822,684,9.1,"Plumas County, CA"
104,2021,Sep,7594,7045,549,7.2,"Plumas County, CA"
105,2021,Oct,7435,6904,531,7.1,"Plumas County, CA"
106,2021,Nov,7126,6579,547,7.7,"Plumas County, CA"
107,2021,Dec,6874,6303,571,8.3,"Plumas County, CA"
108,2022,Jan,6993,6244,749,10.7,"Plumas County, CA"
109,2022,Feb,7100,6378,722,10.2,"Plumas County, CA"
110,2022,Mar,7170,6493,677,9.4,"Plumas County, CA"
111,2022,Apr,7192,6703,489,6.8,"Plumas County, CA"
112,2022,May,7523,7157,366,4.9,"Plumas County, CA"
113,2022,Jun,7887,7508,379,4.8,"Plumas County, CA"
114,2022,Jul,7824,7442,382,4.9,"Plumas County, CA"
115,2022,Aug,7980,7605,375,4.7,"Plumas County, CA"
116,2022,Sep,7737,7407,330,4.3,"Plumas County, CA"
117,2022,Oct,7559,7205,354,4.7,"Plumas County, CA"
118,2022,Nov,7188,6745,443,6.2,"Plumas County, CA"
119,2022,Dec,6986,6464,522,7.5,"Plumas County, CA"
120,2023,Jan,6970,6261,709,10.2,"Plumas County, CA"
121,2023,Feb,7159,6360,799,11.2,"Plumas County, CA"
122,2023,Mar,7225,6408,817,11.3,"Plumas County, CA"
123,2023,Apr,7067,6447,620,8.8,"Plumas County, CA"
124,2023,May,7380,6865,515,7.0,"Plumas County, CA"
125,2023,Jun,7530,7083,447,5.9,"Plumas County, CA"
126,2023,Jul,7588,7175,413,5.4,"Plumas County, CA"
127,2023,Aug,7519,7097,422,5.6,"Plumas County, CA"
128,2023,Sep,7414,7031,383,5.2,"Plumas County, CA"
129,2023,Oct,7294,6889,405,5.6,"Plumas County, CA"
0,2013,Jan,4435,3978,457,10.3,"Hamilton County, FL"
1,2013,Feb,4420,3999,421,9.5,"Hamilton County, FL"
2,2013,Mar,4472,4075,397,8.9,"Hamilton County, FL"
3,2013,Apr,4505,4127,378,8.4,"Hamilton County, FL"
4,2013,May,4581,4183,398,8.7,"Hamilton County, FL"
5,2013,Jun,4639,4189,450,9.7,"Hamilton County, FL"
6,2013,Jul,4597,4159,438,9.5,"Hamilton County, FL"
7,2013,Aug,4602,4174,428,9.3,"Hamilton County, FL"
8,2013,Sep,4633,4230,403,8.7,"Hamilton County, FL"
9,2013,Oct,5115,4710,405,7.9,"Hamilton County, FL"
10,2013,Nov,4935,4527,408,8.3,"Hamilton County, FL"
11,2013,Dec,4567,4179,388,8.5,"Hamilton County, FL"
12,2014,Jan,4322,3924,398,9.2,"Hamilton County, FL"
13,2014,Feb,4338,3957,381,8.8,"Hamilton County, FL"
14,2014,Mar,4396,4021,375,8.5,"Hamilton County, FL"
15,2014,Apr,4367,4015,352,8.1,"Hamilton County, FL"
16,2014,May,4492,4127,365,8.1,"Hamilton County, FL"
17,2014,Jun,5014,4643,371,7.4,"Hamilton County, FL"
18,2014,Jul,4665,4290,375,8.0,"Hamilton County, FL"
19,2014,Aug,4631,4255,376,8.1,"Hamilton County, FL"
20,2014,Sep,4622,4281,341,7.4,"Hamilton County, FL"
21,2014,Oct,4629,4294,335,7.2,"Hamilton County, FL"
22,2014,Nov,4730,4392,338,7.1,"Hamilton County, FL"
23,2014,Dec,5011,4692,319,6.4,"Hamilton County, FL"
24,2015,Jan,4347,4012,335,7.7,"Hamilton County, FL"
25,2015,Feb,4326,4008,318,7.4,"Hamilton County, FL"
26,2015,Mar,4386,4083,303,6.9,"Hamilton County, FL"
27,2015,Apr,4423,4148,275,6.2,"Hamilton County, FL"
28,2015,May,4584,4289,295,6.4,"Hamilton County, FL"
29,2015,Jun,5055,4750,305,6.0,"Hamilton County, FL"
30,2015,Jul,4550,4238,312,6.9,"Hamilton County, FL"
31,2015,Aug,4632,4335,297,6.4,"Hamilton County, FL"
32,2015,Sep,4612,4335,277,6.0,"Hamilton County, FL"
33,2015,Oct,4700,4418,282,6.0,"Hamilton County, FL"
34,2015,Nov,4536,4243,293,6.5,"Hamilton County, FL"
35,2015,Dec,4326,4052,274,6.3,"Hamilton County, FL"
36,2016,Jan,4876,4593,283,5.8,"Hamilton County, FL"
37,2016,Feb,4847,4578,269,5.5,"Hamilton County, FL"
38,2016,Mar,4812,4550,262,5.4,"Hamilton County, FL"
39,2016,Apr,4413,4165,248,5.6,"Hamilton County, FL"
40,2016,May,4481,4240,241,5.4,"Hamilton County, FL"
41,2016,Jun,4976,4697,279,5.6,"Hamilton County, FL"
42,2016,Jul,4673,4392,281,6.0,"Hamilton County, FL"
43,2016,Aug,4795,4513,282,5.9,"Hamilton County, FL"
44,2016,Sep,4928,4643,285,5.8,"Hamilton County, FL"
45,2016,Oct,4646,4374,272,5.9,"Hamilton County, FL"
46,2016,Nov,4385,4121,264,6.0,"Hamilton County, FL"
47,2016,Dec,4244,4003,241,5.7,"Hamilton County, FL"
48,2017,Jan,4167,3915,252,6.0,"Hamilton County, FL"
49,2017,Feb,4197,3971,226,5.4,"Hamilton County, FL"
50,2017,Mar,4223,4011,212,5.0,"Hamilton County, FL"
51,2017,Apr,4213,4020,193,4.6,"Hamilton County, FL"
52,2017,May,4287,4079,208,4.9,"Hamilton County, FL"
53,2017,Jun,4755,4540,215,4.5,"Hamilton County, FL"
54,2017,Jul,4203,3981,222,5.3,"Hamilton County, FL"
55,2017,Aug,4321,4096,225,5.2,"Hamilton County, FL"
56,2017,Sep,4346,4136,210,4.8,"Hamilton County, FL"
57,2017,Oct,4424,4229,195,4.4,"Hamilton County, FL"
58,2017,Nov,4141,3951,190,4.6,"Hamilton County, FL"
59,2017,Dec,4075,3899,176,4.3,"Hamilton County, FL"
60,2018,Jan,4109,3898,211,5.1,"Hamilton County, FL"
61,2018,Feb,4138,3944,194,4.7,"Hamilton County, FL"
62,2018,Mar,4185,3998,187,4.5,"Hamilton County, FL"
63,2018,Apr,4242,4071,171,4.0,"Hamilton County, FL"
64,2018,May,4310,4141,169,3.9,"Hamilton County, FL"
65,2018,Jun,4829,4623,206,4.3,"Hamilton County, FL"
66,2018,Jul,4316,4105,211,4.9,"Hamilton County, FL"
67,2018,Aug,4388,4200,188,4.3,"Hamilton County, FL"
68,2018,Sep,4436,4267,169,3.8,"Hamilton County, FL"
69,2018,Oct,4638,4464,174,3.8,"Hamilton County, FL"
70,2018,Nov,4298,4125,173,4.0,"Hamilton County, FL"
71,2018,Dec,4232,4054,178,4.2,"Hamilton County, FL"
72,2019,Jan,4179,3959,220,5.3,"Hamilton County, FL"
73,2019,Feb,4184,3992,192,4.6,"Hamilton County, FL"
74,2019,Mar,4253,4067,186,4.4,"Hamilton County, FL"
75,2019,Apr,4198,4042,156,3.7,"Hamilton County, FL"
76,2019,May,4260,4095,165,3.9,"Hamilton County, FL"
77,2019,Jun,4527,4337,190,4.2,"Hamilton County, FL"
78,2019,Jul,4221,4023,198,4.7,"Hamilton County, FL"
79,2019,Aug,4272,4086,186,4.4,"Hamilton County, FL"
80,2019,Sep,4405,4225,180,4.1,"Hamilton County, FL"
81,2019,Oct,4500,4322,178,4.0,"Hamilton County, FL"
82,2019,Nov,4200,4036,164,3.9,"Hamilton County, FL"
83,2019,Dec,4159,4000,159,3.8,"Hamilton County, FL"
84,2020,Jan,4191,3993,198,4.7,"Hamilton County, FL"
85,2020,Feb,4130,3971,159,3.8,"Hamilton County, FL"
86,2020,Mar,4132,3899,233,5.6,"Hamilton County, FL"
87,2020,Apr,3811,3498,313,8.2,"Hamilton County, FL"
88,2020,May,4122,3708,414,10.0,"Hamilton County, FL"
89,2020,Jun,4339,3926,413,9.5,"Hamilton County, FL"
90,2020,Jul,4363,3812,551,12.6,"Hamilton County, FL"
91,2020,Aug,4299,3855,444,10.3,"Hamilton County, FL"
92,2020,Sep,4315,3901,414,9.6,"Hamilton County, FL"
93,2020,Oct,4449,4104,345,7.8,"Hamilton County, FL"
94,2020,Nov,4248,3926,322,7.6,"Hamilton County, FL"
95,2020,Dec,4158,3836,322,7.7,"Hamilton County, FL"
96,2021,Jan,4191,3871,320,7.6,"Hamilton County, FL"
97,2021,Feb,4194,3909,285,6.8,"Hamilton County, FL"
98,2021,Mar,4195,3933,262,6.2,"Hamilton County, FL"
99,2021,Apr,4228,3964,264,6.2,"Hamilton County, FL"
100,2021,May,4247,3992,255,6.0,"Hamilton County, FL"
101,2021,Jun,4237,3966,271,6.4,"Hamilton County, FL"
102,2021,Jul,4182,3924,258,6.2,"Hamilton County, FL"
103,2021,Aug,4184,3926,258,6.2,"Hamilton County, FL"
104,2021,Sep,4239,3999,240,5.7,"Hamilton County, FL"
105,2021,Oct,4216,3990,226,5.4,"Hamilton County, FL"
106,2021,Nov,4180,3967,213,5.1,"Hamilton County, FL"
107,2021,Dec,4132,3942,190,4.6,"Hamilton County, FL"
108,2022,Jan,4144,3919,225,5.4,"Hamilton County, FL"
109,2022,Feb,4112,3923,189,4.6,"Hamilton County, FL"
110,2022,Mar,4149,3975,174,4.2,"Hamilton County, FL"
111,2022,Apr,4115,3960,155,3.8,"Hamilton County, FL"
112,2022,May,4137,3979,158,3.8,"Hamilton County, FL"
113,2022,Jun,4586,4408,178,3.9,"Hamilton County, FL"
114,2022,Jul,4302,4134,168,3.9,"Hamilton County, FL"
115,2022,Aug,4149,3981,168,4.0,"Hamilton County, FL"
116,2022,Sep,4231,4076,155,3.7,"Hamilton County, FL"
117,2022,Oct,4214,4046,168,4.0,"Hamilton County, FL"
118,2022,Nov,4145,3987,158,3.8,"Hamilton County, FL"
119,2022,Dec,4147,4018,129,3.1,"Hamilton County, FL"
120,2023,Jan,4157,4007,150,3.6,"Hamilton County, FL"
121,2023,Feb,4180,4031,149,3.6,"Hamilton County, FL"
122,2023,Mar,4223,4075,148,3.5,"Hamilton County, FL"
123,2023,Apr,4160,4029,131,3.1,"Hamilton County, FL"
124,2023,May,4211,4057,154,3.7,"Hamilton County, FL"
125,2023,Jun,4655,4476,179,3.8,"Hamilton County, FL"
126,2023,Jul,4381,4187,194,4.4,"Hamilton County, FL"
127,2023,Aug,4267,4051,216,5.1,"Hamilton County, FL"
128,2023,Sep,4334,4114,220,5.1,"Hamilton County, FL"
129,2023,Oct,4320,4102,218,5.0,"Hamilton County, FL"
0,2013,Jan,3397,2827,570,16.8,"Modoc County, CA"
1,2013,Feb,3383,2838,545,16.1,"Modoc County, CA"
2,2013,Mar,3402,2891,511,15.0,"Modoc County, CA"
3,2013,Apr,3504,3050,454,13.0,"Modoc County, CA"
4,2013,May,3536,3132,404,11.4,"Modoc County, CA"
5,2013,Jun,3751,3331,420,11.2,"Modoc County, CA"
6,2013,Jul,3623,3212,411,11.3,"Modoc County, CA"
7,2013,Aug,3655,3270,385,10.5,"Modoc County, CA"
8,2013,Sep,3528,3172,356,10.1,"Modoc County, CA"
9,2013,Oct,3544,3173,371,10.5,"Modoc County, CA"
10,2013,Nov,3309,2924,385,11.6,"Modoc County, CA"
11,2013,Dec,3270,2880,390,11.9,"Modoc County, CA"
12,2014,Jan,3272,2814,458,14.0,"Modoc County, CA"
13,2014,Feb,3279,2816,463,14.1,"Modoc County, CA"
14,2014,Mar,3314,2864,450,13.6,"Modoc County, CA"
15,2014,Apr,3440,3067,373,10.8,"Modoc County, CA"
16,2014,May,3419,3097,322,9.4,"Modoc County, CA"
17,2014,Jun,3560,3244,316,8.9,"Modoc County, CA"
18,2014,Jul,3514,3198,316,9.0,"Modoc County, CA"
19,2014,Aug,3440,3139,301,8.8,"Modoc County, CA"
20,2014,Sep,3389,3116,273,8.1,"Modoc County, CA"
21,2014,Oct,3415,3132,283,8.3,"Modoc County, CA"
22,2014,Nov,3192,2888,304,9.5,"Modoc County, CA"
23,2014,Dec,3088,2765,323,10.5,"Modoc County, CA"
24,2015,Jan,3143,2769,374,11.9,"Modoc County, CA"
25,2015,Feb,3107,2752,355,11.4,"Modoc County, CA"
26,2015,Mar,3221,2878,343,10.6,"Modoc County, CA"
27,2015,Apr,3339,3056,283,8.5,"Modoc County, CA"
28,2015,May,3363,3092,271,8.1,"Modoc County, CA"
29,2015,Jun,3522,3253,269,7.6,"Modoc County, CA"
30,2015,Jul,3480,3206,274,7.9,"Modoc County, CA"
31,2015,Aug,3420,3174,246,7.2,"Modoc County, CA"
32,2015,Sep,3394,3168,226,6.7,"Modoc County, CA"
33,2015,Oct,3358,3121,237,7.1,"Modoc County, CA"
34,2015,Nov,3194,2944,250,7.8,"Modoc County, CA"
35,2015,Dec,3099,2817,282,9.1,"Modoc County, CA"
36,2016,Jan,3111,2785,326,10.5,"Modoc County, CA"
37,2016,Feb,3110,2789,321,10.3,"Modoc County, CA"
38,2016,Mar,3245,2920,325,10.0,"Modoc County, CA"
39,2016,Apr,3303,3048,255,7.7,"Modoc County, CA"
40,2016,May,3334,3119,215,6.4,"Modoc County, CA"
41,2016,Jun,3497,3265,232,6.6,"Modoc County, CA"
42,2016,Jul,3414,3181,233,6.8,"Modoc County, CA"
43,2016,Aug,3364,3150,214,6.4,"Modoc County, CA"
44,2016,Sep,3328,3114,214,6.4,"Modoc County, CA"
45,2016,Oct,3401,3169,232,6.8,"Modoc County, CA"
46,2016,Nov,3261,3013,248,7.6,"Modoc County, CA"
47,2016,Dec,3141,2858,283,9.0,"Modoc County, CA"
48,2017,Jan,3142,2777,365,11.6,"Modoc County, CA"
49,2017,Feb,3144,2777,367,11.7,"Modoc County, CA"
50,2017,Mar,3147,2803,344,10.9,"Modoc County, CA"
51,2017,Apr,3163,2895,268,8.5,"Modoc County, CA"
52,2017,May,3245,3018,227,7.0,"Modoc County, CA"
53,2017,Jun,3320,3092,228,6.9,"Modoc County, CA"
54,2017,Jul,3258,3034,224,6.9,"Modoc County, CA"
55,2017,Aug,3287,3076,211,6.4,"Modoc County, CA"
56,2017,Sep,3237,3052,185,5.7,"Modoc County, CA"
57,2017,Oct,3254,3061,193,5.9,"Modoc County, CA"
58,2017,Nov,3085,2852,233,7.6,"Modoc County, CA"
59,2017,Dec,3027,2746,281,9.3,"Modoc County, CA"
60,2018,Jan,3064,2726,338,11.0,"Modoc County, CA"
61,2018,Feb,3086,2746,340,11.0,"Modoc County, CA"
62,2018,Mar,3074,2752,322,10.5,"Modoc County, CA"
63,2018,Apr,3089,2839,250,8.1,"Modoc County, CA"
64,2018,May,3198,2996,202,6.3,"Modoc County, CA"
65,2018,Jun,3299,3090,209,6.3,"Modoc County, CA"
66,2018,Jul,3191,2990,201,6.3,"Modoc County, CA"
67,2018,Aug,3230,3040,190,5.9,"Modoc County, CA"
68,2018,Sep,3229,3057,172,5.3,"Modoc County, CA"
69,2018,Oct,3248,3075,173,5.3,"Modoc County, CA"
70,2018,Nov,3097,2894,203,6.6,"Modoc County, CA"
71,2018,Dec,3057,2788,269,8.8,"Modoc County, CA"
72,2019,Jan,3075,2712,363,11.8,"Modoc County, CA"
73,2019,Feb,3091,2757,334,10.8,"Modoc County, CA"
74,2019,Mar,3077,2757,320,10.4,"Modoc County, CA"
75,2019,Apr,3099,2856,243,7.8,"Modoc County, CA"
76,2019,May,3226,3044,182,5.6,"Modoc County, CA"
77,2019,Jun,3350,3159,191,5.7,"Modoc County, CA"
78,2019,Jul,3281,3082,199,6.1,"Modoc County, CA"
79,2019,Aug,3272,3092,180,5.5,"Modoc County, CA"
80,2019,Sep,3195,3046,149,4.7,"Modoc County, CA"
81,2019,Oct,3275,3119,156,4.8,"Modoc County, CA"
82,2019,Nov,3175,2992,183,5.8,"Modoc County, CA"
83,2019,Dec,3043,2817,226,7.4,"Modoc County, CA"
84,2020,Jan,3061,2754,307,10.0,"Modoc County, CA"
85,2020,Feb,3130,2832,298,9.5,"Modoc County, CA"
86,2020,Mar,3280,2869,411,12.5,"Modoc County, CA"
87,2020,Apr,3222,2795,427,13.3,"Modoc County, CA"
88,2020,May,3114,2798,316,10.1,"Modoc County, CA"
89,2020,Jun,3324,3046,278,8.4,"Modoc County, CA"
90,2020,Jul,3230,2978,252,7.8,"Modoc County, CA"
91,2020,Aug,3243,3038,205,6.3,"Modoc County, CA"
92,2020,Sep,3240,3044,196,6.0,"Modoc County, CA"
93,2020,Oct,3248,3058,190,5.8,"Modoc County, CA"
94,2020,Nov,3129,2913,216,6.9,"Modoc County, CA"
95,2020,Dec,3012,2744,268,8.9,"Modoc County, CA"
96,2021,Jan,3060,2744,316,10.3,"Modoc County, CA"
97,2021,Feb,3069,2745,324,10.6,"Modoc County, CA"
98,2021,Mar,3118,2794,324,10.4,"Modoc County, CA"
99,2021,Apr,3197,2936,261,8.2,"Modoc County, CA"
100,2021,May,3241,3037,204,6.3,"Modoc County, CA"
101,2021,Jun,3339,3121,218,6.5,"Modoc County, CA"
102,2021,Jul,3277,3061,216,6.6,"Modoc County, CA"
103,2021,Aug,3313,3110,203,6.1,"Modoc County, CA"
104,2021,Sep,3280,3110,170,5.2,"Modoc County, CA"
105,2021,Oct,3280,3115,165,5.0,"Modoc County, CA"
106,2021,Nov,3123,2956,167,5.3,"Modoc County, CA"
107,2021,Dec,3045,2858,187,6.1,"Modoc County, CA"
108,2022,Jan,3065,2806,259,8.5,"Modoc County, CA"
109,2022,Feb,3098,2846,252,8.1,"Modoc County, CA"
110,2022,Mar,3149,2928,221,7.0,"Modoc County, CA"
111,2022,Apr,3175,3004,171,5.4,"Modoc County, CA"
112,2022,May,3186,3051,135,4.2,"Modoc County, CA"
113,2022,Jun,3262,3114,148,4.5,"Modoc County, CA"
114,2022,Jul,3230,3085,145,4.5,"Modoc County, CA"
115,2022,Aug,3272,3128,144,4.4,"Modoc County, CA"
116,2022,Sep,3195,3069,126,3.9,"Modoc County, CA"
117,2022,Oct,3236,3105,131,4.0,"Modoc County, CA"
118,2022,Nov,3163,3003,160,5.1,"Modoc County, CA"
119,2022,Dec,3089,2894,195,6.3,"Modoc County, CA"
120,2023,Jan,3121,2837,284,9.1,"Modoc County, CA"
121,2023,Feb,3159,2870,289,9.1,"Modoc County, CA"
122,2023,Mar,3190,2901,289,9.1,"Modoc County, CA"
123,2023,Apr,3151,2933,218,6.9,"Modoc County, CA"
124,2023,May,3216,3023,193,6.0,"Modoc County, CA"
125,2023,Jun,3264,3090,174,5.3,"Modoc County, CA"
126,2023,Jul,3210,3056,154,4.8,"Modoc County, CA"
127,2023,Aug,3237,3073,164,5.1,"Modoc County, CA"
128,2023,Sep,3248,3094,154,4.7,"Modoc County, CA"
129,2023,Oct,3244,3093,151,4.7,"Modoc County, CA"
0,2013,Jan,5062,4692,370,7.3,"Union County, FL"
1,2013,Feb,5010,4669,341,6.8,"Union County, FL"
2,2013,Mar,4970,4644,326,6.6,"Union County, FL"
3,2013,Apr,4945,4639,306,6.2,"Union County, FL"
4,2013,May,5044,4724,320,6.3,"Union County, FL"
5,2013,Jun,5016,4664,352,7.0,"Union County, FL"
6,2013,Jul,4976,4629,347,7.0,"Union County, FL"
7,2013,Aug,4948,4630,318,6.4,"Union County, FL"
8,2013,Sep,5011,4695,316,6.3,"Union County, FL"
9,2013,Oct,5008,4695,313,6.3,"Union County, FL"
10,2013,Nov,4901,4584,317,6.5,"Union County, FL"
11,2013,Dec,4731,4429,302,6.4,"Union County, FL"
12,2014,Jan,4765,4451,314,6.6,"Union County, FL"
13,2014,Feb,4794,4494,300,6.3,"Union County, FL"
14,2014,Mar,4754,4465,289,6.1,"Union County, FL"
15,2014,Apr,4698,4439,259,5.5,"Union County, FL"
16,2014,May,4731,4443,288,6.1,"Union County, FL"
17,2014,Jun,4680,4372,308,6.6,"Union County, FL"
18,2014,Jul,4697,4377,320,6.8,"Union County, FL"
19,2014,Aug,4694,4380,314,6.7,"Union County, FL"
20,2014,Sep,4781,4495,286,6.0,"Union County, FL"
21,2014,Oct,4802,4527,275,5.7,"Union County, FL"
22,2014,Nov,4674,4397,277,5.9,"Union County, FL"
23,2014,Dec,4643,4387,256,5.5,"Union County, FL"
24,2015,Jan,4695,4420,275,5.9,"Union County, FL"
25,2015,Feb,4662,4424,238,5.1,"Union County, FL"
26,2015,Mar,4679,4449,230,4.9,"Union County, FL"
27,2015,Apr,4707,4487,220,4.7,"Union County, FL"
28,2015,May,4824,4587,237,4.9,"Union County, FL"
29,2015,Jun,4757,4509,248,5.2,"Union County, FL"
30,2015,Jul,4754,4506,248,5.2,"Union County, FL"
31,2015,Aug,4777,4549,228,4.8,"Union County, FL"
32,2015,Sep,4887,4664,223,4.6,"Union County, FL"
33,2015,Oct,4808,4595,213,4.4,"Union County, FL"
34,2015,Nov,4749,4527,222,4.7,"Union County, FL"
35,2015,Dec,4744,4528,216,4.6,"Union County, FL"
36,2016,Jan,4772,4538,234,4.9,"Union County, FL"
37,2016,Feb,4789,4579,210,4.4,"Union County, FL"
38,2016,Mar,4762,4555,207,4.3,"Union County, FL"
39,2016,Apr,4766,4571,195,4.1,"Union County, FL"
40,2016,May,4811,4612,199,4.1,"Union County, FL"
41,2016,Jun,4755,4526,229,4.8,"Union County, FL"
42,2016,Jul,4794,4573,221,4.6,"Union County, FL"
43,2016,Aug,4895,4675,220,4.5,"Union County, FL"
44,2016,Sep,4961,4738,223,4.5,"Union County, FL"
45,2016,Oct,4868,4663,205,4.2,"Union County, FL"
46,2016,Nov,4794,4600,194,4.0,"Union County, FL"
47,2016,Dec,4771,4586,185,3.9,"Union County, FL"
48,2017,Jan,4878,4668,210,4.3,"Union County, FL"
49,2017,Feb,4855,4669,186,3.8,"Union County, FL"
50,2017,Mar,4853,4676,177,3.6,"Union County, FL"
51,2017,Apr,4856,4690,166,3.4,"Union County, FL"
52,2017,May,4849,4683,166,3.4,"Union County, FL"
53,2017,Jun,4805,4609,196,4.1,"Union County, FL"
54,2017,Jul,4689,4491,198,4.2,"Union County, FL"
55,2017,Aug,4714,4526,188,4.0,"Union County, FL"
56,2017,Sep,4866,4685,181,3.7,"Union County, FL"
57,2017,Oct,4691,4517,174,3.7,"Union County, FL"
58,2017,Nov,4620,4441,179,3.9,"Union County, FL"
59,2017,Dec,4623,4460,163,3.5,"Union County, FL"
60,2018,Jan,4643,4464,179,3.9,"Union County, FL"
61,2018,Feb,4637,4483,154,3.3,"Union County, FL"
62,2018,Mar,4620,4465,155,3.4,"Union County, FL"
63,2018,Apr,4575,4436,139,3.0,"Union County, FL"
64,2018,May,4559,4423,136,3.0,"Union County, FL"
65,2018,Jun,4534,4370,164,3.6,"Union County, FL"
66,2018,Jul,4430,4262,168,3.8,"Union County, FL"
67,2018,Aug,4532,4374,158,3.5,"Union County, FL"
68,2018,Sep,4684,4537,147,3.1,"Union County, FL"
69,2018,Oct,4655,4506,149,3.2,"Union County, FL"
70,2018,Nov,4576,4439,137,3.0,"Union County, FL"
71,2018,Dec,4557,4424,133,2.9,"Union County, FL"
72,2019,Jan,4523,4357,166,3.7,"Union County, FL"
73,2019,Feb,4520,4382,138,3.1,"Union County, FL"
74,2019,Mar,4518,4382,136,3.0,"Union County, FL"
75,2019,Apr,4593,4470,123,2.7,"Union County, FL"
76,2019,May,4600,4474,126,2.7,"Union County, FL"
77,2019,Jun,4560,4404,156,3.4,"Union County, FL"
78,2019,Jul,4508,4347,161,3.6,"Union County, FL"
79,2019,Aug,4636,4486,150,3.2,"Union County, FL"
80,2019,Sep,4722,4585,137,2.9,"Union County, FL"
81,2019,Oct,4643,4505,138,3.0,"Union County, FL"
82,2019,Nov,4576,4446,130,2.8,"Union County, FL"
83,2019,Dec,4570,4448,122,2.7,"Union County, FL"
84,2020,Jan,4610,4467,143,3.1,"Union County, FL"
85,2020,Feb,4627,4511,116,2.5,"Union County, FL"
86,2020,Mar,4541,4377,164,3.6,"Union County, FL"
87,2020,Apr,4414,4150,264,6.0,"Union County, FL"
88,2020,May,4467,4170,297,6.6,"Union County, FL"
89,2020,Jun,4415,4146,269,6.1,"Union County, FL"
90,2020,Jul,4459,4118,341,7.6,"Union County, FL"
91,2020,Aug,4573,4324,249,5.4,"Union County, FL"
92,2020,Sep,4625,4394,231,5.0,"Union County, FL"
93,2020,Oct,4651,4427,224,4.8,"Union County, FL"
94,2020,Nov,4572,4353,219,4.8,"Union County, FL"
95,2020,Dec,4531,4327,204,4.5,"Union County, FL"
96,2021,Jan,4529,4312,217,4.8,"Union County, FL"
97,2021,Feb,4569,4366,203,4.4,"Union County, FL"
98,2021,Mar,4588,4412,176,3.8,"Union County, FL"
99,2021,Apr,4540,4365,175,3.9,"Union County, FL"
100,2021,May,4542,4372,170,3.7,"Union County, FL"
101,2021,Jun,4413,4217,196,4.4,"Union County, FL"
102,2021,Jul,4405,4214,191,4.3,"Union County, FL"
103,2021,Aug,4425,4244,181,4.1,"Union County, FL"
104,2021,Sep,4517,4356,161,3.6,"Union County, FL"
105,2021,Oct,4421,4271,150,3.4,"Union County, FL"
106,2021,Nov,4506,4365,141,3.1,"Union County, FL"
107,2021,Dec,4487,4368,119,2.7,"Union County, FL"
108,2022,Jan,4566,4415,151,3.3,"Union County, FL"
109,2022,Feb,4506,4379,127,2.8,"Union County, FL"
110,2022,Mar,4492,4372,120,2.7,"Union County, FL"
111,2022,Apr,4462,4353,109,2.4,"Union County, FL"
112,2022,May,4487,4368,119,2.7,"Union County, FL"
113,2022,Jun,4412,4269,143,3.2,"Union County, FL"
114,2022,Jul,4402,4258,144,3.3,"Union County, FL"
115,2022,Aug,4547,4405,142,3.1,"Union County, FL"
116,2022,Sep,4637,4495,142,3.1,"Union County, FL"
117,2022,Oct,4597,4452,145,3.2,"Union County, FL"
118,2022,Nov,4549,4416,133,2.9,"Union County, FL"
119,2022,Dec,4556,4450,106,2.3,"Union County, FL"
120,2023,Jan,4552,4436,116,2.5,"Union County, FL"
121,2023,Feb,4573,4452,121,2.6,"Union County, FL"
122,2023,Mar,4585,4469,116,2.5,"Union County, FL"
123,2023,Apr,4590,4488,102,2.2,"Union County, FL"
124,2023,May,4619,4487,132,2.9,"Union County, FL"
125,2023,Jun,4603,4461,142,3.1,"Union County, FL"
126,2023,Jul,4593,4443,150,3.3,"Union County, FL"
127,2023,Aug,4694,4542,152,3.2,"Union County, FL"
128,2023,Sep,4744,4601,143,3.0,"Union County, FL"
129,2023,Oct,4723,4570,153,3.2,"Union County, FL"
0,2013,Jan,35493,32529,2964,8.4,"Nassau County, FL"
1,2013,Feb,35444,32744,2700,7.6,"Nassau County, FL"
2,2013,Mar,35483,32974,2509,7.1,"Nassau County, FL"
3,2013,Apr,35598,33184,2414,6.8,"Nassau County, FL"
4,2013,May,36171,33672,2499,6.9,"Nassau County, FL"
5,2013,Jun,36506,33840,2666,7.3,"Nassau County, FL"
6,2013,Jul,36736,34106,2630,7.2,"Nassau County, FL"
7,2013,Aug,36527,34005,2522,6.9,"Nassau County, FL"
8,2013,Sep,36677,34198,2479,6.8,"Nassau County, FL"
9,2013,Oct,36314,33886,2428,6.7,"Nassau County, FL"
10,2013,Nov,35988,33644,2344,6.5,"Nassau County, FL"
11,2013,Dec,35955,33726,2229,6.2,"Nassau County, FL"
12,2014,Jan,35514,33164,2350,6.6,"Nassau County, FL"
13,2014,Feb,35685,33379,2306,6.5,"Nassau County, FL"
14,2014,Mar,35895,33619,2276,6.3,"Nassau County, FL"
15,2014,Apr,35750,33702,2048,5.7,"Nassau County, FL"
16,2014,May,36291,34085,2206,6.1,"Nassau County, FL"
17,2014,Jun,36484,34179,2305,6.3,"Nassau County, FL"
18,2014,Jul,36646,34236,2410,6.6,"Nassau County, FL"
19,2014,Aug,36561,34217,2344,6.4,"Nassau County, FL"
20,2014,Sep,36547,34358,2189,6.0,"Nassau County, FL"
21,2014,Oct,36665,34548,2117,5.8,"Nassau County, FL"
22,2014,Nov,36218,34126,2092,5.8,"Nassau County, FL"
23,2014,Dec,36243,34253,1990,5.5,"Nassau County, FL"
24,2015,Jan,36166,33976,2190,6.1,"Nassau County, FL"
25,2015,Feb,36151,34158,1993,5.5,"Nassau County, FL"
26,2015,Mar,36281,34392,1889,5.2,"Nassau County, FL"
27,2015,Apr,36339,34521,1818,5.0,"Nassau County, FL"
28,2015,May,36884,34926,1958,5.3,"Nassau County, FL"
29,2015,Jun,37036,35047,1989,5.4,"Nassau County, FL"
30,2015,Jul,37092,35103,1989,5.4,"Nassau County, FL"
31,2015,Aug,36975,35061,1914,5.2,"Nassau County, FL"
32,2015,Sep,36998,35193,1805,4.9,"Nassau County, FL"
33,2015,Oct,37027,35222,1805,4.9,"Nassau County, FL"
34,2015,Nov,36708,34923,1785,4.9,"Nassau County, FL"
35,2015,Dec,36773,35052,1721,4.7,"Nassau County, FL"
36,2016,Jan,37019,35174,1845,5.0,"Nassau County, FL"
37,2016,Feb,37196,35504,1692,4.5,"Nassau County, FL"
38,2016,Mar,37340,35682,1658,4.4,"Nassau County, FL"
39,2016,Apr,37410,35788,1622,4.3,"Nassau County, FL"
40,2016,May,37872,36269,1603,4.2,"Nassau County, FL"
41,2016,Jun,38147,36383,1764,4.6,"Nassau County, FL"
42,2016,Jul,38439,36610,1829,4.8,"Nassau County, FL"
43,2016,Aug,38396,36572,1824,4.8,"Nassau County, FL"
44,2016,Sep,38622,36797,1825,4.7,"Nassau County, FL"
45,2016,Oct,38315,36590,1725,4.5,"Nassau County, FL"
46,2016,Nov,38034,36376,1658,4.4,"Nassau County, FL"
47,2016,Dec,37966,36364,1602,4.2,"Nassau County, FL"
48,2017,Jan,37987,36195,1792,4.7,"Nassau County, FL"
49,2017,Feb,38160,36526,1634,4.3,"Nassau County, FL"
50,2017,Mar,38261,36740,1521,4.0,"Nassau County, FL"
51,2017,Apr,38419,36975,1444,3.8,"Nassau County, FL"
52,2017,May,38781,37293,1488,3.8,"Nassau County, FL"
53,2017,Jun,39158,37542,1616,4.1,"Nassau County, FL"
54,2017,Jul,39395,37764,1631,4.1,"Nassau County, FL"
55,2017,Aug,39143,37497,1646,4.2,"Nassau County, FL"
56,2017,Sep,39373,37916,1457,3.7,"Nassau County, FL"
57,2017,Oct,39200,37771,1429,3.6,"Nassau County, FL"
58,2017,Nov,39110,37671,1439,3.7,"Nassau County, FL"
59,2017,Dec,39034,37685,1349,3.5,"Nassau County, FL"
60,2018,Jan,39636,38124,1512,3.8,"Nassau County, FL"
61,2018,Feb,39745,38369,1376,3.5,"Nassau County, FL"
62,2018,Mar,39762,38442,1320,3.3,"Nassau County, FL"
63,2018,Apr,39736,38501,1235,3.1,"Nassau County, FL"
64,2018,May,40162,38922,1240,3.1,"Nassau County, FL"
65,2018,Jun,40639,39157,1482,3.6,"Nassau County, FL"
66,2018,Jul,40720,39325,1395,3.4,"Nassau County, FL"
67,2018,Aug,40480,39122,1358,3.4,"Nassau County, FL"
68,2018,Sep,40712,39458,1254,3.1,"Nassau County, FL"
69,2018,Oct,40571,39288,1283,3.2,"Nassau County, FL"
70,2018,Nov,40363,39126,1237,3.1,"Nassau County, FL"
71,2018,Dec,40399,39181,1218,3.0,"Nassau County, FL"
72,2019,Jan,40804,39335,1469,3.6,"Nassau County, FL"
73,2019,Feb,40807,39549,1258,3.1,"Nassau County, FL"
74,2019,Mar,40811,39572,1239,3.0,"Nassau County, FL"
75,2019,Apr,40801,39694,1107,2.7,"Nassau County, FL"
76,2019,May,41296,40148,1148,2.8,"Nassau County, FL"
77,2019,Jun,41829,40479,1350,3.2,"Nassau County, FL"
78,2019,Jul,42127,40729,1398,3.3,"Nassau County, FL"
79,2019,Aug,42131,40767,1364,3.2,"Nassau County, FL"
80,2019,Sep,42289,41086,1203,2.8,"Nassau County, FL"
81,2019,Oct,42235,41029,1206,2.9,"Nassau County, FL"
82,2019,Nov,42023,40859,1164,2.8,"Nassau County, FL"
83,2019,Dec,42052,40962,1090,2.6,"Nassau County, FL"
84,2020,Jan,42319,41024,1295,3.1,"Nassau County, FL"
85,2020,Feb,42309,41220,1089,2.6,"Nassau County, FL"
86,2020,Mar,41544,39958,1586,3.8,"Nassau County, FL"
87,2020,Apr,38589,34443,4146,10.7,"Nassau County, FL"
88,2020,May,40981,36753,4228,10.3,"Nassau County, FL"
89,2020,Jun,41276,37905,3371,8.2,"Nassau County, FL"
90,2020,Jul,41993,38493,3500,8.3,"Nassau County, FL"
91,2020,Aug,41740,39347,2393,5.7,"Nassau County, FL"
92,2020,Sep,42187,39939,2248,5.3,"Nassau County, FL"
93,2020,Oct,42277,40343,1934,4.6,"Nassau County, FL"
94,2020,Nov,42125,40260,1865,4.4,"Nassau County, FL"
95,2020,Dec,42170,40354,1816,4.3,"Nassau County, FL"
96,2021,Jan,41882,40041,1841,4.4,"Nassau County, FL"
97,2021,Feb,41993,40301,1692,4.0,"Nassau County, FL"
98,2021,Mar,42116,40517,1599,3.8,"Nassau County, FL"
99,2021,Apr,42157,40705,1452,3.4,"Nassau County, FL"
100,2021,May,42577,41177,1400,3.3,"Nassau County, FL"
101,2021,Jun,43026,41314,1712,4.0,"Nassau County, FL"
102,2021,Jul,43218,41588,1630,3.8,"Nassau County, FL"
103,2021,Aug,43276,41714,1562,3.6,"Nassau County, FL"
104,2021,Sep,43528,42138,1390,3.2,"Nassau County, FL"
105,2021,Oct,43584,42255,1329,3.0,"Nassau County, FL"
106,2021,Nov,43604,42335,1269,2.9,"Nassau County, FL"
107,2021,Dec,43694,42553,1141,2.6,"Nassau County, FL"
108,2022,Jan,43799,42364,1435,3.3,"Nassau County, FL"
109,2022,Feb,43785,42539,1246,2.8,"Nassau County, FL"
110,2022,Mar,44022,42880,1142,2.6,"Nassau County, FL"
111,2022,Apr,44033,43032,1001,2.3,"Nassau County, FL"
112,2022,May,44553,43504,1049,2.4,"Nassau County, FL"
113,2022,Jun,44830,43602,1228,2.7,"Nassau County, FL"
114,2022,Jul,45080,43905,1175,2.6,"Nassau County, FL"
115,2022,Aug,45171,43984,1187,2.6,"Nassau County, FL"
116,2022,Sep,45340,44236,1104,2.4,"Nassau County, FL"
117,2022,Oct,45345,44268,1077,2.4,"Nassau County, FL"
118,2022,Nov,45062,43977,1085,2.4,"Nassau County, FL"
119,2022,Dec,45462,44520,942,2.1,"Nassau County, FL"
120,2023,Jan,45467,44377,1090,2.4,"Nassau County, FL"
121,2023,Feb,45934,44836,1098,2.4,"Nassau County, FL"
122,2023,Mar,46188,45067,1121,2.4,"Nassau County, FL"
123,2023,Apr,46083,45076,1007,2.2,"Nassau County, FL"
124,2023,May,46406,45239,1167,2.5,"Nassau County, FL"
125,2023,Jun,47226,45910,1316,2.8,"Nassau County, FL"
126,2023,Jul,47351,45993,1358,2.9,"Nassau County, FL"
127,2023,Aug,47722,46339,1383,2.9,"Nassau County, FL"
128,2023,Sep,47827,46412,1415,3.0,"Nassau County, FL"
129,2023,Oct,47844,46426,1418,3.0,"Nassau County, FL"
0,2013,Jan,17970,16454,1516,8.4,"Suwannee County, FL"
1,2013,Feb,17803,16424,1379,7.7,"Suwannee County, FL"
2,2013,Mar,17905,16606,1299,7.3,"Suwannee County, FL"
3,2013,Apr,17845,16621,1224,6.9,"Suwannee County, FL"
4,2013,May,18314,17045,1269,6.9,"Suwannee County, FL"
5,2013,Jun,18497,17129,1368,7.4,"Suwannee County, FL"
6,2013,Jul,17968,16606,1362,7.6,"Suwannee County, FL"
7,2013,Aug,17993,16676,1317,7.3,"Suwannee County, FL"
8,2013,Sep,18279,17019,1260,6.9,"Suwannee County, FL"
9,2013,Oct,18184,16937,1247,6.9,"Suwannee County, FL"
10,2013,Nov,18000,16781,1219,6.8,"Suwannee County, FL"
11,2013,Dec,17573,16414,1159,6.6,"Suwannee County, FL"
12,2014,Jan,17491,16243,1248,7.1,"Suwannee County, FL"
13,2014,Feb,17490,16263,1227,7.0,"Suwannee County, FL"
14,2014,Mar,17652,16462,1190,6.7,"Suwannee County, FL"
15,2014,Apr,17776,16725,1051,5.9,"Suwannee County, FL"
16,2014,May,18196,17053,1143,6.3,"Suwannee County, FL"
17,2014,Jun,18254,17059,1195,6.5,"Suwannee County, FL"
18,2014,Jul,18138,16869,1269,7.0,"Suwannee County, FL"
19,2014,Aug,18222,17001,1221,6.7,"Suwannee County, FL"
20,2014,Sep,18368,17241,1127,6.1,"Suwannee County, FL"
21,2014,Oct,18114,17010,1104,6.1,"Suwannee County, FL"
22,2014,Nov,17939,16823,1116,6.2,"Suwannee County, FL"
23,2014,Dec,17689,16628,1061,6.0,"Suwannee County, FL"
24,2015,Jan,17732,16607,1125,6.3,"Suwannee County, FL"
25,2015,Feb,17604,16563,1041,5.9,"Suwannee County, FL"
26,2015,Mar,17829,16852,977,5.5,"Suwannee County, FL"
27,2015,Apr,17978,17029,949,5.3,"Suwannee County, FL"
28,2015,May,18408,17401,1007,5.5,"Suwannee County, FL"
29,2015,Jun,17922,16882,1040,5.8,"Suwannee County, FL"
30,2015,Jul,17855,16824,1031,5.8,"Suwannee County, FL"
31,2015,Aug,18251,17259,992,5.4,"Suwannee County, FL"
32,2015,Sep,18333,17390,943,5.1,"Suwannee County, FL"
33,2015,Oct,18215,17268,947,5.2,"Suwannee County, FL"
34,2015,Nov,18001,17069,932,5.2,"Suwannee County, FL"
35,2015,Dec,17925,17021,904,5.0,"Suwannee County, FL"
36,2016,Jan,17830,16879,951,5.3,"Suwannee County, FL"
37,2016,Feb,17947,17072,875,4.9,"Suwannee County, FL"
38,2016,Mar,18020,17148,872,4.8,"Suwannee County, FL"
39,2016,Apr,18171,17315,856,4.7,"Suwannee County, FL"
40,2016,May,18322,17480,842,4.6,"Suwannee County, FL"
41,2016,Jun,18361,17404,957,5.2,"Suwannee County, FL"
42,2016,Jul,18175,17219,956,5.3,"Suwannee County, FL"
43,2016,Aug,18616,17668,948,5.1,"Suwannee County, FL"
44,2016,Sep,18672,17737,935,5.0,"Suwannee County, FL"
45,2016,Oct,18558,17652,906,4.9,"Suwannee County, FL"
46,2016,Nov,18252,17389,863,4.7,"Suwannee County, FL"
47,2016,Dec,17991,17136,855,4.8,"Suwannee County, FL"
48,2017,Jan,18113,17181,932,5.1,"Suwannee County, FL"
49,2017,Feb,18117,17251,866,4.8,"Suwannee County, FL"
50,2017,Mar,18189,17381,808,4.4,"Suwannee County, FL"
51,2017,Apr,18174,17429,745,4.1,"Suwannee County, FL"
52,2017,May,18421,17667,754,4.1,"Suwannee County, FL"
53,2017,Jun,18761,17947,814,4.3,"Suwannee County, FL"
54,2017,Jul,18017,17189,828,4.6,"Suwannee County, FL"
55,2017,Aug,18320,17503,817,4.5,"Suwannee County, FL"
56,2017,Sep,18278,17528,750,4.1,"Suwannee County, FL"
57,2017,Oct,18232,17517,715,3.9,"Suwannee County, FL"
58,2017,Nov,17912,17165,747,4.2,"Suwannee County, FL"
59,2017,Dec,17870,17167,703,3.9,"Suwannee County, FL"
60,2018,Jan,17962,17185,777,4.3,"Suwannee County, FL"
61,2018,Feb,17938,17221,717,4.0,"Suwannee County, FL"
62,2018,Mar,17933,17230,703,3.9,"Suwannee County, FL"
63,2018,Apr,18011,17368,643,3.6,"Suwannee County, FL"
64,2018,May,18203,17578,625,3.4,"Suwannee County, FL"
65,2018,Jun,18649,17897,752,4.0,"Suwannee County, FL"
66,2018,Jul,17880,17146,734,4.1,"Suwannee County, FL"
67,2018,Aug,18241,17536,705,3.9,"Suwannee County, FL"
68,2018,Sep,18226,17581,645,3.5,"Suwannee County, FL"
69,2018,Oct,18132,17488,644,3.6,"Suwannee County, FL"
70,2018,Nov,17730,17111,619,3.5,"Suwannee County, FL"
71,2018,Dec,17743,17113,630,3.6,"Suwannee County, FL"
72,2019,Jan,17938,17212,726,4.0,"Suwannee County, FL"
73,2019,Feb,17914,17282,632,3.5,"Suwannee County, FL"
74,2019,Mar,17899,17277,622,3.5,"Suwannee County, FL"
75,2019,Apr,17990,17440,550,3.1,"Suwannee County, FL"
76,2019,May,18176,17606,570,3.1,"Suwannee County, FL"
77,2019,Jun,18534,17876,658,3.6,"Suwannee County, FL"
78,2019,Jul,17856,17159,697,3.9,"Suwannee County, FL"
79,2019,Aug,18400,17687,713,3.9,"Suwannee County, FL"
80,2019,Sep,18513,17891,622,3.4,"Suwannee County, FL"
81,2019,Oct,18559,17945,614,3.3,"Suwannee County, FL"
82,2019,Nov,18201,17625,576,3.2,"Suwannee County, FL"
83,2019,Dec,18106,17556,550,3.0,"Suwannee County, FL"
84,2020,Jan,18125,17490,635,3.5,"Suwannee County, FL"
85,2020,Feb,18124,17582,542,3.0,"Suwannee County, FL"
86,2020,Mar,17696,16918,778,4.4,"Suwannee County, FL"
87,2020,Apr,16397,15205,1192,7.3,"Suwannee County, FL"
88,2020,May,17566,16171,1395,7.9,"Suwannee County, FL"
89,2020,Jun,17894,16541,1353,7.6,"Suwannee County, FL"
90,2020,Jul,17387,15781,1606,9.2,"Suwannee County, FL"
91,2020,Aug,17812,16655,1157,6.5,"Suwannee County, FL"
92,2020,Sep,17990,16856,1134,6.3,"Suwannee County, FL"
93,2020,Oct,17828,16811,1017,5.7,"Suwannee County, FL"
94,2020,Nov,17656,16686,970,5.5,"Suwannee County, FL"
95,2020,Dec,17507,16585,922,5.3,"Suwannee County, FL"
96,2021,Jan,17096,16148,948,5.5,"Suwannee County, FL"
97,2021,Feb,17364,16468,896,5.2,"Suwannee County, FL"
98,2021,Mar,17437,16606,831,4.8,"Suwannee County, FL"
99,2021,Apr,17377,16590,787,4.5,"Suwannee County, FL"
100,2021,May,17399,16643,756,4.3,"Suwannee County, FL"
101,2021,Jun,17424,16513,911,5.2,"Suwannee County, FL"
102,2021,Jul,17209,16338,871,5.1,"Suwannee County, FL"
103,2021,Aug,17231,16406,825,4.8,"Suwannee County, FL"
104,2021,Sep,17422,16647,775,4.4,"Suwannee County, FL"
105,2021,Oct,17413,16697,716,4.1,"Suwannee County, FL"
106,2021,Nov,17457,16796,661,3.8,"Suwannee County, FL"
107,2021,Dec,17273,16698,575,3.3,"Suwannee County, FL"
108,2022,Jan,17251,16524,727,4.2,"Suwannee County, FL"
109,2022,Feb,17337,16730,607,3.5,"Suwannee County, FL"
110,2022,Mar,17430,16875,555,3.2,"Suwannee County, FL"
111,2022,Apr,17310,16797,513,3.0,"Suwannee County, FL"
112,2022,May,17554,17001,553,3.2,"Suwannee County, FL"
113,2022,Jun,17400,16776,624,3.6,"Suwannee County, FL"
114,2022,Jul,17446,16853,593,3.4,"Suwannee County, FL"
115,2022,Aug,17680,17091,589,3.3,"Suwannee County, FL"
116,2022,Sep,17852,17307,545,3.1,"Suwannee County, FL"
117,2022,Oct,17795,17254,541,3.0,"Suwannee County, FL"
118,2022,Nov,17666,17138,528,3.0,"Suwannee County, FL"
119,2022,Dec,17650,17211,439,2.5,"Suwannee County, FL"
120,2023,Jan,17691,17167,524,3.0,"Suwannee County, FL"
121,2023,Feb,17802,17283,519,2.9,"Suwannee County, FL"
122,2023,Mar,17910,17394,516,2.9,"Suwannee County, FL"
123,2023,Apr,17709,17234,475,2.7,"Suwannee County, FL"
124,2023,May,17955,17395,560,3.1,"Suwannee County, FL"
125,2023,Jun,18306,17682,624,3.4,"Suwannee County, FL"
126,2023,Jul,18020,17368,652,3.6,"Suwannee County, FL"
127,2023,Aug,18333,17651,682,3.7,"Suwannee County, FL"
128,2023,Sep,18368,17690,678,3.7,"Suwannee County, FL"
129,2023,Oct,18372,17693,679,3.7,"Suwannee County, FL"
0,2013,Jan,28097,24516,3581,12.7,"Putnam County, FL"
1,2013,Feb,28035,24741,3294,11.7,"Putnam County, FL"
2,2013,Mar,27975,24875,3100,11.1,"Putnam County, FL"
3,2013,Apr,28698,25726,2972,10.4,"Putnam County, FL"
4,2013,May,29042,26017,3025,10.4,"Putnam County, FL"
5,2013,Jun,28569,25357,3212,11.2,"Putnam County, FL"
6,2013,Jul,28055,24893,3162,11.3,"Putnam County, FL"
7,2013,Aug,28059,24974,3085,11.0,"Putnam County, FL"
8,2013,Sep,28031,25094,2937,10.5,"Putnam County, FL"
9,2013,Oct,27990,25100,2890,10.3,"Putnam County, FL"
10,2013,Nov,27829,25074,2755,9.9,"Putnam County, FL"
11,2013,Dec,27766,25122,2644,9.5,"Putnam County, FL"
12,2014,Jan,27980,25198,2782,9.9,"Putnam County, FL"
13,2014,Feb,28031,25321,2710,9.7,"Putnam County, FL"
14,2014,Mar,28005,25377,2628,9.4,"Putnam County, FL"
15,2014,Apr,28559,26192,2367,8.3,"Putnam County, FL"
16,2014,May,29083,26591,2492,8.6,"Putnam County, FL"
17,2014,Jun,28129,25578,2551,9.1,"Putnam County, FL"
18,2014,Jul,27503,24861,2642,9.6,"Putnam County, FL"
19,2014,Aug,27326,24723,2603,9.5,"Putnam County, FL"
20,2014,Sep,27582,25180,2402,8.7,"Putnam County, FL"
21,2014,Oct,27723,25374,2349,8.5,"Putnam County, FL"
22,2014,Nov,27495,25158,2337,8.5,"Putnam County, FL"
23,2014,Dec,27656,25443,2213,8.0,"Putnam County, FL"
24,2015,Jan,27641,25223,2418,8.7,"Putnam County, FL"
25,2015,Feb,27518,25241,2277,8.3,"Putnam County, FL"
26,2015,Mar,27347,25170,2177,8.0,"Putnam County, FL"
27,2015,Apr,28067,25989,2078,7.4,"Putnam County, FL"
28,2015,May,28294,26109,2185,7.7,"Putnam County, FL"
29,2015,Jun,27004,24773,2231,8.3,"Putnam County, FL"
30,2015,Jul,26310,24085,2225,8.5,"Putnam County, FL"
31,2015,Aug,26963,24866,2097,7.8,"Putnam County, FL"
32,2015,Sep,27182,25205,1977,7.3,"Putnam County, FL"
33,2015,Oct,27128,25189,1939,7.1,"Putnam County, FL"
34,2015,Nov,27166,25279,1887,6.9,"Putnam County, FL"
35,2015,Dec,27897,26064,1833,6.6,"Putnam County, FL"
36,2016,Jan,27469,25560,1909,6.9,"Putnam County, FL"
37,2016,Feb,26673,24881,1792,6.7,"Putnam County, FL"
38,2016,Mar,27050,25327,1723,6.4,"Putnam County, FL"
39,2016,Apr,27370,25748,1622,5.9,"Putnam County, FL"
40,2016,May,27727,26104,1623,5.9,"Putnam County, FL"
41,2016,Jun,26733,24913,1820,6.8,"Putnam County, FL"
42,2016,Jul,26172,24309,1863,7.1,"Putnam County, FL"
43,2016,Aug,26989,25159,1830,6.8,"Putnam County, FL"
44,2016,Sep,27300,25537,1763,6.5,"Putnam County, FL"
45,2016,Oct,27294,25606,1688,6.2,"Putnam County, FL"
46,2016,Nov,26592,24953,1639,6.2,"Putnam County, FL"
47,2016,Dec,27481,25883,1598,5.8,"Putnam County, FL"
48,2017,Jan,26920,25216,1704,6.3,"Putnam County, FL"
49,2017,Feb,26940,25381,1559,5.8,"Putnam County, FL"
50,2017,Mar,27116,25654,1462,5.4,"Putnam County, FL"
51,2017,Apr,26973,25599,1374,5.1,"Putnam County, FL"
52,2017,May,27600,26196,1404,5.1,"Putnam County, FL"
53,2017,Jun,26635,25087,1548,5.8,"Putnam County, FL"
54,2017,Jul,26534,24961,1573,5.9,"Putnam County, FL"
55,2017,Aug,26997,25409,1588,5.9,"Putnam County, FL"
56,2017,Sep,26893,25429,1464,5.4,"Putnam County, FL"
57,2017,Oct,26766,25371,1395,5.2,"Putnam County, FL"
58,2017,Nov,26232,24838,1394,5.3,"Putnam County, FL"
59,2017,Dec,26288,24941,1347,5.1,"Putnam County, FL"
60,2018,Jan,26314,24830,1484,5.6,"Putnam County, FL"
61,2018,Feb,26418,25032,1386,5.2,"Putnam County, FL"
62,2018,Mar,26493,25167,1326,5.0,"Putnam County, FL"
63,2018,Apr,26525,25275,1250,4.7,"Putnam County, FL"
64,2018,May,27114,25847,1267,4.7,"Putnam County, FL"
65,2018,Jun,26602,25163,1439,5.4,"Putnam County, FL"
66,2018,Jul,26344,24906,1438,5.5,"Putnam County, FL"
67,2018,Aug,26802,25434,1368,5.1,"Putnam County, FL"
68,2018,Sep,26966,25690,1276,4.7,"Putnam County, FL"
69,2018,Oct,26722,25472,1250,4.7,"Putnam County, FL"
70,2018,Nov,26341,25147,1194,4.5,"Putnam County, FL"
71,2018,Dec,26364,25164,1200,4.6,"Putnam County, FL"
72,2019,Jan,26277,24924,1353,5.1,"Putnam County, FL"
73,2019,Feb,26314,25115,1199,4.6,"Putnam County, FL"
74,2019,Mar,26542,25368,1174,4.4,"Putnam County, FL"
75,2019,Apr,26389,25344,1045,4.0,"Putnam County, FL"
76,2019,May,26571,25455,1116,4.2,"Putnam County, FL"
77,2019,Jun,26113,24852,1261,4.8,"Putnam County, FL"
78,2019,Jul,26111,24826,1285,4.9,"Putnam County, FL"
79,2019,Aug,26695,25435,1260,4.7,"Putnam County, FL"
80,2019,Sep,26778,25668,1110,4.1,"Putnam County, FL"
81,2019,Oct,26633,25536,1097,4.1,"Putnam County, FL"
82,2019,Nov,26376,25287,1089,4.1,"Putnam County, FL"
83,2019,Dec,26118,25096,1022,3.9,"Putnam County, FL"
84,2020,Jan,26247,25032,1215,4.6,"Putnam County, FL"
85,2020,Feb,26254,25155,1099,4.2,"Putnam County, FL"
86,2020,Mar,26099,24466,1633,6.3,"Putnam County, FL"
87,2020,Apr,24365,21889,2476,10.2,"Putnam County, FL"
88,2020,May,26455,23455,3000,11.3,"Putnam County, FL"
89,2020,Jun,26156,23417,2739,10.5,"Putnam County, FL"
90,2020,Jul,26841,23472,3369,12.6,"Putnam County, FL"
91,2020,Aug,27063,24603,2460,9.1,"Putnam County, FL"
92,2020,Sep,27229,24804,2425,8.9,"Putnam County, FL"
93,2020,Oct,27067,24840,2227,8.2,"Putnam County, FL"
94,2020,Nov,26653,24594,2059,7.7,"Putnam County, FL"
95,2020,Dec,26602,24602,2000,7.5,"Putnam County, FL"
96,2021,Jan,27034,25048,1986,7.3,"Putnam County, FL"
97,2021,Feb,27226,25354,1872,6.9,"Putnam County, FL"
98,2021,Mar,27192,25486,1706,6.3,"Putnam County, FL"
99,2021,Apr,27414,25743,1671,6.1,"Putnam County, FL"
100,2021,May,27852,26203,1649,5.9,"Putnam County, FL"
101,2021,Jun,27804,25934,1870,6.7,"Putnam County, FL"
102,2021,Jul,27917,26144,1773,6.4,"Putnam County, FL"
103,2021,Aug,28000,26301,1699,6.1,"Putnam County, FL"
104,2021,Sep,28015,26411,1604,5.7,"Putnam County, FL"
105,2021,Oct,27946,26411,1535,5.5,"Putnam County, FL"
106,2021,Nov,27563,26132,1431,5.2,"Putnam County, FL"
107,2021,Dec,27363,26123,1240,4.5,"Putnam County, FL"
108,2022,Jan,27738,26254,1484,5.4,"Putnam County, FL"
109,2022,Feb,27562,26295,1267,4.6,"Putnam County, FL"
110,2022,Mar,27554,26404,1150,4.2,"Putnam County, FL"
111,2022,Apr,27467,26415,1052,3.8,"Putnam County, FL"
112,2022,May,27656,26602,1054,3.8,"Putnam County, FL"
113,2022,Jun,27489,26289,1200,4.4,"Putnam County, FL"
114,2022,Jul,27449,26299,1150,4.2,"Putnam County, FL"
115,2022,Aug,27603,26463,1140,4.1,"Putnam County, FL"
116,2022,Sep,27603,26608,995,3.6,"Putnam County, FL"
117,2022,Oct,27519,26502,1017,3.7,"Putnam County, FL"
118,2022,Nov,27090,26097,993,3.7,"Putnam County, FL"
119,2022,Dec,27155,26293,862,3.2,"Putnam County, FL"
120,2023,Jan,27507,26500,1007,3.7,"Putnam County, FL"
121,2023,Feb,27725,26735,990,3.6,"Putnam County, FL"
122,2023,Mar,27941,26936,1005,3.6,"Putnam County, FL"
123,2023,Apr,27660,26784,876,3.2,"Putnam County, FL"
124,2023,May,27970,26941,1029,3.7,"Putnam County, FL"
125,2023,Jun,27975,26830,1145,4.1,"Putnam County, FL"
126,2023,Jul,27715,26524,1191,4.3,"Putnam County, FL"
127,2023,Aug,28280,27079,1201,4.2,"Putnam County, FL"
128,2023,Sep,28295,27124,1171,4.1,"Putnam County, FL"
129,2023,Oct,28303,27095,1208,4.3,"Putnam County, FL"
0,2013,Jan,12736,11711,1025,8.0,"Hardee County, FL"
1,2013,Feb,12758,11848,910,7.1,"Hardee County, FL"
2,2013,Mar,12309,11454,855,6.9,"Hardee County, FL"
3,2013,Apr,11915,11106,809,6.8,"Hardee County, FL"
4,2013,May,11678,10850,828,7.1,"Hardee County, FL"
5,2013,Jun,10292,9291,1001,9.7,"Hardee County, FL"
6,2013,Jul,9699,8628,1071,11.0,"Hardee County, FL"
7,2013,Aug,9681,8598,1083,11.2,"Hardee County, FL"
8,2013,Sep,9758,8697,1061,10.9,"Hardee County, FL"
9,2013,Oct,9822,8824,998,10.2,"Hardee County, FL"
10,2013,Nov,10400,9500,900,8.7,"Hardee County, FL"
11,2013,Dec,11292,10457,835,7.4,"Hardee County, FL"
12,2014,Jan,11328,10469,859,7.6,"Hardee County, FL"
13,2014,Feb,11267,10449,818,7.3,"Hardee County, FL"
14,2014,Mar,11008,10228,780,7.1,"Hardee County, FL"
15,2014,Apr,10923,10211,712,6.5,"Hardee County, FL"
16,2014,May,11059,10323,736,6.7,"Hardee County, FL"
17,2014,Jun,10177,9341,836,8.2,"Hardee County, FL"
18,2014,Jul,9401,8488,913,9.7,"Hardee County, FL"
19,2014,Aug,9320,8388,932,10.0,"Hardee County, FL"
20,2014,Sep,9368,8485,883,9.4,"Hardee County, FL"
21,2014,Oct,9480,8668,812,8.6,"Hardee County, FL"
22,2014,Nov,9874,9085,789,8.0,"Hardee County, FL"
23,2014,Dec,10775,10051,724,6.7,"Hardee County, FL"
24,2015,Jan,11275,10501,774,6.9,"Hardee County, FL"
25,2015,Feb,11165,10468,697,6.2,"Hardee County, FL"
26,2015,Mar,10851,10192,659,6.1,"Hardee County, FL"
27,2015,Apr,10696,10070,626,5.9,"Hardee County, FL"
28,2015,May,10896,10216,680,6.2,"Hardee County, FL"
29,2015,Jun,9913,9157,756,7.6,"Hardee County, FL"
30,2015,Jul,9117,8309,808,8.9,"Hardee County, FL"
31,2015,Aug,9295,8517,778,8.4,"Hardee County, FL"
32,2015,Sep,9282,8520,762,8.2,"Hardee County, FL"
33,2015,Oct,9310,8597,713,7.7,"Hardee County, FL"
34,2015,Nov,9537,8854,683,7.2,"Hardee County, FL"
35,2015,Dec,10230,9586,644,6.3,"Hardee County, FL"
36,2016,Jan,9875,9232,643,6.5,"Hardee County, FL"
37,2016,Feb,9771,9178,593,6.1,"Hardee County, FL"
38,2016,Mar,9728,9155,573,5.9,"Hardee County, FL"
39,2016,Apr,9649,9093,556,5.8,"Hardee County, FL"
40,2016,May,9813,9270,543,5.5,"Hardee County, FL"
41,2016,Jun,8774,8131,643,7.3,"Hardee County, FL"
42,2016,Jul,8585,7895,690,8.0,"Hardee County, FL"
43,2016,Aug,8699,8008,691,7.9,"Hardee County, FL"
44,2016,Sep,8825,8146,679,7.7,"Hardee County, FL"
45,2016,Oct,8958,8307,651,7.3,"Hardee County, FL"
46,2016,Nov,9041,8425,616,6.8,"Hardee County, FL"
47,2016,Dec,9728,9132,596,6.1,"Hardee County, FL"
48,2017,Jan,9346,8734,612,6.5,"Hardee County, FL"
49,2017,Feb,9386,8856,530,5.6,"Hardee County, FL"
50,2017,Mar,9364,8851,513,5.5,"Hardee County, FL"
51,2017,Apr,9315,8833,482,5.2,"Hardee County, FL"
52,2017,May,9297,8814,483,5.2,"Hardee County, FL"
53,2017,Jun,8510,7955,555,6.5,"Hardee County, FL"
54,2017,Jul,8028,7441,587,7.3,"Hardee County, FL"
55,2017,Aug,8484,7898,586,6.9,"Hardee County, FL"
56,2017,Sep,8446,7905,541,6.4,"Hardee County, FL"
57,2017,Oct,8648,8137,511,5.9,"Hardee County, FL"
58,2017,Nov,8687,8183,504,5.8,"Hardee County, FL"
59,2017,Dec,9262,8797,465,5.0,"Hardee County, FL"
60,2018,Jan,9363,8859,504,5.4,"Hardee County, FL"
61,2018,Feb,9376,8913,463,4.9,"Hardee County, FL"
62,2018,Mar,9388,8948,440,4.7,"Hardee County, FL"
63,2018,Apr,9303,8888,415,4.5,"Hardee County, FL"
64,2018,May,9149,8741,408,4.5,"Hardee County, FL"
65,2018,Jun,8278,7782,496,6.0,"Hardee County, FL"
66,2018,Jul,7957,7376,581,7.3,"Hardee County, FL"
67,2018,Aug,8425,7878,547,6.5,"Hardee County, FL"
68,2018,Sep,8378,7897,481,5.7,"Hardee County, FL"
69,2018,Oct,8408,7960,448,5.3,"Hardee County, FL"
70,2018,Nov,8347,7941,406,4.9,"Hardee County, FL"
71,2018,Dec,8649,8233,416,4.8,"Hardee County, FL"
72,2019,Jan,8653,8185,468,5.4,"Hardee County, FL"
73,2019,Feb,8458,8030,428,5.1,"Hardee County, FL"
74,2019,Mar,8536,8125,411,4.8,"Hardee County, FL"
75,2019,Apr,8384,8021,363,4.3,"Hardee County, FL"
76,2019,May,8340,7945,395,4.7,"Hardee County, FL"
77,2019,Jun,7893,7429,464,5.9,"Hardee County, FL"
78,2019,Jul,7792,7272,520,6.7,"Hardee County, FL"
79,2019,Aug,8404,7907,497,5.9,"Hardee County, FL"
80,2019,Sep,8404,7942,462,5.5,"Hardee County, FL"
81,2019,Oct,8363,7931,432,5.2,"Hardee County, FL"
82,2019,Nov,8276,7896,380,4.6,"Hardee County, FL"
83,2019,Dec,8359,7998,361,4.3,"Hardee County, FL"
84,2020,Jan,8516,8126,390,4.6,"Hardee County, FL"
85,2020,Feb,8518,8191,327,3.8,"Hardee County, FL"
86,2020,Mar,8497,8015,482,5.7,"Hardee County, FL"
87,2020,Apr,8005,7476,529,6.6,"Hardee County, FL"
88,2020,May,8540,7828,712,8.3,"Hardee County, FL"
89,2020,Jun,8143,7405,738,9.1,"Hardee County, FL"
90,2020,Jul,8163,7224,939,11.5,"Hardee County, FL"
91,2020,Aug,8563,7898,665,7.8,"Hardee County, FL"
92,2020,Sep,8655,8014,641,7.4,"Hardee County, FL"
93,2020,Oct,8681,8165,516,5.9,"Hardee County, FL"
94,2020,Nov,8686,8179,507,5.8,"Hardee County, FL"
95,2020,Dec,8762,8264,498,5.7,"Hardee County, FL"
96,2021,Jan,8695,8179,516,5.9,"Hardee County, FL"
97,2021,Feb,8733,8274,459,5.3,"Hardee County, FL"
98,2021,Mar,8756,8327,429,4.9,"Hardee County, FL"
99,2021,Apr,9154,8744,410,4.5,"Hardee County, FL"
100,2021,May,9048,8651,397,4.4,"Hardee County, FL"
101,2021,Jun,9011,8516,495,5.5,"Hardee County, FL"
102,2021,Jul,8847,8326,521,5.9,"Hardee County, FL"
103,2021,Aug,8940,8439,501,5.6,"Hardee County, FL"
104,2021,Sep,8956,8520,436,4.9,"Hardee County, FL"
105,2021,Oct,8910,8506,404,4.5,"Hardee County, FL"
106,2021,Nov,8827,8466,361,4.1,"Hardee County, FL"
107,2021,Dec,8832,8517,315,3.6,"Hardee County, FL"
108,2022,Jan,8891,8489,402,4.5,"Hardee County, FL"
109,2022,Feb,8850,8510,340,3.8,"Hardee County, FL"
110,2022,Mar,8845,8527,318,3.6,"Hardee County, FL"
111,2022,Apr,8734,8438,296,3.4,"Hardee County, FL"
112,2022,May,8779,8472,307,3.5,"Hardee County, FL"
113,2022,Jun,8689,8289,400,4.6,"Hardee County, FL"
114,2022,Jul,8634,8240,394,4.6,"Hardee County, FL"
115,2022,Aug,8765,8379,386,4.4,"Hardee County, FL"
116,2022,Sep,8834,8499,335,3.8,"Hardee County, FL"
117,2022,Oct,8844,8507,337,3.8,"Hardee County, FL"
118,2022,Nov,8765,8452,313,3.6,"Hardee County, FL"
119,2022,Dec,8767,8528,239,2.7,"Hardee County, FL"
120,2023,Jan,8825,8537,288,3.3,"Hardee County, FL"
121,2023,Feb,8896,8604,292,3.3,"Hardee County, FL"
122,2023,Mar,8979,8680,299,3.3,"Hardee County, FL"
123,2023,Apr,8938,8662,276,3.1,"Hardee County, FL"
124,2023,May,9014,8697,317,3.5,"Hardee County, FL"
125,2023,Jun,8911,8522,389,4.4,"Hardee County, FL"
126,2023,Jul,8869,8436,433,4.9,"Hardee County, FL"
127,2023,Aug,8955,8516,439,4.9,"Hardee County, FL"
128,2023,Sep,8927,8519,408,4.6,"Hardee County, FL"
129,2023,Oct,8967,8567,400,4.5,"Hardee County, FL"
0,2013,Jan,87840,81451,6389,7.3,"Okaloosa County, FL"
1,2013,Feb,88023,82228,5795,6.6,"Okaloosa County, FL"
2,2013,Mar,90374,85003,5371,5.9,"Okaloosa County, FL"
3,2013,Apr,91179,86085,5094,5.6,"Okaloosa County, FL"
4,2013,May,93889,88496,5393,5.7,"Okaloosa County, FL"
5,2013,Jun,96184,90403,5781,6.0,"Okaloosa County, FL"
6,2013,Jul,96812,91025,5787,6.0,"Okaloosa County, FL"
7,2013,Aug,95032,89541,5491,5.8,"Okaloosa County, FL"
8,2013,Sep,93338,87972,5366,5.7,"Okaloosa County, FL"
9,2013,Oct,91272,86061,5211,5.7,"Okaloosa County, FL"
10,2013,Nov,89817,84644,5173,5.8,"Okaloosa County, FL"
11,2013,Dec,88628,83683,4945,5.6,"Okaloosa County, FL"
12,2014,Jan,88206,82869,5337,6.1,"Okaloosa County, FL"
13,2014,Feb,88811,83656,5155,5.8,"Okaloosa County, FL"
14,2014,Mar,91783,86757,5026,5.5,"Okaloosa County, FL"
15,2014,Apr,91787,87366,4421,4.8,"Okaloosa County, FL"
16,2014,May,94093,89334,4759,5.1,"Okaloosa County, FL"
17,2014,Jun,95880,90926,4954,5.2,"Okaloosa County, FL"
18,2014,Jul,96249,91043,5206,5.4,"Okaloosa County, FL"
19,2014,Aug,94488,89433,5055,5.3,"Okaloosa County, FL"
20,2014,Sep,92739,87999,4740,5.1,"Okaloosa County, FL"
21,2014,Oct,91340,86698,4642,5.1,"Okaloosa County, FL"
22,2014,Nov,89140,84463,4677,5.2,"Okaloosa County, FL"
23,2014,Dec,88165,83735,4430,5.0,"Okaloosa County, FL"
24,2015,Jan,87974,83138,4836,5.5,"Okaloosa County, FL"
25,2015,Feb,88395,83969,4426,5.0,"Okaloosa County, FL"
26,2015,Mar,90458,86310,4148,4.6,"Okaloosa County, FL"
27,2015,Apr,91610,87626,3984,4.3,"Okaloosa County, FL"
28,2015,May,93969,89690,4279,4.6,"Okaloosa County, FL"
29,2015,Jun,95447,91117,4330,4.5,"Okaloosa County, FL"
30,2015,Jul,96490,92070,4420,4.6,"Okaloosa County, FL"
31,2015,Aug,94626,90390,4236,4.5,"Okaloosa County, FL"
32,2015,Sep,92826,88798,4028,4.3,"Okaloosa County, FL"
33,2015,Oct,92506,88503,4003,4.3,"Okaloosa County, FL"
34,2015,Nov,90595,86610,3985,4.4,"Okaloosa County, FL"
35,2015,Dec,90055,86221,3834,4.3,"Okaloosa County, FL"
36,2016,Jan,89278,85163,4115,4.6,"Okaloosa County, FL"
37,2016,Feb,90231,86438,3793,4.2,"Okaloosa County, FL"
38,2016,Mar,92449,88722,3727,4.0,"Okaloosa County, FL"
39,2016,Apr,93152,89594,3558,3.8,"Okaloosa County, FL"
40,2016,May,94706,91218,3488,3.7,"Okaloosa County, FL"
41,2016,Jun,97398,93463,3935,4.0,"Okaloosa County, FL"
42,2016,Jul,98246,94204,4042,4.1,"Okaloosa County, FL"
43,2016,Aug,96439,92541,3898,4.0,"Okaloosa County, FL"
44,2016,Sep,94861,90985,3876,4.1,"Okaloosa County, FL"
45,2016,Oct,93571,89777,3794,4.1,"Okaloosa County, FL"
46,2016,Nov,91555,87865,3690,4.0,"Okaloosa County, FL"
47,2016,Dec,90511,86908,3603,4.0,"Okaloosa County, FL"
48,2017,Jan,89756,85778,3978,4.4,"Okaloosa County, FL"
49,2017,Feb,90376,86813,3563,3.9,"Okaloosa County, FL"
50,2017,Mar,92606,89315,3291,3.6,"Okaloosa County, FL"
51,2017,Apr,93477,90413,3064,3.3,"Okaloosa County, FL"
52,2017,May,94669,91562,3107,3.3,"Okaloosa County, FL"
53,2017,Jun,97393,93979,3414,3.5,"Okaloosa County, FL"
54,2017,Jul,97653,94127,3526,3.6,"Okaloosa County, FL"
55,2017,Aug,96090,92605,3485,3.6,"Okaloosa County, FL"
56,2017,Sep,95792,92637,3155,3.3,"Okaloosa County, FL"
57,2017,Oct,93479,90426,3053,3.3,"Okaloosa County, FL"
58,2017,Nov,91874,88782,3092,3.4,"Okaloosa County, FL"
59,2017,Dec,90729,87799,2930,3.2,"Okaloosa County, FL"
60,2018,Jan,90925,87530,3395,3.7,"Okaloosa County, FL"
61,2018,Feb,91937,88837,3100,3.4,"Okaloosa County, FL"
62,2018,Mar,94132,91214,2918,3.1,"Okaloosa County, FL"
63,2018,Apr,94569,91809,2760,2.9,"Okaloosa County, FL"
64,2018,May,95835,93161,2674,2.8,"Okaloosa County, FL"
65,2018,Jun,98340,95116,3224,3.3,"Okaloosa County, FL"
66,2018,Jul,98648,95604,3044,3.1,"Okaloosa County, FL"
67,2018,Aug,96657,93733,2924,3.0,"Okaloosa County, FL"
68,2018,Sep,95184,92479,2705,2.8,"Okaloosa County, FL"
69,2018,Oct,94182,91438,2744,2.9,"Okaloosa County, FL"
70,2018,Nov,93064,90365,2699,2.9,"Okaloosa County, FL"
71,2018,Dec,92268,89579,2689,2.9,"Okaloosa County, FL"
72,2019,Jan,92509,89293,3216,3.5,"Okaloosa County, FL"
73,2019,Feb,93065,90289,2776,3.0,"Okaloosa County, FL"
74,2019,Mar,94704,92012,2692,2.8,"Okaloosa County, FL"
75,2019,Apr,95065,92657,2408,2.5,"Okaloosa County, FL"
76,2019,May,97197,94715,2482,2.6,"Okaloosa County, FL"
77,2019,Jun,99521,96620,2901,2.9,"Okaloosa County, FL"
78,2019,Jul,99968,97047,2921,2.9,"Okaloosa County, FL"
79,2019,Aug,98524,95689,2835,2.9,"Okaloosa County, FL"
80,2019,Sep,97257,94752,2505,2.6,"Okaloosa County, FL"
81,2019,Oct,96247,93783,2464,2.6,"Okaloosa County, FL"
82,2019,Nov,94864,92404,2460,2.6,"Okaloosa County, FL"
83,2019,Dec,94249,91958,2291,2.4,"Okaloosa County, FL"
84,2020,Jan,94370,91600,2770,2.9,"Okaloosa County, FL"
85,2020,Feb,94964,92626,2338,2.5,"Okaloosa County, FL"
86,2020,Mar,94693,91351,3342,3.5,"Okaloosa County, FL"
87,2020,Apr,87764,76769,10995,12.5,"Okaloosa County, FL"
88,2020,May,94027,84729,9298,9.9,"Okaloosa County, FL"
89,2020,Jun,96094,89282,6812,7.1,"Okaloosa County, FL"
90,2020,Jul,98782,91226,7556,7.6,"Okaloosa County, FL"
91,2020,Aug,97657,92424,5233,5.4,"Okaloosa County, FL"
92,2020,Sep,96800,91896,4904,5.1,"Okaloosa County, FL"
93,2020,Oct,97529,93218,4311,4.4,"Okaloosa County, FL"
94,2020,Nov,96033,91830,4203,4.4,"Okaloosa County, FL"
95,2020,Dec,96118,91935,4183,4.4,"Okaloosa County, FL"
96,2021,Jan,95824,91577,4247,4.4,"Okaloosa County, FL"
97,2021,Feb,96634,92753,3881,4.0,"Okaloosa County, FL"
98,2021,Mar,98692,95018,3674,3.7,"Okaloosa County, FL"
99,2021,Apr,99113,95872,3241,3.3,"Okaloosa County, FL"
100,2021,May,100505,97339,3166,3.2,"Okaloosa County, FL"
101,2021,Jun,102790,98940,3850,3.7,"Okaloosa County, FL"
102,2021,Jul,102859,99163,3696,3.6,"Okaloosa County, FL"
103,2021,Aug,101346,97834,3512,3.5,"Okaloosa County, FL"
104,2021,Sep,100275,97174,3101,3.1,"Okaloosa County, FL"
105,2021,Oct,100184,97162,3022,3.0,"Okaloosa County, FL"
106,2021,Nov,99097,96276,2821,2.8,"Okaloosa County, FL"
107,2021,Dec,99048,96525,2523,2.5,"Okaloosa County, FL"
108,2022,Jan,99926,96751,3175,3.2,"Okaloosa County, FL"
109,2022,Feb,100346,97580,2766,2.8,"Okaloosa County, FL"
110,2022,Mar,102330,99810,2520,2.5,"Okaloosa County, FL"
111,2022,Apr,102719,100454,2265,2.2,"Okaloosa County, FL"
112,2022,May,104437,102067,2370,2.3,"Okaloosa County, FL"
113,2022,Jun,105935,103123,2812,2.7,"Okaloosa County, FL"
114,2022,Jul,106275,103626,2649,2.5,"Okaloosa County, FL"
115,2022,Aug,105052,102479,2573,2.4,"Okaloosa County, FL"
116,2022,Sep,104258,101873,2385,2.3,"Okaloosa County, FL"
117,2022,Oct,103565,101197,2368,2.3,"Okaloosa County, FL"
118,2022,Nov,102551,100221,2330,2.3,"Okaloosa County, FL"
119,2022,Dec,102501,100483,2018,2.0,"Okaloosa County, FL"
120,2023,Jan,102933,100539,2394,2.3,"Okaloosa County, FL"
121,2023,Feb,103647,101267,2380,2.3,"Okaloosa County, FL"
122,2023,Mar,105531,103176,2355,2.2,"Okaloosa County, FL"
123,2023,Apr,105580,103512,2068,2.0,"Okaloosa County, FL"
124,2023,May,106551,104154,2397,2.2,"Okaloosa County, FL"
125,2023,Jun,108813,106037,2776,2.6,"Okaloosa County, FL"
126,2023,Jul,109753,106829,2924,2.7,"Okaloosa County, FL"
127,2023,Aug,109438,106458,2980,2.7,"Okaloosa County, FL"
128,2023,Sep,108925,105964,2961,2.7,"Okaloosa County, FL"
129,2023,Oct,108047,105015,3032,2.8,"Okaloosa County, FL"
0,2013,Jan,176633,160682,15951,9.0,"Placer County, CA"
1,2013,Feb,176354,161344,15010,8.5,"Placer County, CA"
2,2013,Mar,175796,161388,14408,8.2,"Placer County, CA"
3,2013,Apr,174388,161167,13221,7.6,"Placer County, CA"
4,2013,May,174817,161598,13219,7.6,"Placer County, CA"
5,2013,Jun,175617,161271,14346,8.2,"Placer County, CA"
6,2013,Jul,175977,161662,14315,8.1,"Placer County, CA"
7,2013,Aug,174844,161321,13523,7.7,"Placer County, CA"
8,2013,Sep,175273,162275,12998,7.4,"Placer County, CA"
9,2013,Oct,173903,160889,13014,7.5,"Placer County, CA"
10,2013,Nov,174849,162286,12563,7.2,"Placer County, CA"
11,2013,Dec,173818,162017,11801,6.8,"Placer County, CA"
12,2014,Jan,174196,161744,12452,7.1,"Placer County, CA"
13,2014,Feb,174886,162294,12592,7.2,"Placer County, CA"
14,2014,Mar,175366,162854,12512,7.1,"Placer County, CA"
15,2014,Apr,173239,162660,10579,6.1,"Placer County, CA"
16,2014,May,174400,163731,10669,6.1,"Placer County, CA"
17,2014,Jun,175663,164482,11181,6.4,"Placer County, CA"
18,2014,Jul,175912,164135,11777,6.7,"Placer County, CA"
19,2014,Aug,175226,163975,11251,6.4,"Placer County, CA"
20,2014,Sep,175350,164989,10361,5.9,"Placer County, CA"
21,2014,Oct,176067,165757,10310,5.9,"Placer County, CA"
22,2014,Nov,176322,166104,10218,5.8,"Placer County, CA"
23,2014,Dec,174539,165202,9337,5.3,"Placer County, CA"
24,2015,Jan,175623,165348,10275,5.9,"Placer County, CA"
25,2015,Feb,175566,165809,9757,5.6,"Placer County, CA"
26,2015,Mar,175993,166385,9608,5.5,"Placer County, CA"
27,2015,Apr,175241,166373,8868,5.1,"Placer County, CA"
28,2015,May,176163,167333,8830,5.0,"Placer County, CA"
29,2015,Jun,176663,167406,9257,5.2,"Placer County, CA"
30,2015,Jul,177389,167893,9496,5.4,"Placer County, CA"
31,2015,Aug,176408,167638,8770,5.0,"Placer County, CA"
32,2015,Sep,176024,167855,8169,4.6,"Placer County, CA"
33,2015,Oct,176736,168347,8389,4.7,"Placer County, CA"
34,2015,Nov,177136,168811,8325,4.7,"Placer County, CA"
35,2015,Dec,177134,169209,7925,4.5,"Placer County, CA"
36,2016,Jan,178645,170118,8527,4.8,"Placer County, CA"
37,2016,Feb,179675,171211,8464,4.7,"Placer County, CA"
38,2016,Mar,180124,171416,8708,4.8,"Placer County, CA"
39,2016,Apr,178264,170420,7844,4.4,"Placer County, CA"
40,2016,May,178669,171476,7193,4.0,"Placer County, CA"
41,2016,Jun,179778,171353,8425,4.7,"Placer County, CA"
42,2016,Jul,180879,172293,8586,4.7,"Placer County, CA"
43,2016,Aug,180374,172054,8320,4.6,"Placer County, CA"
44,2016,Sep,180365,172360,8005,4.4,"Placer County, CA"
45,2016,Oct,179875,171880,7995,4.4,"Placer County, CA"
46,2016,Nov,179692,172162,7530,4.2,"Placer County, CA"
47,2016,Dec,179267,171854,7413,4.1,"Placer County, CA"
48,2017,Jan,180399,172051,8348,4.6,"Placer County, CA"
49,2017,Feb,180928,172893,8035,4.4,"Placer County, CA"
50,2017,Mar,181113,173551,7562,4.2,"Placer County, CA"
51,2017,Apr,179875,173019,6856,3.8,"Placer County, CA"
52,2017,May,180287,173780,6507,3.6,"Placer County, CA"
53,2017,Jun,181214,173789,7425,4.1,"Placer County, CA"
54,2017,Jul,182558,174860,7698,4.2,"Placer County, CA"
55,2017,Aug,181390,173987,7403,4.1,"Placer County, CA"
56,2017,Sep,182203,175685,6518,3.6,"Placer County, CA"
57,2017,Oct,181789,175506,6283,3.5,"Placer County, CA"
58,2017,Nov,181612,175528,6084,3.3,"Placer County, CA"
59,2017,Dec,181402,175477,5925,3.3,"Placer County, CA"
60,2018,Jan,183581,176986,6595,3.6,"Placer County, CA"
61,2018,Feb,185033,178639,6394,3.5,"Placer County, CA"
62,2018,Mar,185003,178850,6153,3.3,"Placer County, CA"
63,2018,Apr,183804,178241,5563,3.0,"Placer County, CA"
64,2018,May,184751,179675,5076,2.7,"Placer County, CA"
65,2018,Jun,185432,179166,6266,3.4,"Placer County, CA"
66,2018,Jul,187162,180962,6200,3.3,"Placer County, CA"
67,2018,Aug,185786,179715,6071,3.3,"Placer County, CA"
68,2018,Sep,186511,180910,5601,3.0,"Placer County, CA"
69,2018,Oct,186779,180998,5781,3.1,"Placer County, CA"
70,2018,Nov,186947,181201,5746,3.1,"Placer County, CA"
71,2018,Dec,186820,180923,5897,3.2,"Placer County, CA"
72,2019,Jan,188840,181643,7197,3.8,"Placer County, CA"
73,2019,Feb,189732,183223,6509,3.4,"Placer County, CA"
74,2019,Mar,189730,183120,6610,3.5,"Placer County, CA"
75,2019,Apr,186907,181470,5437,2.9,"Placer County, CA"
76,2019,May,187466,182307,5159,2.8,"Placer County, CA"
77,2019,Jun,187583,181551,6032,3.2,"Placer County, CA"
78,2019,Jul,189818,183451,6367,3.4,"Placer County, CA"
79,2019,Aug,189281,183224,6057,3.2,"Placer County, CA"
80,2019,Sep,189632,184364,5268,2.8,"Placer County, CA"
81,2019,Oct,190103,184600,5503,2.9,"Placer County, CA"
82,2019,Nov,189644,184149,5495,2.9,"Placer County, CA"
83,2019,Dec,189105,183791,5314,2.8,"Placer County, CA"
84,2020,Jan,191216,184817,6399,3.3,"Placer County, CA"
85,2020,Feb,192743,186700,6043,3.1,"Placer County, CA"
86,2020,Mar,190738,182028,8710,4.6,"Placer County, CA"
87,2020,Apr,184881,160135,24746,13.4,"Placer County, CA"
88,2020,May,182075,159133,22942,12.6,"Placer County, CA"
89,2020,Jun,187583,168226,19357,10.3,"Placer County, CA"
90,2020,Jul,187984,170346,17638,9.4,"Placer County, CA"
91,2020,Aug,186576,172171,14405,7.7,"Placer County, CA"
92,2020,Sep,186463,173183,13280,7.1,"Placer County, CA"
93,2020,Oct,186662,175145,11517,6.2,"Placer County, CA"
94,2020,Nov,185821,174612,11209,6.0,"Placer County, CA"
95,2020,Dec,185610,174214,11396,6.1,"Placer County, CA"
96,2021,Jan,186899,175270,11629,6.2,"Placer County, CA"
97,2021,Feb,188123,176740,11383,6.1,"Placer County, CA"
98,2021,Mar,188711,177701,11010,5.8,"Placer County, CA"
99,2021,Apr,187566,177119,10447,5.6,"Placer County, CA"
100,2021,May,187873,178294,9579,5.1,"Placer County, CA"
101,2021,Jun,189087,178297,10790,5.7,"Placer County, CA"
102,2021,Jul,191524,181144,10380,5.4,"Placer County, CA"
103,2021,Aug,190941,181043,9898,5.2,"Placer County, CA"
104,2021,Sep,190803,182491,8312,4.4,"Placer County, CA"
105,2021,Oct,191089,183027,8062,4.2,"Placer County, CA"
106,2021,Nov,191365,184063,7302,3.8,"Placer County, CA"
107,2021,Dec,190938,184272,6666,3.5,"Placer County, CA"
108,2022,Jan,191362,183745,7617,4.0,"Placer County, CA"
109,2022,Feb,192864,185995,6869,3.6,"Placer County, CA"
110,2022,Mar,194042,187867,6175,3.2,"Placer County, CA"
111,2022,Apr,191938,186600,5338,2.8,"Placer County, CA"
112,2022,May,192939,188029,4910,2.5,"Placer County, CA"
113,2022,Jun,192512,186592,5920,3.1,"Placer County, CA"
114,2022,Jul,194610,188729,5881,3.0,"Placer County, CA"
115,2022,Aug,195250,189211,6039,3.1,"Placer County, CA"
116,2022,Sep,195163,189773,5390,2.8,"Placer County, CA"
117,2022,Oct,195558,189845,5713,2.9,"Placer County, CA"
118,2022,Nov,194970,189114,5856,3.0,"Placer County, CA"
119,2022,Dec,194667,189190,5477,2.8,"Placer County, CA"
120,2023,Jan,194185,187208,6977,3.6,"Placer County, CA"
121,2023,Feb,196105,188893,7212,3.7,"Placer County, CA"
122,2023,Mar,196687,189371,7316,3.7,"Placer County, CA"
123,2023,Apr,195042,188674,6368,3.3,"Placer County, CA"
124,2023,May,194976,188364,6612,3.4,"Placer County, CA"
125,2023,Jun,194337,186916,7421,3.8,"Placer County, CA"
126,2023,Jul,196147,188895,7252,3.7,"Placer County, CA"
127,2023,Aug,195068,187217,7851,4.0,"Placer County, CA"
128,2023,Sep,196824,189360,7464,3.8,"Placer County, CA"
129,2023,Oct,196830,189222,7608,3.9,"Placer County, CA"
0,2013,Jan,27304,24277,3027,11.1,"Sumter County, FL"
1,2013,Feb,27135,24453,2682,9.9,"Sumter County, FL"
2,2013,Mar,27089,24542,2547,9.4,"Sumter County, FL"
3,2013,Apr,27174,24679,2495,9.2,"Sumter County, FL"
4,2013,May,27603,24938,2665,9.7,"Sumter County, FL"
5,2013,Jun,27617,24851,2766,10.0,"Sumter County, FL"
6,2013,Jul,27410,24660,2750,10.0,"Sumter County, FL"
7,2013,Aug,27822,25111,2711,9.7,"Sumter County, FL"
8,2013,Sep,27908,25286,2622,9.4,"Sumter County, FL"
9,2013,Oct,27914,25264,2650,9.5,"Sumter County, FL"
10,2013,Nov,27853,25268,2585,9.3,"Sumter County, FL"
11,2013,Dec,27528,25131,2397,8.7,"Sumter County, FL"
12,2014,Jan,27975,25368,2607,9.3,"Sumter County, FL"
13,2014,Feb,28039,25525,2514,9.0,"Sumter County, FL"
14,2014,Mar,28184,25673,2511,8.9,"Sumter County, FL"
15,2014,Apr,28086,25876,2210,7.9,"Sumter County, FL"
16,2014,May,28444,25935,2509,8.8,"Sumter County, FL"
17,2014,Jun,28191,25809,2382,8.4,"Sumter County, FL"
18,2014,Jul,28204,25646,2558,9.1,"Sumter County, FL"
19,2014,Aug,28401,25893,2508,8.8,"Sumter County, FL"
20,2014,Sep,28325,25995,2330,8.2,"Sumter County, FL"
21,2014,Oct,28618,26227,2391,8.4,"Sumter County, FL"
22,2014,Nov,28292,25946,2346,8.3,"Sumter County, FL"
23,2014,Dec,28160,25939,2221,7.9,"Sumter County, FL"
24,2015,Jan,28581,26108,2473,8.7,"Sumter County, FL"
25,2015,Feb,28523,26190,2333,8.2,"Sumter County, FL"
26,2015,Mar,28589,26342,2247,7.9,"Sumter County, FL"
27,2015,Apr,28530,26378,2152,7.5,"Sumter County, FL"
28,2015,May,28930,26616,2314,8.0,"Sumter County, FL"
29,2015,Jun,28747,26526,2221,7.7,"Sumter County, FL"
30,2015,Jul,28586,26255,2331,8.2,"Sumter County, FL"
31,2015,Aug,28922,26647,2275,7.9,"Sumter County, FL"
32,2015,Sep,28843,26731,2112,7.3,"Sumter County, FL"
33,2015,Oct,29099,26917,2182,7.5,"Sumter County, FL"
34,2015,Nov,28819,26708,2111,7.3,"Sumter County, FL"
35,2015,Dec,28830,26795,2035,7.1,"Sumter County, FL"
36,2016,Jan,29134,26874,2260,7.8,"Sumter County, FL"
37,2016,Feb,29212,27080,2132,7.3,"Sumter County, FL"
38,2016,Mar,29322,27230,2092,7.1,"Sumter County, FL"
39,2016,Apr,29137,27088,2049,7.0,"Sumter County, FL"
40,2016,May,29474,27440,2034,6.9,"Sumter County, FL"
41,2016,Jun,29511,27426,2085,7.1,"Sumter County, FL"
42,2016,Jul,29423,27188,2235,7.6,"Sumter County, FL"
43,2016,Aug,29605,27405,2200,7.4,"Sumter County, FL"
44,2016,Sep,29787,27592,2195,7.4,"Sumter County, FL"
45,2016,Oct,29881,27690,2191,7.3,"Sumter County, FL"
46,2016,Nov,29682,27581,2101,7.1,"Sumter County, FL"
47,2016,Dec,29711,27704,2007,6.8,"Sumter County, FL"
48,2017,Jan,29593,27427,2166,7.3,"Sumter County, FL"
49,2017,Feb,29796,27735,2061,6.9,"Sumter County, FL"
50,2017,Mar,29785,27914,1871,6.3,"Sumter County, FL"
51,2017,Apr,29768,28001,1767,5.9,"Sumter County, FL"
52,2017,May,30039,28161,1878,6.3,"Sumter County, FL"
53,2017,Jun,29904,28043,1861,6.2,"Sumter County, FL"
54,2017,Jul,29866,27915,1951,6.5,"Sumter County, FL"
55,2017,Aug,30167,28157,2010,6.7,"Sumter County, FL"
56,2017,Sep,30161,28409,1752,5.8,"Sumter County, FL"
57,2017,Oct,30388,28677,1711,5.6,"Sumter County, FL"
58,2017,Nov,30349,28635,1714,5.6,"Sumter County, FL"
59,2017,Dec,30537,28882,1655,5.4,"Sumter County, FL"
60,2018,Jan,30936,29109,1827,5.9,"Sumter County, FL"
61,2018,Feb,31031,29320,1711,5.5,"Sumter County, FL"
62,2018,Mar,30996,29354,1642,5.3,"Sumter County, FL"
63,2018,Apr,30922,29385,1537,5.0,"Sumter County, FL"
64,2018,May,31062,29500,1562,5.0,"Sumter County, FL"
65,2018,Jun,31210,29400,1810,5.8,"Sumter County, FL"
66,2018,Jul,31029,29329,1700,5.5,"Sumter County, FL"
67,2018,Aug,31216,29509,1707,5.5,"Sumter County, FL"
68,2018,Sep,31304,29767,1537,4.9,"Sumter County, FL"
69,2018,Oct,31457,29918,1539,4.9,"Sumter County, FL"
70,2018,Nov,31137,29582,1555,5.0,"Sumter County, FL"
71,2018,Dec,31161,29613,1548,5.0,"Sumter County, FL"
72,2019,Jan,32026,30240,1786,5.6,"Sumter County, FL"
73,2019,Feb,32147,30538,1609,5.0,"Sumter County, FL"
74,2019,Mar,32280,30677,1603,5.0,"Sumter County, FL"
75,2019,Apr,31752,30313,1439,4.5,"Sumter County, FL"
76,2019,May,32047,30545,1502,4.7,"Sumter County, FL"
77,2019,Jun,32235,30531,1704,5.3,"Sumter County, FL"
78,2019,Jul,32216,30582,1634,5.1,"Sumter County, FL"
79,2019,Aug,32810,31085,1725,5.3,"Sumter County, FL"
80,2019,Sep,32899,31452,1447,4.4,"Sumter County, FL"
81,2019,Oct,32880,31478,1402,4.3,"Sumter County, FL"
82,2019,Nov,32922,31443,1479,4.5,"Sumter County, FL"
83,2019,Dec,32881,31526,1355,4.1,"Sumter County, FL"
84,2020,Jan,33304,31666,1638,4.9,"Sumter County, FL"
85,2020,Feb,33399,31951,1448,4.3,"Sumter County, FL"
86,2020,Mar,33255,31200,2055,6.2,"Sumter County, FL"
87,2020,Apr,30027,26512,3515,11.7,"Sumter County, FL"
88,2020,May,31879,27784,4095,12.8,"Sumter County, FL"
89,2020,Jun,32442,28810,3632,11.2,"Sumter County, FL"
90,2020,Jul,32750,28858,3892,11.9,"Sumter County, FL"
91,2020,Aug,32493,29755,2738,8.4,"Sumter County, FL"
92,2020,Sep,32745,30055,2690,8.2,"Sumter County, FL"
93,2020,Oct,33260,30964,2296,6.9,"Sumter County, FL"
94,2020,Nov,33329,31033,2296,6.9,"Sumter County, FL"
95,2020,Dec,33401,31152,2249,6.7,"Sumter County, FL"
96,2021,Jan,33696,31573,2123,6.3,"Sumter County, FL"
97,2021,Feb,34068,32079,1989,5.8,"Sumter County, FL"
98,2021,Mar,34400,32346,2054,6.0,"Sumter County, FL"
99,2021,Apr,34397,32595,1802,5.2,"Sumter County, FL"
100,2021,May,34591,32888,1703,4.9,"Sumter County, FL"
101,2021,Jun,35147,33011,2136,6.1,"Sumter County, FL"
102,2021,Jul,35192,33128,2064,5.9,"Sumter County, FL"
103,2021,Aug,35506,33435,2071,5.8,"Sumter County, FL"
104,2021,Sep,35570,33727,1843,5.2,"Sumter County, FL"
105,2021,Oct,35638,33945,1693,4.8,"Sumter County, FL"
106,2021,Nov,35710,34015,1695,4.7,"Sumter County, FL"
107,2021,Dec,35680,34200,1480,4.1,"Sumter County, FL"
108,2022,Jan,36543,34603,1940,5.3,"Sumter County, FL"
109,2022,Feb,36658,34970,1688,4.6,"Sumter County, FL"
110,2022,Mar,37003,35467,1536,4.2,"Sumter County, FL"
111,2022,Apr,36793,35514,1279,3.5,"Sumter County, FL"
112,2022,May,37255,35848,1407,3.8,"Sumter County, FL"
113,2022,Jun,37557,35888,1669,4.4,"Sumter County, FL"
114,2022,Jul,37293,35785,1508,4.0,"Sumter County, FL"
115,2022,Aug,37781,36177,1604,4.2,"Sumter County, FL"
116,2022,Sep,37962,36443,1519,4.0,"Sumter County, FL"
117,2022,Oct,37927,36513,1414,3.7,"Sumter County, FL"
118,2022,Nov,37632,36257,1375,3.7,"Sumter County, FL"
119,2022,Dec,37755,36486,1269,3.4,"Sumter County, FL"
120,2023,Jan,38227,36739,1488,3.9,"Sumter County, FL"
121,2023,Feb,38386,36941,1445,3.8,"Sumter County, FL"
122,2023,Mar,38838,37386,1452,3.7,"Sumter County, FL"
123,2023,Apr,38754,37553,1201,3.1,"Sumter County, FL"
124,2023,May,38957,37517,1440,3.7,"Sumter County, FL"
125,2023,Jun,39338,37752,1586,4.0,"Sumter County, FL"
126,2023,Jul,39468,37769,1699,4.3,"Sumter County, FL"
127,2023,Aug,40139,38306,1833,4.6,"Sumter County, FL"
128,2023,Sep,39997,38069,1928,4.8,"Sumter County, FL"
129,2023,Oct,39680,37945,1735,4.4,"Sumter County, FL"
0,2013,Jan,19843,17369,2474,12.5,"Calaveras County, CA"
1,2013,Feb,19798,17463,2335,11.8,"Calaveras County, CA"
2,2013,Mar,19840,17638,2202,11.1,"Calaveras County, CA"
3,2013,Apr,19966,17949,2017,10.1,"Calaveras County, CA"
4,2013,May,20386,18423,1963,9.6,"Calaveras County, CA"
5,2013,Jun,20753,18685,2068,10.0,"Calaveras County, CA"
6,2013,Jul,20756,18701,2055,9.9,"Calaveras County, CA"
7,2013,Aug,20545,18602,1943,9.5,"Calaveras County, CA"
8,2013,Sep,20418,18567,1851,9.1,"Calaveras County, CA"
9,2013,Oct,20123,18266,1857,9.2,"Calaveras County, CA"
10,2013,Nov,19944,18127,1817,9.1,"Calaveras County, CA"
11,2013,Dec,19871,18088,1783,9.0,"Calaveras County, CA"
12,2014,Jan,19779,17865,1914,9.7,"Calaveras County, CA"
13,2014,Feb,20012,18092,1920,9.6,"Calaveras County, CA"
14,2014,Mar,20072,18179,1893,9.4,"Calaveras County, CA"
15,2014,Apr,19943,18336,1607,8.1,"Calaveras County, CA"
16,2014,May,20157,18559,1598,7.9,"Calaveras County, CA"
17,2014,Jun,20520,18898,1622,7.9,"Calaveras County, CA"
18,2014,Jul,20604,18900,1704,8.3,"Calaveras County, CA"
19,2014,Aug,20333,18713,1620,8.0,"Calaveras County, CA"
20,2014,Sep,20327,18863,1464,7.2,"Calaveras County, CA"
21,2014,Oct,20368,18919,1449,7.1,"Calaveras County, CA"
22,2014,Nov,20151,18702,1449,7.2,"Calaveras County, CA"
23,2014,Dec,20194,18802,1392,6.9,"Calaveras County, CA"
24,2015,Jan,20309,18792,1517,7.5,"Calaveras County, CA"
25,2015,Feb,20360,18904,1456,7.2,"Calaveras County, CA"
26,2015,Mar,20366,18947,1419,7.0,"Calaveras County, CA"
27,2015,Apr,20468,19147,1321,6.5,"Calaveras County, CA"
28,2015,May,20696,19396,1300,6.3,"Calaveras County, CA"
29,2015,Jun,20800,19447,1353,6.5,"Calaveras County, CA"
30,2015,Jul,20826,19431,1395,6.7,"Calaveras County, CA"
31,2015,Aug,20701,19438,1263,6.1,"Calaveras County, CA"
32,2015,Sep,20379,19205,1174,5.8,"Calaveras County, CA"
33,2015,Oct,20500,19297,1203,5.9,"Calaveras County, CA"
34,2015,Nov,20523,19322,1201,5.9,"Calaveras County, CA"
35,2015,Dec,20662,19444,1218,5.9,"Calaveras County, CA"
36,2016,Jan,20671,19357,1314,6.4,"Calaveras County, CA"
37,2016,Feb,20742,19479,1263,6.1,"Calaveras County, CA"
38,2016,Mar,20905,19574,1331,6.4,"Calaveras County, CA"
39,2016,Apr,20638,19440,1198,5.8,"Calaveras County, CA"
40,2016,May,20617,19529,1088,5.3,"Calaveras County, CA"
41,2016,Jun,20963,19761,1202,5.7,"Calaveras County, CA"
42,2016,Jul,20978,19771,1207,5.8,"Calaveras County, CA"
43,2016,Aug,20972,19819,1153,5.5,"Calaveras County, CA"
44,2016,Sep,21050,19931,1119,5.3,"Calaveras County, CA"
45,2016,Oct,20794,19687,1107,5.3,"Calaveras County, CA"
46,2016,Nov,20539,19445,1094,5.3,"Calaveras County, CA"
47,2016,Dec,20704,19582,1122,5.4,"Calaveras County, CA"
48,2017,Jan,20710,19443,1267,6.1,"Calaveras County, CA"
49,2017,Feb,20805,19594,1211,5.8,"Calaveras County, CA"
50,2017,Mar,20911,19788,1123,5.4,"Calaveras County, CA"
51,2017,Apr,20834,19834,1000,4.8,"Calaveras County, CA"
52,2017,May,20829,19885,944,4.5,"Calaveras County, CA"
53,2017,Jun,21189,20166,1023,4.8,"Calaveras County, CA"
54,2017,Jul,21366,20312,1054,4.9,"Calaveras County, CA"
55,2017,Aug,21410,20412,998,4.7,"Calaveras County, CA"
56,2017,Sep,21308,20447,861,4.0,"Calaveras County, CA"
57,2017,Oct,21169,20321,848,4.0,"Calaveras County, CA"
58,2017,Nov,20937,20100,837,4.0,"Calaveras County, CA"
59,2017,Dec,20717,19864,853,4.1,"Calaveras County, CA"
60,2018,Jan,20707,19733,974,4.7,"Calaveras County, CA"
61,2018,Feb,21019,20046,973,4.6,"Calaveras County, CA"
62,2018,Mar,20977,20025,952,4.5,"Calaveras County, CA"
63,2018,Apr,21000,20157,843,4.0,"Calaveras County, CA"
64,2018,May,21190,20441,749,3.5,"Calaveras County, CA"
65,2018,Jun,21287,20429,858,4.0,"Calaveras County, CA"
66,2018,Jul,21616,20756,860,4.0,"Calaveras County, CA"
67,2018,Aug,21494,20646,848,3.9,"Calaveras County, CA"
68,2018,Sep,21389,20612,777,3.6,"Calaveras County, CA"
69,2018,Oct,21256,20451,805,3.8,"Calaveras County, CA"
70,2018,Nov,20986,20195,791,3.8,"Calaveras County, CA"
71,2018,Dec,21059,20226,833,4.0,"Calaveras County, CA"
72,2019,Jan,20895,19857,1038,5.0,"Calaveras County, CA"
73,2019,Feb,21009,20033,976,4.6,"Calaveras County, CA"
74,2019,Mar,21096,20128,968,4.6,"Calaveras County, CA"
75,2019,Apr,20970,20194,776,3.7,"Calaveras County, CA"
76,2019,May,21151,20449,702,3.3,"Calaveras County, CA"
77,2019,Jun,21334,20528,806,3.8,"Calaveras County, CA"
78,2019,Jul,21778,20945,833,3.8,"Calaveras County, CA"
79,2019,Aug,21878,21078,800,3.7,"Calaveras County, CA"
80,2019,Sep,21719,21036,683,3.1,"Calaveras County, CA"
81,2019,Oct,21629,20896,733,3.4,"Calaveras County, CA"
82,2019,Nov,21395,20646,749,3.5,"Calaveras County, CA"
83,2019,Dec,21432,20662,770,3.6,"Calaveras County, CA"
84,2020,Jan,21657,20709,948,4.4,"Calaveras County, CA"
85,2020,Feb,21857,20955,902,4.1,"Calaveras County, CA"
86,2020,Mar,21686,20356,1330,6.1,"Calaveras County, CA"
87,2020,Apr,20739,17863,2876,13.9,"Calaveras County, CA"
88,2020,May,20558,18117,2441,11.9,"Calaveras County, CA"
89,2020,Jun,21656,19512,2144,9.9,"Calaveras County, CA"
90,2020,Jul,21703,19727,1976,9.1,"Calaveras County, CA"
91,2020,Aug,21683,20072,1611,7.4,"Calaveras County, CA"
92,2020,Sep,21528,19976,1552,7.2,"Calaveras County, CA"
93,2020,Oct,21392,19987,1405,6.6,"Calaveras County, CA"
94,2020,Nov,21153,19776,1377,6.5,"Calaveras County, CA"
95,2020,Dec,21127,19646,1481,7.0,"Calaveras County, CA"
96,2021,Jan,21103,19545,1558,7.4,"Calaveras County, CA"
97,2021,Feb,21215,19700,1515,7.1,"Calaveras County, CA"
98,2021,Mar,21374,19899,1475,6.9,"Calaveras County, CA"
99,2021,Apr,21386,20035,1351,6.3,"Calaveras County, CA"
100,2021,May,21394,20172,1222,5.7,"Calaveras County, CA"
101,2021,Jun,21817,20477,1340,6.1,"Calaveras County, CA"
102,2021,Jul,22016,20724,1292,5.9,"Calaveras County, CA"
103,2021,Aug,21916,20675,1241,5.7,"Calaveras County, CA"
104,2021,Sep,21831,20761,1070,4.9,"Calaveras County, CA"
105,2021,Oct,21800,20751,1049,4.8,"Calaveras County, CA"
106,2021,Nov,21729,20754,975,4.5,"Calaveras County, CA"
107,2021,Dec,21686,20781,905,4.2,"Calaveras County, CA"
108,2022,Jan,21982,20899,1083,4.9,"Calaveras County, CA"
109,2022,Feb,22277,21322,955,4.3,"Calaveras County, CA"
110,2022,Mar,22383,21502,881,3.9,"Calaveras County, CA"
111,2022,Apr,22108,21362,746,3.4,"Calaveras County, CA"
112,2022,May,22131,21446,685,3.1,"Calaveras County, CA"
113,2022,Jun,22256,21464,792,3.6,"Calaveras County, CA"
114,2022,Jul,22493,21722,771,3.4,"Calaveras County, CA"
115,2022,Aug,22552,21764,788,3.5,"Calaveras County, CA"
116,2022,Sep,22394,21687,707,3.2,"Calaveras County, CA"
117,2022,Oct,22282,21517,765,3.4,"Calaveras County, CA"
118,2022,Nov,22137,21341,796,3.6,"Calaveras County, CA"
119,2022,Dec,22200,21433,767,3.5,"Calaveras County, CA"
120,2023,Jan,22164,21148,1016,4.6,"Calaveras County, CA"
121,2023,Feb,22386,21399,987,4.4,"Calaveras County, CA"
122,2023,Mar,22490,21454,1036,4.6,"Calaveras County, CA"
123,2023,Apr,21991,21135,856,3.9,"Calaveras County, CA"
124,2023,May,22013,21158,855,3.9,"Calaveras County, CA"
125,2023,Jun,22238,21354,884,4.0,"Calaveras County, CA"
126,2023,Jul,22371,21503,868,3.9,"Calaveras County, CA"
127,2023,Aug,22500,21551,949,4.2,"Calaveras County, CA"
128,2023,Sep,22551,21649,902,4.0,"Calaveras County, CA"
129,2023,Oct,22347,21440,907,4.1,"Calaveras County, CA"
0,2013,Jan,897499,798291,99208,11.1,"San Bernardino County, CA"
1,2013,Feb,894959,801148,93811,10.5,"San Bernardino County, CA"
2,2013,Mar,893418,802375,91043,10.2,"San Bernardino County, CA"
3,2013,Apr,886958,802372,84586,9.5,"San Bernardino County, CA"
4,2013,May,888101,803172,84929,9.6,"San Bernardino County, CA"
5,2013,Jun,892835,798359,94476,10.6,"San Bernardino County, CA"
6,2013,Jul,892326,797659,94667,10.6,"San Bernardino County, CA"
7,2013,Aug,889875,800003,89872,10.1,"San Bernardino County, CA"
8,2013,Sep,894198,808954,85244,9.5,"San Bernardino County, CA"
9,2013,Oct,893876,808666,85210,9.5,"San Bernardino County, CA"
10,2013,Nov,900813,820194,80619,8.9,"San Bernardino County, CA"
11,2013,Dec,898455,821333,77122,8.6,"San Bernardino County, CA"
12,2014,Jan,897536,816592,80944,9.0,"San Bernardino County, CA"
13,2014,Feb,900191,819659,80532,8.9,"San Bernardino County, CA"
14,2014,Mar,903856,823309,80547,8.9,"San Bernardino County, CA"
15,2014,Apr,892864,822825,70039,7.8,"San Bernardino County, CA"
16,2014,May,895141,824744,70397,7.9,"San Bernardino County, CA"
17,2014,Jun,897414,821735,75679,8.4,"San Bernardino County, CA"
18,2014,Jul,901036,821095,79941,8.9,"San Bernardino County, CA"
19,2014,Aug,899908,824206,75702,8.4,"San Bernardino County, CA"
20,2014,Sep,903001,834023,68978,7.6,"San Bernardino County, CA"
21,2014,Oct,912293,844381,67912,7.4,"San Bernardino County, CA"
22,2014,Nov,922217,855858,66359,7.2,"San Bernardino County, CA"
23,2014,Dec,918331,857107,61224,6.7,"San Bernardino County, CA"
24,2015,Jan,916141,849586,66555,7.3,"San Bernardino County, CA"
25,2015,Feb,915967,852571,63396,6.9,"San Bernardino County, CA"
26,2015,Mar,916172,853659,62513,6.8,"San Bernardino County, CA"
27,2015,Apr,911905,853482,58423,6.4,"San Bernardino County, CA"
28,2015,May,914875,856411,58464,6.4,"San Bernardino County, CA"
29,2015,Jun,914583,851655,62928,6.9,"San Bernardino County, CA"
30,2015,Jul,915800,851158,64642,7.1,"San Bernardino County, CA"
31,2015,Aug,914282,854243,60039,6.6,"San Bernardino County, CA"
32,2015,Sep,914904,859364,55540,6.1,"San Bernardino County, CA"
33,2015,Oct,924617,868483,56134,6.1,"San Bernardino County, CA"
34,2015,Nov,934799,880458,54341,5.8,"San Bernardino County, CA"
35,2015,Dec,937657,885729,51928,5.5,"San Bernardino County, CA"
36,2016,Jan,928745,874342,54403,5.9,"San Bernardino County, CA"
37,2016,Feb,928446,874328,54118,5.8,"San Bernardino County, CA"
38,2016,Mar,932229,876965,55264,5.9,"San Bernardino County, CA"
39,2016,Apr,923110,871202,51908,5.6,"San Bernardino County, CA"
40,2016,May,922454,873588,48866,5.3,"San Bernardino County, CA"
41,2016,Jun,925073,866719,58354,6.3,"San Bernardino County, CA"
42,2016,Jul,928518,868862,59656,6.4,"San Bernardino County, CA"
43,2016,Aug,926876,869639,57237,6.2,"San Bernardino County, CA"
44,2016,Sep,931951,877357,54594,5.9,"San Bernardino County, CA"
45,2016,Oct,936317,882647,53670,5.7,"San Bernardino County, CA"
46,2016,Nov,940575,890605,49970,5.3,"San Bernardino County, CA"
47,2016,Dec,938614,890393,48221,5.1,"San Bernardino County, CA"
48,2017,Jan,940464,887056,53408,5.7,"San Bernardino County, CA"
49,2017,Feb,940115,889038,51077,5.4,"San Bernardino County, CA"
50,2017,Mar,942893,893613,49280,5.2,"San Bernardino County, CA"
51,2017,Apr,932359,887727,44632,4.8,"San Bernardino County, CA"
52,2017,May,933332,890569,42763,4.6,"San Bernardino County, CA"
53,2017,Jun,935198,885248,49950,5.3,"San Bernardino County, CA"
54,2017,Jul,941740,889457,52283,5.6,"San Bernardino County, CA"
55,2017,Aug,939231,889012,50219,5.3,"San Bernardino County, CA"
56,2017,Sep,946346,901957,44389,4.7,"San Bernardino County, CA"
57,2017,Oct,946478,903720,42758,4.5,"San Bernardino County, CA"
58,2017,Nov,955613,914334,41279,4.3,"San Bernardino County, CA"
59,2017,Dec,950806,911444,39362,4.1,"San Bernardino County, CA"
60,2018,Jan,949426,906356,43070,4.5,"San Bernardino County, CA"
61,2018,Feb,954829,913178,41651,4.4,"San Bernardino County, CA"
62,2018,Mar,955221,915655,39566,4.1,"San Bernardino County, CA"
63,2018,Apr,946596,910451,36145,3.8,"San Bernardino County, CA"
64,2018,May,948341,914394,33947,3.6,"San Bernardino County, CA"
65,2018,Jun,950878,908449,42429,4.5,"San Bernardino County, CA"
66,2018,Jul,956596,913703,42893,4.5,"San Bernardino County, CA"
67,2018,Aug,946956,905943,41013,4.3,"San Bernardino County, CA"
68,2018,Sep,954846,917347,37499,3.9,"San Bernardino County, CA"
69,2018,Oct,961024,922912,38112,4.0,"San Bernardino County, CA"
70,2018,Nov,968628,931424,37204,3.8,"San Bernardino County, CA"
71,2018,Dec,967734,930279,37455,3.9,"San Bernardino County, CA"
72,2019,Jan,966482,922695,43787,4.5,"San Bernardino County, CA"
73,2019,Feb,967333,928158,39175,4.0,"San Bernardino County, CA"
74,2019,Mar,967048,927713,39335,4.1,"San Bernardino County, CA"
75,2019,Apr,955375,922237,33138,3.5,"San Bernardino County, CA"
76,2019,May,955095,922598,32497,3.4,"San Bernardino County, CA"
77,2019,Jun,956432,917119,39313,4.1,"San Bernardino County, CA"
78,2019,Jul,965469,923156,42313,4.4,"San Bernardino County, CA"
79,2019,Aug,961032,921510,39522,4.1,"San Bernardino County, CA"
80,2019,Sep,965469,931120,34349,3.6,"San Bernardino County, CA"
81,2019,Oct,975241,939582,35659,3.7,"San Bernardino County, CA"
82,2019,Nov,984890,949436,35454,3.6,"San Bernardino County, CA"
83,2019,Dec,985676,951859,33817,3.4,"San Bernardino County, CA"
84,2020,Jan,983330,944582,38748,3.9,"San Bernardino County, CA"
85,2020,Feb,989808,952834,36974,3.7,"San Bernardino County, CA"
86,2020,Mar,980058,925739,54319,5.5,"San Bernardino County, CA"
87,2020,Apr,943635,807334,136301,14.4,"San Bernardino County, CA"
88,2020,May,935576,801141,134435,14.4,"San Bernardino County, CA"
89,2020,Jun,976995,851667,125328,12.8,"San Bernardino County, CA"
90,2020,Jul,977176,852912,124264,12.7,"San Bernardino County, CA"
91,2020,Aug,972256,867563,104693,10.8,"San Bernardino County, CA"
92,2020,Sep,975890,874961,100929,10.3,"San Bernardino County, CA"
93,2020,Oct,985662,894108,91554,9.3,"San Bernardino County, CA"
94,2020,Nov,988896,899337,89559,9.1,"San Bernardino County, CA"
95,2020,Dec,987296,898461,88835,9.0,"San Bernardino County, CA"
96,2021,Jan,982790,894685,88105,9.0,"San Bernardino County, CA"
97,2021,Feb,992148,906020,86128,8.7,"San Bernardino County, CA"
98,2021,Mar,989985,906920,83065,8.4,"San Bernardino County, CA"
99,2021,Apr,982765,902020,80745,8.2,"San Bernardino County, CA"
100,2021,May,985420,910210,75210,7.6,"San Bernardino County, CA"
101,2021,Jun,988286,904225,84061,8.5,"San Bernardino County, CA"
102,2021,Jul,994171,914096,80075,8.1,"San Bernardino County, CA"
103,2021,Aug,989708,914930,74778,7.6,"San Bernardino County, CA"
104,2021,Sep,989878,925371,64507,6.5,"San Bernardino County, CA"
105,2021,Oct,998966,937221,61745,6.2,"San Bernardino County, CA"
106,2021,Nov,1005974,950963,55011,5.5,"San Bernardino County, CA"
107,2021,Dec,1006660,956676,49984,5.0,"San Bernardino County, CA"
108,2022,Jan,1009114,954153,54961,5.4,"San Bernardino County, CA"
109,2022,Feb,1017714,969327,48387,4.8,"San Bernardino County, CA"
110,2022,Mar,1017241,974185,43056,4.2,"San Bernardino County, CA"
111,2022,Apr,999914,962670,37244,3.7,"San Bernardino County, CA"
112,2022,May,1001750,967237,34513,3.4,"San Bernardino County, CA"
113,2022,Jun,997825,957122,40703,4.1,"San Bernardino County, CA"
114,2022,Jul,1003313,962189,41124,4.1,"San Bernardino County, CA"
115,2022,Aug,1003647,962087,41560,4.1,"San Bernardino County, CA"
116,2022,Sep,1007538,970015,37523,3.7,"San Bernardino County, CA"
117,2022,Oct,1013870,974048,39822,3.9,"San Bernardino County, CA"
118,2022,Nov,1013535,973162,40373,4.0,"San Bernardino County, CA"
119,2022,Dec,1016438,979614,36824,3.6,"San Bernardino County, CA"
120,2023,Jan,1007405,963262,44143,4.4,"San Bernardino County, CA"
121,2023,Feb,1012408,966754,45654,4.5,"San Bernardino County, CA"
122,2023,Mar,1014559,968624,45935,4.5,"San Bernardino County, CA"
123,2023,Apr,999743,958881,40862,4.1,"San Bernardino County, CA"
124,2023,May,999408,955937,43471,4.3,"San Bernardino County, CA"
125,2023,Jun,992422,943427,48995,4.9,"San Bernardino County, CA"
126,2023,Jul,999348,951047,48301,4.8,"San Bernardino County, CA"
127,2023,Aug,999444,948244,51200,5.1,"San Bernardino County, CA"
128,2023,Sep,1010623,962100,48523,4.8,"San Bernardino County, CA"
129,2023,Oct,1015779,965140,50639,5.0,"San Bernardino County, CA"
0,2013,Jan,241091,204195,36896,15.3,"Stanislaus County, CA"
1,2013,Feb,239955,204587,35368,14.7,"Stanislaus County, CA"
2,2013,Mar,241243,206605,34638,14.4,"Stanislaus County, CA"
3,2013,Apr,238916,206550,32366,13.5,"Stanislaus County, CA"
4,2013,May,240900,210077,30823,12.8,"Stanislaus County, CA"
5,2013,Jun,240774,208068,32706,13.6,"Stanislaus County, CA"
6,2013,Jul,243119,211553,31566,13.0,"Stanislaus County, CA"
7,2013,Aug,243324,213991,29333,12.1,"Stanislaus County, CA"
8,2013,Sep,242458,214791,27667,11.4,"Stanislaus County, CA"
9,2013,Oct,238361,209951,28410,11.9,"Stanislaus County, CA"
10,2013,Nov,236929,207871,29058,12.3,"Stanislaus County, CA"
11,2013,Dec,236149,207155,28994,12.3,"Stanislaus County, CA"
12,2014,Jan,238646,207337,31309,13.1,"Stanislaus County, CA"
13,2014,Feb,239726,208331,31395,13.1,"Stanislaus County, CA"
14,2014,Mar,241405,209385,32020,13.3,"Stanislaus County, CA"
15,2014,Apr,238466,210294,28172,11.8,"Stanislaus County, CA"
16,2014,May,240238,213215,27023,11.2,"Stanislaus County, CA"
17,2014,Jun,240924,213471,27453,11.4,"Stanislaus County, CA"
18,2014,Jul,243705,216283,27422,11.3,"Stanislaus County, CA"
19,2014,Aug,243301,218094,25207,10.4,"Stanislaus County, CA"
20,2014,Sep,240990,217804,23186,9.6,"Stanislaus County, CA"
21,2014,Oct,239351,215953,23398,9.8,"Stanislaus County, CA"
22,2014,Nov,239229,214520,24709,10.3,"Stanislaus County, CA"
23,2014,Dec,236681,212256,24425,10.3,"Stanislaus County, CA"
24,2015,Jan,239862,213143,26719,11.1,"Stanislaus County, CA"
25,2015,Feb,240410,214045,26365,11.0,"Stanislaus County, CA"
26,2015,Mar,241336,215096,26240,10.9,"Stanislaus County, CA"
27,2015,Apr,240003,215797,24206,10.1,"Stanislaus County, CA"
28,2015,May,241708,218517,23191,9.6,"Stanislaus County, CA"
29,2015,Jun,240770,216883,23887,9.9,"Stanislaus County, CA"
30,2015,Jul,242166,219054,23112,9.5,"Stanislaus County, CA"
31,2015,Aug,244559,223749,20810,8.5,"Stanislaus County, CA"
32,2015,Sep,241566,222372,19194,7.9,"Stanislaus County, CA"
33,2015,Oct,240243,220102,20141,8.4,"Stanislaus County, CA"
34,2015,Nov,240089,218981,21108,8.8,"Stanislaus County, CA"
35,2015,Dec,239118,217917,21201,8.9,"Stanislaus County, CA"
36,2016,Jan,240295,216959,23336,9.7,"Stanislaus County, CA"
37,2016,Feb,241171,217806,23365,9.7,"Stanislaus County, CA"
38,2016,Mar,244054,219586,24468,10.0,"Stanislaus County, CA"
39,2016,Apr,240435,218369,22066,9.2,"Stanislaus County, CA"
40,2016,May,242192,222493,19699,8.1,"Stanislaus County, CA"
41,2016,Jun,241714,219944,21770,9.0,"Stanislaus County, CA"
42,2016,Jul,246161,225210,20951,8.5,"Stanislaus County, CA"
43,2016,Aug,246718,227419,19299,7.8,"Stanislaus County, CA"
44,2016,Sep,246170,227913,18257,7.4,"Stanislaus County, CA"
45,2016,Oct,242907,224068,18839,7.8,"Stanislaus County, CA"
46,2016,Nov,241963,222749,19214,7.9,"Stanislaus County, CA"
47,2016,Dec,239066,218712,20354,8.5,"Stanislaus County, CA"
48,2017,Jan,239292,217388,21904,9.2,"Stanislaus County, CA"
49,2017,Feb,241365,219488,21877,9.1,"Stanislaus County, CA"
50,2017,Mar,243069,221587,21482,8.8,"Stanislaus County, CA"
51,2017,Apr,240886,221455,19431,8.1,"Stanislaus County, CA"
52,2017,May,242744,224956,17788,7.3,"Stanislaus County, CA"
53,2017,Jun,241219,222344,18875,7.8,"Stanislaus County, CA"
54,2017,Jul,244441,225758,18683,7.6,"Stanislaus County, CA"
55,2017,Aug,245992,228935,17057,6.9,"Stanislaus County, CA"
56,2017,Sep,243547,228676,14871,6.1,"Stanislaus County, CA"
57,2017,Oct,240898,226202,14696,6.1,"Stanislaus County, CA"
58,2017,Nov,241065,225350,15715,6.5,"Stanislaus County, CA"
59,2017,Dec,239134,222677,16457,6.9,"Stanislaus County, CA"
60,2018,Jan,240281,222200,18081,7.5,"Stanislaus County, CA"
61,2018,Feb,242455,224416,18039,7.4,"Stanislaus County, CA"
62,2018,Mar,242664,224783,17881,7.4,"Stanislaus County, CA"
63,2018,Apr,241487,225578,15909,6.6,"Stanislaus County, CA"
64,2018,May,244728,230010,14718,6.0,"Stanislaus County, CA"
65,2018,Jun,244002,227072,16930,6.9,"Stanislaus County, CA"
66,2018,Jul,245776,229161,16615,6.8,"Stanislaus County, CA"
67,2018,Aug,243857,229146,14711,6.0,"Stanislaus County, CA"
68,2018,Sep,245166,232119,13047,5.3,"Stanislaus County, CA"
69,2018,Oct,243491,230115,13376,5.5,"Stanislaus County, CA"
70,2018,Nov,242841,228737,14104,5.8,"Stanislaus County, CA"
71,2018,Dec,239914,224375,15539,6.5,"Stanislaus County, CA"
72,2019,Jan,241702,223493,18209,7.5,"Stanislaus County, CA"
73,2019,Feb,242325,225285,17040,7.0,"Stanislaus County, CA"
74,2019,Mar,243702,226604,17098,7.0,"Stanislaus County, CA"
75,2019,Apr,240659,225865,14794,6.1,"Stanislaus County, CA"
76,2019,May,242231,228638,13593,5.6,"Stanislaus County, CA"
77,2019,Jun,241733,226378,15355,6.4,"Stanislaus County, CA"
78,2019,Jul,244881,229243,15638,6.4,"Stanislaus County, CA"
79,2019,Aug,243981,229916,14065,5.8,"Stanislaus County, CA"
80,2019,Sep,245521,233504,12017,4.9,"Stanislaus County, CA"
81,2019,Oct,243149,230650,12499,5.1,"Stanislaus County, CA"
82,2019,Nov,243964,230666,13298,5.5,"Stanislaus County, CA"
83,2019,Dec,241266,227134,14132,5.9,"Stanislaus County, CA"
84,2020,Jan,242161,225791,16370,6.8,"Stanislaus County, CA"
85,2020,Feb,244787,228874,15913,6.5,"Stanislaus County, CA"
86,2020,Mar,247628,224373,23255,9.4,"Stanislaus County, CA"
87,2020,Apr,242929,200502,42427,17.5,"Stanislaus County, CA"
88,2020,May,238061,200317,37744,15.9,"Stanislaus County, CA"
89,2020,Jun,243857,210853,33004,13.5,"Stanislaus County, CA"
90,2020,Jul,244404,212686,31718,13.0,"Stanislaus County, CA"
91,2020,Aug,245005,218904,26101,10.7,"Stanislaus County, CA"
92,2020,Sep,244067,219194,24873,10.2,"Stanislaus County, CA"
93,2020,Oct,240330,217934,22396,9.3,"Stanislaus County, CA"
94,2020,Nov,239377,216841,22536,9.4,"Stanislaus County, CA"
95,2020,Dec,237265,214155,23110,9.7,"Stanislaus County, CA"
96,2021,Jan,238343,214534,23809,10.0,"Stanislaus County, CA"
97,2021,Feb,240009,216335,23674,9.9,"Stanislaus County, CA"
98,2021,Mar,240768,217547,23221,9.6,"Stanislaus County, CA"
99,2021,Apr,239266,216763,22503,9.4,"Stanislaus County, CA"
100,2021,May,239991,219350,20641,8.6,"Stanislaus County, CA"
101,2021,Jun,240643,217711,22932,9.5,"Stanislaus County, CA"
102,2021,Jul,243701,222437,21264,8.7,"Stanislaus County, CA"
103,2021,Aug,242085,222456,19629,8.1,"Stanislaus County, CA"
104,2021,Sep,241399,224646,16753,6.9,"Stanislaus County, CA"
105,2021,Oct,239356,223031,16325,6.8,"Stanislaus County, CA"
106,2021,Nov,239273,224081,15192,6.3,"Stanislaus County, CA"
107,2021,Dec,237560,223039,14521,6.1,"Stanislaus County, CA"
108,2022,Jan,240279,223461,16818,7.0,"Stanislaus County, CA"
109,2022,Feb,241431,226052,15379,6.4,"Stanislaus County, CA"
110,2022,Mar,242057,227896,14161,5.9,"Stanislaus County, CA"
111,2022,Apr,238932,226246,12686,5.3,"Stanislaus County, CA"
112,2022,May,242013,230442,11571,4.8,"Stanislaus County, CA"
113,2022,Jun,239800,226717,13083,5.5,"Stanislaus County, CA"
114,2022,Jul,244681,231825,12856,5.3,"Stanislaus County, CA"
115,2022,Aug,244565,232146,12419,5.1,"Stanislaus County, CA"
116,2022,Sep,244760,233688,11072,4.5,"Stanislaus County, CA"
117,2022,Oct,243034,231115,11919,4.9,"Stanislaus County, CA"
118,2022,Nov,242692,229810,12882,5.3,"Stanislaus County, CA"
119,2022,Dec,243061,230221,12840,5.3,"Stanislaus County, CA"
120,2023,Jan,242287,226487,15800,6.5,"Stanislaus County, CA"
121,2023,Feb,244332,227777,16555,6.8,"Stanislaus County, CA"
122,2023,Mar,246098,228953,17145,7.0,"Stanislaus County, CA"
123,2023,Apr,243290,228109,15181,6.2,"Stanislaus County, CA"
124,2023,May,245225,229517,15708,6.4,"Stanislaus County, CA"
125,2023,Jun,243170,226592,16578,6.8,"Stanislaus County, CA"
126,2023,Jul,241761,225873,15888,6.6,"Stanislaus County, CA"
127,2023,Aug,243422,227737,15685,6.4,"Stanislaus County, CA"
128,2023,Sep,246776,232536,14240,5.8,"Stanislaus County, CA"
129,2023,Oct,247096,232249,14847,6.0,"Stanislaus County, CA"
0,2013,Jan,94712,87482,7230,7.6,"Clay County, FL"
1,2013,Feb,94695,88047,6648,7.0,"Clay County, FL"
2,2013,Mar,95043,88731,6312,6.6,"Clay County, FL"
3,2013,Apr,95348,89278,6070,6.4,"Clay County, FL"
4,2013,May,96903,90607,6296,6.5,"Clay County, FL"
5,2013,Jun,97822,91011,6811,7.0,"Clay County, FL"
6,2013,Jul,98448,91701,6747,6.9,"Clay County, FL"
7,2013,Aug,98019,91526,6493,6.6,"Clay County, FL"
8,2013,Sep,98381,92049,6332,6.4,"Clay County, FL"
9,2013,Oct,97442,91266,6176,6.3,"Clay County, FL"
10,2013,Nov,96554,90563,5991,6.2,"Clay County, FL"
11,2013,Dec,96534,90804,5730,5.9,"Clay County, FL"
12,2014,Jan,95736,89610,6126,6.4,"Clay County, FL"
13,2014,Feb,96109,90168,5941,6.2,"Clay County, FL"
14,2014,Mar,96740,90869,5871,6.1,"Clay County, FL"
15,2014,Apr,96428,91124,5304,5.5,"Clay County, FL"
16,2014,May,97861,92168,5693,5.8,"Clay County, FL"
17,2014,Jun,98343,92317,6026,6.1,"Clay County, FL"
18,2014,Jul,98865,92539,6326,6.4,"Clay County, FL"
19,2014,Aug,98697,92553,6144,6.2,"Clay County, FL"
20,2014,Sep,98609,92883,5726,5.8,"Clay County, FL"
21,2014,Oct,98852,93367,5485,5.5,"Clay County, FL"
22,2014,Nov,97691,92194,5497,5.6,"Clay County, FL"
23,2014,Dec,97780,92611,5169,5.3,"Clay County, FL"
24,2015,Jan,97186,91507,5679,5.8,"Clay County, FL"
25,2015,Feb,97307,92166,5141,5.3,"Clay County, FL"
26,2015,Mar,97723,92815,4908,5.0,"Clay County, FL"
27,2015,Apr,97844,93084,4760,4.9,"Clay County, FL"
28,2015,May,99229,94141,5088,5.1,"Clay County, FL"
29,2015,Jun,99699,94403,5296,5.3,"Clay County, FL"
30,2015,Jul,99916,94601,5315,5.3,"Clay County, FL"
31,2015,Aug,99559,94460,5099,5.1,"Clay County, FL"
32,2015,Sep,99789,94866,4923,4.9,"Clay County, FL"
33,2015,Oct,99737,94942,4795,4.8,"Clay County, FL"
34,2015,Nov,98941,94116,4825,4.9,"Clay County, FL"
35,2015,Dec,99113,94551,4562,4.6,"Clay County, FL"
36,2016,Jan,98918,94021,4897,5.0,"Clay County, FL"
37,2016,Feb,99456,94960,4496,4.5,"Clay County, FL"
38,2016,Mar,99860,95412,4448,4.5,"Clay County, FL"
39,2016,Apr,100039,95748,4291,4.3,"Clay County, FL"
40,2016,May,101301,97079,4222,4.2,"Clay County, FL"
41,2016,Jun,102150,97278,4872,4.8,"Clay County, FL"
42,2016,Jul,102837,97919,4918,4.8,"Clay County, FL"
43,2016,Aug,102708,97816,4892,4.8,"Clay County, FL"
44,2016,Sep,103241,98417,4824,4.7,"Clay County, FL"
45,2016,Oct,102364,97788,4576,4.5,"Clay County, FL"
46,2016,Nov,101700,97243,4457,4.4,"Clay County, FL"
47,2016,Dec,101563,97282,4281,4.2,"Clay County, FL"
48,2017,Jan,100907,96211,4696,4.7,"Clay County, FL"
49,2017,Feb,101430,97171,4259,4.2,"Clay County, FL"
50,2017,Mar,101762,97732,4030,4.0,"Clay County, FL"
51,2017,Apr,102205,98389,3816,3.7,"Clay County, FL"
52,2017,May,103191,99274,3917,3.8,"Clay County, FL"
53,2017,Jun,104157,99800,4357,4.2,"Clay County, FL"
54,2017,Jul,104924,100465,4459,4.2,"Clay County, FL"
55,2017,Aug,104141,99829,4312,4.1,"Clay County, FL"
56,2017,Sep,104900,100940,3960,3.8,"Clay County, FL"
57,2017,Oct,104415,100626,3789,3.6,"Clay County, FL"
58,2017,Nov,104092,100253,3839,3.7,"Clay County, FL"
59,2017,Dec,103909,100362,3547,3.4,"Clay County, FL"
60,2018,Jan,103479,99507,3972,3.8,"Clay County, FL"
61,2018,Feb,103825,100173,3652,3.5,"Clay County, FL"
62,2018,Mar,103780,100259,3521,3.4,"Clay County, FL"
63,2018,Apr,103757,100409,3348,3.2,"Clay County, FL"
64,2018,May,104810,101512,3298,3.1,"Clay County, FL"
65,2018,Jun,106110,102182,3928,3.7,"Clay County, FL"
66,2018,Jul,106550,102706,3844,3.6,"Clay County, FL"
67,2018,Aug,105869,102225,3644,3.4,"Clay County, FL"
68,2018,Sep,106427,103041,3386,3.2,"Clay County, FL"
69,2018,Oct,105986,102537,3449,3.3,"Clay County, FL"
70,2018,Nov,105453,102129,3324,3.2,"Clay County, FL"
71,2018,Dec,105651,102315,3336,3.2,"Clay County, FL"
72,2019,Jan,104850,100927,3923,3.7,"Clay County, FL"
73,2019,Feb,104838,101496,3342,3.2,"Clay County, FL"
74,2019,Mar,104763,101477,3286,3.1,"Clay County, FL"
75,2019,Apr,104766,101826,2940,2.8,"Clay County, FL"
76,2019,May,106186,103113,3073,2.9,"Clay County, FL"
77,2019,Jun,107417,103807,3610,3.4,"Clay County, FL"
78,2019,Jul,108201,104495,3706,3.4,"Clay County, FL"
79,2019,Aug,108204,104614,3590,3.3,"Clay County, FL"
80,2019,Sep,108647,105416,3231,3.0,"Clay County, FL"
81,2019,Oct,108421,105183,3238,3.0,"Clay County, FL"
82,2019,Nov,107927,104836,3091,2.9,"Clay County, FL"
83,2019,Dec,107948,105090,2858,2.6,"Clay County, FL"
84,2020,Jan,106800,103433,3367,3.2,"Clay County, FL"
85,2020,Feb,106864,103984,2880,2.7,"Clay County, FL"
86,2020,Mar,104899,100754,4145,4.0,"Clay County, FL"
87,2020,Apr,95577,86917,8660,9.1,"Clay County, FL"
88,2020,May,102213,92777,9436,9.2,"Clay County, FL"
89,2020,Jun,103615,95678,7937,7.7,"Clay County, FL"
90,2020,Jul,105863,97116,8747,8.3,"Clay County, FL"
91,2020,Aug,105284,99306,5978,5.7,"Clay County, FL"
92,2020,Sep,106444,100856,5588,5.2,"Clay County, FL"
93,2020,Oct,106782,101843,4939,4.6,"Clay County, FL"
94,2020,Nov,106431,101666,4765,4.5,"Clay County, FL"
95,2020,Dec,106412,101864,4548,4.3,"Clay County, FL"
96,2021,Jan,105916,101162,4754,4.5,"Clay County, FL"
97,2021,Feb,106117,101799,4318,4.1,"Clay County, FL"
98,2021,Mar,106460,102356,4104,3.9,"Clay County, FL"
99,2021,Apr,106628,102807,3821,3.6,"Clay County, FL"
100,2021,May,107536,103887,3649,3.4,"Clay County, FL"
101,2021,Jun,108711,104262,4449,4.1,"Clay County, FL"
102,2021,Jul,109118,104821,4297,3.9,"Clay County, FL"
103,2021,Aug,109349,105298,4051,3.7,"Clay County, FL"
104,2021,Sep,110080,106443,3637,3.3,"Clay County, FL"
105,2021,Oct,110199,106659,3540,3.2,"Clay County, FL"
106,2021,Nov,110316,107026,3290,3.0,"Clay County, FL"
107,2021,Dec,110518,107582,2936,2.7,"Clay County, FL"
108,2022,Jan,110792,107117,3675,3.3,"Clay County, FL"
109,2022,Feb,110807,107562,3245,2.9,"Clay County, FL"
110,2022,Mar,111392,108434,2958,2.7,"Clay County, FL"
111,2022,Apr,111444,108773,2671,2.4,"Clay County, FL"
112,2022,May,112633,109828,2805,2.5,"Clay County, FL"
113,2022,Jun,113476,110197,3279,2.9,"Clay County, FL"
114,2022,Jul,114148,110968,3180,2.8,"Clay County, FL"
115,2022,Aug,114392,111227,3165,2.8,"Clay County, FL"
116,2022,Sep,114682,111877,2805,2.4,"Clay County, FL"
117,2022,Oct,114670,111839,2831,2.5,"Clay County, FL"
118,2022,Nov,114096,111297,2799,2.5,"Clay County, FL"
119,2022,Dec,115071,112692,2379,2.1,"Clay County, FL"
120,2023,Jan,115098,112312,2786,2.4,"Clay County, FL"
121,2023,Feb,116256,113442,2814,2.4,"Clay County, FL"
122,2023,Mar,116881,114038,2843,2.4,"Clay County, FL"
123,2023,Apr,116570,114039,2531,2.2,"Clay County, FL"
124,2023,May,117512,114505,3007,2.6,"Clay County, FL"
125,2023,Jun,119730,116278,3452,2.9,"Clay County, FL"
126,2023,Jul,120013,116429,3584,3.0,"Clay County, FL"
127,2023,Aug,121037,117381,3656,3.0,"Clay County, FL"
128,2023,Sep,121110,117559,3551,2.9,"Clay County, FL"
129,2023,Oct,121237,117517,3720,3.1,"Clay County, FL"
0,2013,Jan,44189,41621,2568,5.8,"Monroe County, FL"
1,2013,Feb,44101,41787,2314,5.2,"Monroe County, FL"
2,2013,Mar,44322,42146,2176,4.9,"Monroe County, FL"
3,2013,Apr,44179,42072,2107,4.8,"Monroe County, FL"
4,2013,May,44529,42289,2240,5.0,"Monroe County, FL"
5,2013,Jun,44797,42469,2328,5.2,"Monroe County, FL"
6,2013,Jul,44865,42543,2322,5.2,"Monroe County, FL"
7,2013,Aug,44482,42259,2223,5.0,"Monroe County, FL"
8,2013,Sep,43729,41519,2210,5.1,"Monroe County, FL"
9,2013,Oct,43413,41221,2192,5.0,"Monroe County, FL"
10,2013,Nov,43392,41287,2105,4.9,"Monroe County, FL"
11,2013,Dec,43834,41845,1989,4.5,"Monroe County, FL"
12,2014,Jan,44535,42450,2085,4.7,"Monroe County, FL"
13,2014,Feb,44950,42941,2009,4.5,"Monroe County, FL"
14,2014,Mar,45252,43250,2002,4.4,"Monroe County, FL"
15,2014,Apr,44922,43157,1765,3.9,"Monroe County, FL"
16,2014,May,44970,43046,1924,4.3,"Monroe County, FL"
17,2014,Jun,45255,43366,1889,4.2,"Monroe County, FL"
18,2014,Jul,45388,43371,2017,4.4,"Monroe County, FL"
19,2014,Aug,44909,42947,1962,4.4,"Monroe County, FL"
20,2014,Sep,44384,42525,1859,4.2,"Monroe County, FL"
21,2014,Oct,44790,42969,1821,4.1,"Monroe County, FL"
22,2014,Nov,44725,42918,1807,4.0,"Monroe County, FL"
23,2014,Dec,45210,43511,1699,3.8,"Monroe County, FL"
24,2015,Jan,45940,44109,1831,4.0,"Monroe County, FL"
25,2015,Feb,46009,44317,1692,3.7,"Monroe County, FL"
26,2015,Mar,46135,44524,1611,3.5,"Monroe County, FL"
27,2015,Apr,45894,44336,1558,3.4,"Monroe County, FL"
28,2015,May,46351,44712,1639,3.5,"Monroe County, FL"
29,2015,Jun,46075,44427,1648,3.6,"Monroe County, FL"
30,2015,Jul,45773,44068,1705,3.7,"Monroe County, FL"
31,2015,Aug,46211,44571,1640,3.5,"Monroe County, FL"
32,2015,Sep,45556,44022,1534,3.4,"Monroe County, FL"
33,2015,Oct,45728,44179,1549,3.4,"Monroe County, FL"
34,2015,Nov,45721,44204,1517,3.3,"Monroe County, FL"
35,2015,Dec,45982,44518,1464,3.2,"Monroe County, FL"
36,2016,Jan,46494,44910,1584,3.4,"Monroe County, FL"
37,2016,Feb,46739,45247,1492,3.2,"Monroe County, FL"
38,2016,Mar,46984,45492,1492,3.2,"Monroe County, FL"
39,2016,Apr,46540,45106,1434,3.1,"Monroe County, FL"
40,2016,May,46778,45359,1419,3.0,"Monroe County, FL"
41,2016,Jun,46315,44797,1518,3.3,"Monroe County, FL"
42,2016,Jul,46448,44863,1585,3.4,"Monroe County, FL"
43,2016,Aug,46867,45328,1539,3.3,"Monroe County, FL"
44,2016,Sep,46453,44906,1547,3.3,"Monroe County, FL"
45,2016,Oct,46387,44868,1519,3.3,"Monroe County, FL"
46,2016,Nov,46502,45063,1439,3.1,"Monroe County, FL"
47,2016,Dec,46598,45206,1392,3.0,"Monroe County, FL"
48,2017,Jan,46478,44994,1484,3.2,"Monroe County, FL"
49,2017,Feb,46688,45311,1377,2.9,"Monroe County, FL"
50,2017,Mar,46954,45680,1274,2.7,"Monroe County, FL"
51,2017,Apr,47061,45868,1193,2.5,"Monroe County, FL"
52,2017,May,46858,45602,1256,2.7,"Monroe County, FL"
53,2017,Jun,46413,45111,1302,2.8,"Monroe County, FL"
54,2017,Jul,46024,44698,1326,2.9,"Monroe County, FL"
55,2017,Aug,45949,44618,1331,2.9,"Monroe County, FL"
56,2017,Sep,40994,38593,2401,5.9,"Monroe County, FL"
57,2017,Oct,43033,41028,2005,4.7,"Monroe County, FL"
58,2017,Nov,43260,41621,1639,3.8,"Monroe County, FL"
59,2017,Dec,44023,42583,1440,3.3,"Monroe County, FL"
60,2018,Jan,43997,42528,1469,3.3,"Monroe County, FL"
61,2018,Feb,44335,43003,1332,3.0,"Monroe County, FL"
62,2018,Mar,44868,43624,1244,2.8,"Monroe County, FL"
63,2018,Apr,44768,43647,1121,2.5,"Monroe County, FL"
64,2018,May,45037,43936,1101,2.4,"Monroe County, FL"
65,2018,Jun,44975,43716,1259,2.8,"Monroe County, FL"
66,2018,Jul,44966,43769,1197,2.7,"Monroe County, FL"
67,2018,Aug,44850,43689,1161,2.6,"Monroe County, FL"
68,2018,Sep,44142,43079,1063,2.4,"Monroe County, FL"
69,2018,Oct,44829,43763,1066,2.4,"Monroe County, FL"
70,2018,Nov,45144,44102,1042,2.3,"Monroe County, FL"
71,2018,Dec,45983,44967,1016,2.2,"Monroe County, FL"
72,2019,Jan,45881,44708,1173,2.6,"Monroe County, FL"
73,2019,Feb,46124,45124,1000,2.2,"Monroe County, FL"
74,2019,Mar,46840,45848,992,2.1,"Monroe County, FL"
75,2019,Apr,46208,45329,879,1.9,"Monroe County, FL"
76,2019,May,46407,45499,908,2.0,"Monroe County, FL"
77,2019,Jun,46146,45119,1027,2.2,"Monroe County, FL"
78,2019,Jul,46216,45196,1020,2.2,"Monroe County, FL"
79,2019,Aug,46316,45288,1028,2.2,"Monroe County, FL"
80,2019,Sep,45559,44639,920,2.0,"Monroe County, FL"
81,2019,Oct,46001,45072,929,2.0,"Monroe County, FL"
82,2019,Nov,46182,45301,881,1.9,"Monroe County, FL"
83,2019,Dec,47556,46715,841,1.8,"Monroe County, FL"
84,2020,Jan,46899,45924,975,2.1,"Monroe County, FL"
85,2020,Feb,47135,46296,839,1.8,"Monroe County, FL"
86,2020,Mar,46856,45607,1249,2.7,"Monroe County, FL"
87,2020,Apr,40218,32029,8189,20.4,"Monroe County, FL"
88,2020,May,43813,34947,8866,20.2,"Monroe County, FL"
89,2020,Jun,44422,38852,5570,12.5,"Monroe County, FL"
90,2020,Jul,44711,39674,5037,11.3,"Monroe County, FL"
91,2020,Aug,44214,40797,3417,7.7,"Monroe County, FL"
92,2020,Sep,43670,40626,3044,7.0,"Monroe County, FL"
93,2020,Oct,44208,41787,2421,5.5,"Monroe County, FL"
94,2020,Nov,43729,41586,2143,4.9,"Monroe County, FL"
95,2020,Dec,44165,42244,1921,4.3,"Monroe County, FL"
96,2021,Jan,44005,42193,1812,4.1,"Monroe County, FL"
97,2021,Feb,44654,43018,1636,3.7,"Monroe County, FL"
98,2021,Mar,45106,43559,1547,3.4,"Monroe County, FL"
99,2021,Apr,45869,44449,1420,3.1,"Monroe County, FL"
100,2021,May,46224,44863,1361,2.9,"Monroe County, FL"
101,2021,Jun,46662,45109,1553,3.3,"Monroe County, FL"
102,2021,Jul,46594,45140,1454,3.1,"Monroe County, FL"
103,2021,Aug,46313,44917,1396,3.0,"Monroe County, FL"
104,2021,Sep,46317,45095,1222,2.6,"Monroe County, FL"
105,2021,Oct,46378,45223,1155,2.5,"Monroe County, FL"
106,2021,Nov,46755,45647,1108,2.4,"Monroe County, FL"
107,2021,Dec,47158,46184,974,2.1,"Monroe County, FL"
108,2022,Jan,48450,47236,1214,2.5,"Monroe County, FL"
109,2022,Feb,49002,47945,1057,2.2,"Monroe County, FL"
110,2022,Mar,49431,48481,950,1.9,"Monroe County, FL"
111,2022,Apr,49227,48408,819,1.7,"Monroe County, FL"
112,2022,May,49477,48635,842,1.7,"Monroe County, FL"
113,2022,Jun,49086,48100,986,2.0,"Monroe County, FL"
114,2022,Jul,49387,48487,900,1.8,"Monroe County, FL"
115,2022,Aug,49297,48375,922,1.9,"Monroe County, FL"
116,2022,Sep,48696,47837,859,1.8,"Monroe County, FL"
117,2022,Oct,49297,48435,862,1.7,"Monroe County, FL"
118,2022,Nov,49476,48636,840,1.7,"Monroe County, FL"
119,2022,Dec,50326,49593,733,1.5,"Monroe County, FL"
120,2023,Jan,50740,49882,858,1.7,"Monroe County, FL"
121,2023,Feb,51134,50295,839,1.6,"Monroe County, FL"
122,2023,Mar,51639,50773,866,1.7,"Monroe County, FL"
123,2023,Apr,51494,50749,745,1.4,"Monroe County, FL"
124,2023,May,51368,50502,866,1.7,"Monroe County, FL"
125,2023,Jun,51546,50580,966,1.9,"Monroe County, FL"
126,2023,Jul,51974,50969,1005,1.9,"Monroe County, FL"
127,2023,Aug,52137,51098,1039,2.0,"Monroe County, FL"
128,2023,Sep,51869,50813,1056,2.0,"Monroe County, FL"
129,2023,Oct,52100,51084,1016,2.0,"Monroe County, FL"
0,2013,Jan,11015,10057,958,8.7,"Baker County, FL"
1,2013,Feb,11037,10122,915,8.3,"Baker County, FL"
2,2013,Mar,11064,10200,864,7.8,"Baker County, FL"
3,2013,Apr,11103,10264,839,7.6,"Baker County, FL"
4,2013,May,11285,10420,865,7.7,"Baker County, FL"
5,2013,Jun,11405,10468,937,8.2,"Baker County, FL"
6,2013,Jul,11467,10546,921,8.0,"Baker County, FL"
7,2013,Aug,11395,10523,872,7.7,"Baker County, FL"
8,2013,Sep,11431,10582,849,7.4,"Baker County, FL"
9,2013,Oct,11320,10490,830,7.3,"Baker County, FL"
10,2013,Nov,11215,10411,804,7.2,"Baker County, FL"
11,2013,Dec,11206,10436,770,6.9,"Baker County, FL"
12,2014,Jan,11013,10205,808,7.3,"Baker County, FL"
13,2014,Feb,11040,10269,771,7.0,"Baker County, FL"
14,2014,Mar,11113,10348,765,6.9,"Baker County, FL"
15,2014,Apr,11066,10372,694,6.3,"Baker County, FL"
16,2014,May,11212,10489,723,6.4,"Baker County, FL"
17,2014,Jun,11267,10502,765,6.8,"Baker County, FL"
18,2014,Jul,11333,10536,797,7.0,"Baker County, FL"
19,2014,Aug,11323,10529,794,7.0,"Baker County, FL"
20,2014,Sep,11285,10570,715,6.3,"Baker County, FL"
21,2014,Oct,11307,10615,692,6.1,"Baker County, FL"
22,2014,Nov,11174,10483,691,6.2,"Baker County, FL"
23,2014,Dec,11176,10532,644,5.8,"Baker County, FL"
24,2015,Jan,11043,10325,718,6.5,"Baker County, FL"
25,2015,Feb,11045,10395,650,5.9,"Baker County, FL"
26,2015,Mar,11090,10473,617,5.6,"Baker County, FL"
27,2015,Apr,11102,10500,602,5.4,"Baker County, FL"
28,2015,May,11277,10621,656,5.8,"Baker County, FL"
29,2015,Jun,11349,10653,696,6.1,"Baker County, FL"
30,2015,Jul,11374,10677,697,6.1,"Baker County, FL"
31,2015,Aug,11303,10662,641,5.7,"Baker County, FL"
32,2015,Sep,11305,10701,604,5.3,"Baker County, FL"
33,2015,Oct,11292,10715,577,5.1,"Baker County, FL"
34,2015,Nov,11203,10622,581,5.2,"Baker County, FL"
35,2015,Dec,11224,10667,557,5.0,"Baker County, FL"
36,2016,Jan,11190,10592,598,5.3,"Baker County, FL"
37,2016,Feb,11235,10692,543,4.8,"Baker County, FL"
38,2016,Mar,11282,10736,546,4.8,"Baker County, FL"
39,2016,Apr,11284,10770,514,4.6,"Baker County, FL"
40,2016,May,11448,10920,528,4.6,"Baker County, FL"
41,2016,Jun,11566,10953,613,5.3,"Baker County, FL"
42,2016,Jul,11644,11024,620,5.3,"Baker County, FL"
43,2016,Aug,11615,11013,602,5.2,"Baker County, FL"
44,2016,Sep,11674,11084,590,5.1,"Baker County, FL"
45,2016,Oct,11569,11014,555,4.8,"Baker County, FL"
46,2016,Nov,11483,10951,532,4.6,"Baker County, FL"
47,2016,Dec,11480,10954,526,4.6,"Baker County, FL"
48,2017,Jan,11305,10734,571,5.1,"Baker County, FL"
49,2017,Feb,11361,10837,524,4.6,"Baker County, FL"
50,2017,Mar,11406,10902,504,4.4,"Baker County, FL"
51,2017,Apr,11439,10975,464,4.1,"Baker County, FL"
52,2017,May,11530,11070,460,4.0,"Baker County, FL"
53,2017,Jun,11665,11136,529,4.5,"Baker County, FL"
54,2017,Jul,11730,11206,524,4.5,"Baker County, FL"
55,2017,Aug,11644,11134,510,4.4,"Baker County, FL"
56,2017,Sep,11720,11256,464,4.0,"Baker County, FL"
57,2017,Oct,11661,11213,448,3.8,"Baker County, FL"
58,2017,Nov,11652,11182,470,4.0,"Baker County, FL"
59,2017,Dec,11625,11196,429,3.7,"Baker County, FL"
60,2018,Jan,11424,10934,490,4.3,"Baker County, FL"
61,2018,Feb,11433,11006,427,3.7,"Baker County, FL"
62,2018,Mar,11421,11018,403,3.5,"Baker County, FL"
63,2018,Apr,11399,11034,365,3.2,"Baker County, FL"
64,2018,May,11516,11156,360,3.1,"Baker County, FL"
65,2018,Jun,11687,11229,458,3.9,"Baker County, FL"
66,2018,Jul,11728,11285,443,3.8,"Baker County, FL"
67,2018,Aug,11641,11228,413,3.5,"Baker County, FL"
68,2018,Sep,11698,11321,377,3.2,"Baker County, FL"
69,2018,Oct,11665,11268,397,3.4,"Baker County, FL"
70,2018,Nov,11599,11224,375,3.2,"Baker County, FL"
71,2018,Dec,11619,11247,372,3.2,"Baker County, FL"
72,2019,Jan,11706,11260,446,3.8,"Baker County, FL"
73,2019,Feb,11704,11326,378,3.2,"Baker County, FL"
74,2019,Mar,11708,11329,379,3.2,"Baker County, FL"
75,2019,Apr,11705,11368,337,2.9,"Baker County, FL"
76,2019,May,11865,11500,365,3.1,"Baker County, FL"
77,2019,Jun,12024,11598,426,3.5,"Baker County, FL"
78,2019,Jul,12125,11684,441,3.6,"Baker County, FL"
79,2019,Aug,12093,11691,402,3.3,"Baker County, FL"
80,2019,Sep,12136,11783,353,2.9,"Baker County, FL"
81,2019,Oct,12115,11755,360,3.0,"Baker County, FL"
82,2019,Nov,12049,11712,337,2.8,"Baker County, FL"
83,2019,Dec,12073,11743,330,2.7,"Baker County, FL"
84,2020,Jan,11963,11569,394,3.3,"Baker County, FL"
85,2020,Feb,11941,11626,315,2.6,"Baker County, FL"
86,2020,Mar,11714,11268,446,3.8,"Baker County, FL"
87,2020,Apr,10398,9720,678,6.5,"Baker County, FL"
88,2020,May,11181,10375,806,7.2,"Baker County, FL"
89,2020,Jun,11480,10701,779,6.8,"Baker County, FL"
90,2020,Jul,11773,10868,905,7.7,"Baker County, FL"
91,2020,Aug,11766,11118,648,5.5,"Baker County, FL"
92,2020,Sep,11941,11289,652,5.5,"Baker County, FL"
93,2020,Oct,12009,11396,613,5.1,"Baker County, FL"
94,2020,Nov,11974,11369,605,5.1,"Baker County, FL"
95,2020,Dec,11972,11397,575,4.8,"Baker County, FL"
96,2021,Jan,11856,11297,559,4.7,"Baker County, FL"
97,2021,Feb,11858,11366,492,4.1,"Baker County, FL"
98,2021,Mar,11901,11425,476,4.0,"Baker County, FL"
99,2021,Apr,11915,11481,434,3.6,"Baker County, FL"
100,2021,May,12021,11610,411,3.4,"Baker County, FL"
101,2021,Jun,12165,11645,520,4.3,"Baker County, FL"
102,2021,Jul,12230,11718,512,4.2,"Baker County, FL"
103,2021,Aug,12244,11758,486,4.0,"Baker County, FL"
104,2021,Sep,12320,11883,437,3.5,"Baker County, FL"
105,2021,Oct,12360,11914,446,3.6,"Baker County, FL"
106,2021,Nov,12361,11955,406,3.3,"Baker County, FL"
107,2021,Dec,12373,12017,356,2.9,"Baker County, FL"
108,2022,Jan,12405,11967,438,3.5,"Baker County, FL"
109,2022,Feb,12396,12016,380,3.1,"Baker County, FL"
110,2022,Mar,12458,12114,344,2.8,"Baker County, FL"
111,2022,Apr,12460,12149,311,2.5,"Baker County, FL"
112,2022,May,12600,12271,329,2.6,"Baker County, FL"
113,2022,Jun,12688,12305,383,3.0,"Baker County, FL"
114,2022,Jul,12765,12390,375,2.9,"Baker County, FL"
115,2022,Aug,12779,12413,366,2.9,"Baker County, FL"
116,2022,Sep,12823,12486,337,2.6,"Baker County, FL"
117,2022,Oct,12818,12490,328,2.6,"Baker County, FL"
118,2022,Nov,12752,12427,325,2.5,"Baker County, FL"
119,2022,Dec,12845,12581,264,2.1,"Baker County, FL"
120,2023,Jan,12858,12542,316,2.5,"Baker County, FL"
121,2023,Feb,12984,12668,316,2.4,"Baker County, FL"
122,2023,Mar,13057,12736,321,2.5,"Baker County, FL"
123,2023,Apr,13022,12732,290,2.2,"Baker County, FL"
124,2023,May,13136,12784,352,2.7,"Baker County, FL"
125,2023,Jun,13364,12975,389,2.9,"Baker County, FL"
126,2023,Jul,13417,12993,424,3.2,"Baker County, FL"
127,2023,Aug,13512,13094,418,3.1,"Baker County, FL"
128,2023,Sep,13511,13113,398,2.9,"Baker County, FL"
129,2023,Oct,13541,13117,424,3.1,"Baker County, FL"
0,2013,Jan,10456,8951,1505,14.4,"Del Norte County, CA"
1,2013,Feb,10359,9017,1342,13.0,"Del Norte County, CA"
2,2013,Mar,10334,9026,1308,12.7,"Del Norte County, CA"
3,2013,Apr,10278,9048,1230,12.0,"Del Norte County, CA"
4,2013,May,10376,9200,1176,11.3,"Del Norte County, CA"
5,2013,Jun,10507,9258,1249,11.9,"Del Norte County, CA"
6,2013,Jul,10235,8963,1272,12.4,"Del Norte County, CA"
7,2013,Aug,10129,8965,1164,11.5,"Del Norte County, CA"
8,2013,Sep,10473,9361,1112,10.6,"Del Norte County, CA"
9,2013,Oct,10236,9088,1148,11.2,"Del Norte County, CA"
10,2013,Nov,10116,8957,1159,11.5,"Del Norte County, CA"
11,2013,Dec,10065,8928,1137,11.3,"Del Norte County, CA"
12,2014,Jan,9992,8815,1177,11.8,"Del Norte County, CA"
13,2014,Feb,9955,8772,1183,11.9,"Del Norte County, CA"
14,2014,Mar,10012,8855,1157,11.6,"Del Norte County, CA"
15,2014,Apr,9914,8908,1006,10.1,"Del Norte County, CA"
16,2014,May,9931,8966,965,9.7,"Del Norte County, CA"
17,2014,Jun,10087,9086,1001,9.9,"Del Norte County, CA"
18,2014,Jul,9768,8731,1037,10.6,"Del Norte County, CA"
19,2014,Aug,9763,8769,994,10.2,"Del Norte County, CA"
20,2014,Sep,9970,9079,891,8.9,"Del Norte County, CA"
21,2014,Oct,9991,9096,895,9.0,"Del Norte County, CA"
22,2014,Nov,9873,8953,920,9.3,"Del Norte County, CA"
23,2014,Dec,9719,8828,891,9.2,"Del Norte County, CA"
24,2015,Jan,9815,8835,980,10.0,"Del Norte County, CA"
25,2015,Feb,9756,8786,970,9.9,"Del Norte County, CA"
26,2015,Mar,9821,8862,959,9.8,"Del Norte County, CA"
27,2015,Apr,9907,9035,872,8.8,"Del Norte County, CA"
28,2015,May,9985,9176,809,8.1,"Del Norte County, CA"
29,2015,Jun,10089,9246,843,8.4,"Del Norte County, CA"
30,2015,Jul,9737,8890,847,8.7,"Del Norte County, CA"
31,2015,Aug,9839,9046,793,8.1,"Del Norte County, CA"
32,2015,Sep,10009,9296,713,7.1,"Del Norte County, CA"
33,2015,Oct,9844,9097,747,7.6,"Del Norte County, CA"
34,2015,Nov,9782,8994,788,8.1,"Del Norte County, CA"
35,2015,Dec,9677,8840,837,8.6,"Del Norte County, CA"
36,2016,Jan,9595,8708,887,9.2,"Del Norte County, CA"
37,2016,Feb,9627,8752,875,9.1,"Del Norte County, CA"
38,2016,Mar,9782,8903,879,9.0,"Del Norte County, CA"
39,2016,Apr,9725,8971,754,7.8,"Del Norte County, CA"
40,2016,May,9773,9116,657,6.7,"Del Norte County, CA"
41,2016,Jun,9971,9269,702,7.0,"Del Norte County, CA"
42,2016,Jul,9791,9073,718,7.3,"Del Norte County, CA"
43,2016,Aug,9784,9082,702,7.2,"Del Norte County, CA"
44,2016,Sep,9955,9317,638,6.4,"Del Norte County, CA"
45,2016,Oct,9852,9190,662,6.7,"Del Norte County, CA"
46,2016,Nov,9646,8952,694,7.2,"Del Norte County, CA"
47,2016,Dec,9566,8899,667,7.0,"Del Norte County, CA"
48,2017,Jan,9653,8899,754,7.8,"Del Norte County, CA"
49,2017,Feb,9706,8952,754,7.8,"Del Norte County, CA"
50,2017,Mar,9647,8935,712,7.4,"Del Norte County, CA"
51,2017,Apr,9644,8995,649,6.7,"Del Norte County, CA"
52,2017,May,9650,9068,582,6.0,"Del Norte County, CA"
53,2017,Jun,9735,9116,619,6.4,"Del Norte County, CA"
54,2017,Jul,9720,9096,624,6.4,"Del Norte County, CA"
55,2017,Aug,9871,9251,620,6.3,"Del Norte County, CA"
56,2017,Sep,9881,9347,534,5.4,"Del Norte County, CA"
57,2017,Oct,9777,9237,540,5.5,"Del Norte County, CA"
58,2017,Nov,9558,8996,562,5.9,"Del Norte County, CA"
59,2017,Dec,9508,8922,586,6.2,"Del Norte County, CA"
60,2018,Jan,9662,8998,664,6.9,"Del Norte County, CA"
61,2018,Feb,9762,9143,619,6.3,"Del Norte County, CA"
62,2018,Mar,9792,9203,589,6.0,"Del Norte County, CA"
63,2018,Apr,9624,9097,527,5.5,"Del Norte County, CA"
64,2018,May,9719,9250,469,4.8,"Del Norte County, CA"
65,2018,Jun,9827,9288,539,5.5,"Del Norte County, CA"
66,2018,Jul,9676,9133,543,5.6,"Del Norte County, CA"
67,2018,Aug,9813,9264,549,5.6,"Del Norte County, CA"
68,2018,Sep,9846,9363,483,4.9,"Del Norte County, CA"
69,2018,Oct,9753,9237,516,5.3,"Del Norte County, CA"
70,2018,Nov,9554,9004,550,5.8,"Del Norte County, CA"
71,2018,Dec,9503,8875,628,6.6,"Del Norte County, CA"
72,2019,Jan,9657,8935,722,7.5,"Del Norte County, CA"
73,2019,Feb,9636,9013,623,6.5,"Del Norte County, CA"
74,2019,Mar,9652,9055,597,6.2,"Del Norte County, CA"
75,2019,Apr,9523,9002,521,5.5,"Del Norte County, CA"
76,2019,May,9568,9091,477,5.0,"Del Norte County, CA"
77,2019,Jun,9688,9166,522,5.4,"Del Norte County, CA"
78,2019,Jul,9621,9054,567,5.9,"Del Norte County, CA"
79,2019,Aug,9749,9192,557,5.7,"Del Norte County, CA"
80,2019,Sep,9777,9293,484,5.0,"Del Norte County, CA"
81,2019,Oct,9792,9266,526,5.4,"Del Norte County, CA"
82,2019,Nov,9504,8957,547,5.8,"Del Norte County, CA"
83,2019,Dec,9463,8891,572,6.0,"Del Norte County, CA"
84,2020,Jan,9669,9030,639,6.6,"Del Norte County, CA"
85,2020,Feb,9644,9046,598,6.2,"Del Norte County, CA"
86,2020,Mar,9776,8944,832,8.5,"Del Norte County, CA"
87,2020,Apr,9338,7965,1373,14.7,"Del Norte County, CA"
88,2020,May,9077,7833,1244,13.7,"Del Norte County, CA"
89,2020,Jun,9511,8421,1090,11.5,"Del Norte County, CA"
90,2020,Jul,9342,8306,1036,11.1,"Del Norte County, CA"
91,2020,Aug,9563,8672,891,9.3,"Del Norte County, CA"
92,2020,Sep,9516,8689,827,8.7,"Del Norte County, CA"
93,2020,Oct,9459,8693,766,8.1,"Del Norte County, CA"
94,2020,Nov,9259,8454,805,8.7,"Del Norte County, CA"
95,2020,Dec,9216,8369,847,9.2,"Del Norte County, CA"
96,2021,Jan,9329,8439,890,9.5,"Del Norte County, CA"
97,2021,Feb,9258,8393,865,9.3,"Del Norte County, CA"
98,2021,Mar,9309,8460,849,9.1,"Del Norte County, CA"
99,2021,Apr,9260,8450,810,8.7,"Del Norte County, CA"
100,2021,May,9287,8566,721,7.8,"Del Norte County, CA"
101,2021,Jun,9410,8624,786,8.4,"Del Norte County, CA"
102,2021,Jul,9385,8648,737,7.9,"Del Norte County, CA"
103,2021,Aug,9521,8825,696,7.3,"Del Norte County, CA"
104,2021,Sep,9520,8945,575,6.0,"Del Norte County, CA"
105,2021,Oct,9433,8874,559,5.9,"Del Norte County, CA"
106,2021,Nov,9251,8711,540,5.8,"Del Norte County, CA"
107,2021,Dec,9247,8751,496,5.4,"Del Norte County, CA"
108,2022,Jan,9337,8773,564,6.0,"Del Norte County, CA"
109,2022,Feb,9356,8811,545,5.8,"Del Norte County, CA"
110,2022,Mar,9422,8905,517,5.5,"Del Norte County, CA"
111,2022,Apr,9189,8734,455,5.0,"Del Norte County, CA"
112,2022,May,9249,8819,430,4.6,"Del Norte County, CA"
113,2022,Jun,9345,8867,478,5.1,"Del Norte County, CA"
114,2022,Jul,9319,8844,475,5.1,"Del Norte County, CA"
115,2022,Aug,9551,9080,471,4.9,"Del Norte County, CA"
116,2022,Sep,9485,9066,419,4.4,"Del Norte County, CA"
117,2022,Oct,9501,9061,440,4.6,"Del Norte County, CA"
118,2022,Nov,9352,8869,483,5.2,"Del Norte County, CA"
119,2022,Dec,9258,8784,474,5.1,"Del Norte County, CA"
120,2023,Jan,9199,8616,583,6.3,"Del Norte County, CA"
121,2023,Feb,9221,8666,555,6.0,"Del Norte County, CA"
122,2023,Mar,9388,8833,555,5.9,"Del Norte County, CA"
123,2023,Apr,9037,8541,496,5.5,"Del Norte County, CA"
124,2023,May,9201,8677,524,5.7,"Del Norte County, CA"
125,2023,Jun,9348,8820,528,5.6,"Del Norte County, CA"
126,2023,Jul,9225,8702,523,5.7,"Del Norte County, CA"
127,2023,Aug,9483,8930,553,5.8,"Del Norte County, CA"
128,2023,Sep,9568,9066,502,5.2,"Del Norte County, CA"
129,2023,Oct,9469,8944,525,5.5,"Del Norte County, CA"
0,2013,Jan,665728,613472,52256,7.8,"Hillsborough County, FL"
1,2013,Feb,664410,616095,48315,7.3,"Hillsborough County, FL"
2,2013,Mar,666013,620098,45915,6.9,"Hillsborough County, FL"
3,2013,Apr,665563,621450,44113,6.6,"Hillsborough County, FL"
4,2013,May,674872,629107,45765,6.8,"Hillsborough County, FL"
5,2013,Jun,677792,628715,49077,7.2,"Hillsborough County, FL"
6,2013,Jul,677470,629081,48389,7.1,"Hillsborough County, FL"
7,2013,Aug,676028,629162,46866,6.9,"Hillsborough County, FL"
8,2013,Sep,677991,632587,45404,6.7,"Hillsborough County, FL"
9,2013,Oct,673076,628635,44441,6.6,"Hillsborough County, FL"
10,2013,Nov,669843,627179,42664,6.4,"Hillsborough County, FL"
11,2013,Dec,669260,628537,40723,6.1,"Hillsborough County, FL"
12,2014,Jan,673967,630639,43328,6.4,"Hillsborough County, FL"
13,2014,Feb,675783,633519,42264,6.3,"Hillsborough County, FL"
14,2014,Mar,680832,639188,41644,6.1,"Hillsborough County, FL"
15,2014,Apr,676630,638727,37903,5.6,"Hillsborough County, FL"
16,2014,May,684822,644398,40424,5.9,"Hillsborough County, FL"
17,2014,Jun,684363,642274,42089,6.2,"Hillsborough County, FL"
18,2014,Jul,685677,641823,43854,6.4,"Hillsborough County, FL"
19,2014,Aug,684902,642128,42774,6.2,"Hillsborough County, FL"
20,2014,Sep,686932,646907,40025,5.8,"Hillsborough County, FL"
21,2014,Oct,685251,646671,38580,5.6,"Hillsborough County, FL"
22,2014,Nov,680848,642426,38422,5.6,"Hillsborough County, FL"
23,2014,Dec,680332,644517,35815,5.3,"Hillsborough County, FL"
24,2015,Jan,676559,637349,39210,5.8,"Hillsborough County, FL"
25,2015,Feb,685727,649598,36129,5.3,"Hillsborough County, FL"
26,2015,Mar,687155,652523,34632,5.0,"Hillsborough County, FL"
27,2015,Apr,686853,653142,33711,4.9,"Hillsborough County, FL"
28,2015,May,696218,659946,36272,5.2,"Hillsborough County, FL"
29,2015,Jun,695919,658462,37457,5.4,"Hillsborough County, FL"
30,2015,Jul,694705,656960,37745,5.4,"Hillsborough County, FL"
31,2015,Aug,693452,657414,36038,5.2,"Hillsborough County, FL"
32,2015,Sep,695948,661697,34251,4.9,"Hillsborough County, FL"
33,2015,Oct,697416,663651,33765,4.8,"Hillsborough County, FL"
34,2015,Nov,696392,663129,33263,4.8,"Hillsborough County, FL"
35,2015,Dec,698035,666408,31627,4.5,"Hillsborough County, FL"
36,2016,Jan,699932,666699,33233,4.7,"Hillsborough County, FL"
37,2016,Feb,703964,673074,30890,4.4,"Hillsborough County, FL"
38,2016,Mar,705912,675259,30653,4.3,"Hillsborough County, FL"
39,2016,Apr,705372,675463,29909,4.2,"Hillsborough County, FL"
40,2016,May,709999,680351,29648,4.2,"Hillsborough County, FL"
41,2016,Jun,711904,678396,33508,4.7,"Hillsborough County, FL"
42,2016,Jul,712129,678217,33912,4.8,"Hillsborough County, FL"
43,2016,Aug,711178,677568,33610,4.7,"Hillsborough County, FL"
44,2016,Sep,716197,682977,33220,4.6,"Hillsborough County, FL"
45,2016,Oct,715432,683539,31893,4.5,"Hillsborough County, FL"
46,2016,Nov,710591,680029,30562,4.3,"Hillsborough County, FL"
47,2016,Dec,711842,682166,29676,4.2,"Hillsborough County, FL"
48,2017,Jan,712855,680308,32547,4.6,"Hillsborough County, FL"
49,2017,Feb,715508,685826,29682,4.1,"Hillsborough County, FL"
50,2017,Mar,717370,689271,28099,3.9,"Hillsborough County, FL"
51,2017,Apr,714677,688102,26575,3.7,"Hillsborough County, FL"
52,2017,May,717682,690316,27366,3.8,"Hillsborough County, FL"
53,2017,Jun,722723,692603,30120,4.2,"Hillsborough County, FL"
54,2017,Jul,721943,691186,30757,4.3,"Hillsborough County, FL"
55,2017,Aug,719607,689017,30590,4.3,"Hillsborough County, FL"
56,2017,Sep,724957,696909,28048,3.9,"Hillsborough County, FL"
57,2017,Oct,721127,693959,27168,3.8,"Hillsborough County, FL"
58,2017,Nov,719050,691722,27328,3.8,"Hillsborough County, FL"
59,2017,Dec,718719,693153,25566,3.6,"Hillsborough County, FL"
60,2018,Jan,722799,694616,28183,3.9,"Hillsborough County, FL"
61,2018,Feb,726971,700810,26161,3.6,"Hillsborough County, FL"
62,2018,Mar,726863,701550,25313,3.5,"Hillsborough County, FL"
63,2018,Apr,725441,701588,23853,3.3,"Hillsborough County, FL"
64,2018,May,729046,705193,23853,3.3,"Hillsborough County, FL"
65,2018,Jun,735357,707247,28110,3.8,"Hillsborough County, FL"
66,2018,Jul,736075,708487,27588,3.7,"Hillsborough County, FL"
67,2018,Aug,733225,706531,26694,3.6,"Hillsborough County, FL"
68,2018,Sep,738364,713719,24645,3.3,"Hillsborough County, FL"
69,2018,Oct,738612,713829,24783,3.4,"Hillsborough County, FL"
70,2018,Nov,733776,710388,23388,3.2,"Hillsborough County, FL"
71,2018,Dec,734099,710842,23257,3.2,"Hillsborough County, FL"
72,2019,Jan,741796,714373,27423,3.7,"Hillsborough County, FL"
73,2019,Feb,744263,720153,24110,3.2,"Hillsborough County, FL"
74,2019,Mar,743712,720111,23601,3.2,"Hillsborough County, FL"
75,2019,Apr,741493,720288,21205,2.9,"Hillsborough County, FL"
76,2019,May,747967,725441,22526,3.0,"Hillsborough County, FL"
77,2019,Jun,753097,727268,25829,3.4,"Hillsborough County, FL"
78,2019,Jul,755454,728698,26756,3.5,"Hillsborough County, FL"
79,2019,Aug,755643,729544,26099,3.5,"Hillsborough County, FL"
80,2019,Sep,763015,739333,23682,3.1,"Hillsborough County, FL"
81,2019,Oct,761965,738544,23421,3.1,"Hillsborough County, FL"
82,2019,Nov,759861,737860,22001,2.9,"Hillsborough County, FL"
83,2019,Dec,760776,740539,20237,2.7,"Hillsborough County, FL"
84,2020,Jan,762453,738856,23597,3.1,"Hillsborough County, FL"
85,2020,Feb,765990,745558,20432,2.7,"Hillsborough County, FL"
86,2020,Mar,755241,722467,32774,4.3,"Hillsborough County, FL"
87,2020,Apr,699882,616154,83728,12.0,"Hillsborough County, FL"
88,2020,May,751089,654554,96535,12.9,"Hillsborough County, FL"
89,2020,Jun,755763,674258,81505,10.8,"Hillsborough County, FL"
90,2020,Jul,771229,679737,91492,11.9,"Hillsborough County, FL"
91,2020,Aug,759850,696632,63218,8.3,"Hillsborough County, FL"
92,2020,Sep,760758,703234,57524,7.6,"Hillsborough County, FL"
93,2020,Oct,763122,715427,47695,6.2,"Hillsborough County, FL"
94,2020,Nov,756785,713142,43643,5.8,"Hillsborough County, FL"
95,2020,Dec,757399,716324,41075,5.4,"Hillsborough County, FL"
96,2021,Jan,756730,715352,41378,5.5,"Hillsborough County, FL"
97,2021,Feb,759100,721704,37396,4.9,"Hillsborough County, FL"
98,2021,Mar,762414,726991,35423,4.6,"Hillsborough County, FL"
99,2021,Apr,762926,728673,34253,4.5,"Hillsborough County, FL"
100,2021,May,765951,732821,33130,4.3,"Hillsborough County, FL"
101,2021,Jun,774926,737460,37466,4.8,"Hillsborough County, FL"
102,2021,Jul,774103,738825,35278,4.6,"Hillsborough County, FL"
103,2021,Aug,776151,742142,34009,4.4,"Hillsborough County, FL"
104,2021,Sep,783267,752531,30736,3.9,"Hillsborough County, FL"
105,2021,Oct,785222,755924,29298,3.7,"Hillsborough County, FL"
106,2021,Nov,785188,758156,27032,3.4,"Hillsborough County, FL"
107,2021,Dec,786897,763472,23425,3.0,"Hillsborough County, FL"
108,2022,Jan,791525,763122,28403,3.6,"Hillsborough County, FL"
109,2022,Feb,791125,766553,24572,3.1,"Hillsborough County, FL"
110,2022,Mar,795960,773752,22208,2.8,"Hillsborough County, FL"
111,2022,Apr,797466,776956,20510,2.6,"Hillsborough County, FL"
112,2022,May,801518,780641,20877,2.6,"Hillsborough County, FL"
113,2022,Jun,808474,784527,23947,3.0,"Hillsborough County, FL"
114,2022,Jul,805643,782596,23047,2.9,"Hillsborough County, FL"
115,2022,Aug,809094,785883,23211,2.9,"Hillsborough County, FL"
116,2022,Sep,812229,791349,20880,2.6,"Hillsborough County, FL"
117,2022,Oct,813630,792331,21299,2.6,"Hillsborough County, FL"
118,2022,Nov,812706,792203,20503,2.5,"Hillsborough County, FL"
119,2022,Dec,814320,796465,17855,2.2,"Hillsborough County, FL"
120,2023,Jan,816115,795747,20368,2.5,"Hillsborough County, FL"
121,2023,Feb,822998,802760,20238,2.5,"Hillsborough County, FL"
122,2023,Mar,831379,810540,20839,2.5,"Hillsborough County, FL"
123,2023,Apr,829990,811129,18861,2.3,"Hillsborough County, FL"
124,2023,May,833177,811141,22036,2.6,"Hillsborough County, FL"
125,2023,Jun,844906,819890,25016,3.0,"Hillsborough County, FL"
126,2023,Jul,842679,816773,25906,3.1,"Hillsborough County, FL"
127,2023,Aug,847240,820651,26589,3.1,"Hillsborough County, FL"
128,2023,Sep,848660,822674,25986,3.1,"Hillsborough County, FL"
129,2023,Oct,846531,819971,26560,3.1,"Hillsborough County, FL"
0,2013,Jan,37115,33242,3873,10.4,"Highlands County, FL"
1,2013,Feb,37057,33545,3512,9.5,"Highlands County, FL"
2,2013,Mar,36993,33624,3369,9.1,"Highlands County, FL"
3,2013,Apr,37132,33877,3255,8.8,"Highlands County, FL"
4,2013,May,36970,33606,3364,9.1,"Highlands County, FL"
5,2013,Jun,35665,31966,3699,10.4,"Highlands County, FL"
6,2013,Jul,34214,30365,3849,11.2,"Highlands County, FL"
7,2013,Aug,35080,31212,3868,11.0,"Highlands County, FL"
8,2013,Sep,35380,31670,3710,10.5,"Highlands County, FL"
9,2013,Oct,35435,31738,3697,10.4,"Highlands County, FL"
10,2013,Nov,35460,31951,3509,9.9,"Highlands County, FL"
11,2013,Dec,36396,33126,3270,9.0,"Highlands County, FL"
12,2014,Jan,36939,33595,3344,9.1,"Highlands County, FL"
13,2014,Feb,37456,34217,3239,8.6,"Highlands County, FL"
14,2014,Mar,37278,34119,3159,8.5,"Highlands County, FL"
15,2014,Apr,37420,34587,2833,7.6,"Highlands County, FL"
16,2014,May,37194,34153,3041,8.2,"Highlands County, FL"
17,2014,Jun,34514,31354,3160,9.2,"Highlands County, FL"
18,2014,Jul,33952,30567,3385,10.0,"Highlands County, FL"
19,2014,Aug,34770,31431,3339,9.6,"Highlands County, FL"
20,2014,Sep,35079,31997,3082,8.8,"Highlands County, FL"
21,2014,Oct,34823,31834,2989,8.6,"Highlands County, FL"
22,2014,Nov,34807,31835,2972,8.5,"Highlands County, FL"
23,2014,Dec,35519,32768,2751,7.7,"Highlands County, FL"
24,2015,Jan,35989,33073,2916,8.1,"Highlands County, FL"
25,2015,Feb,35707,33015,2692,7.5,"Highlands County, FL"
26,2015,Mar,35677,33109,2568,7.2,"Highlands County, FL"
27,2015,Apr,36398,33892,2506,6.9,"Highlands County, FL"
28,2015,May,36262,33581,2681,7.4,"Highlands County, FL"
29,2015,Jun,34796,32029,2767,8.0,"Highlands County, FL"
30,2015,Jul,34155,31171,2984,8.7,"Highlands County, FL"
31,2015,Aug,35009,32172,2837,8.1,"Highlands County, FL"
32,2015,Sep,35227,32595,2632,7.5,"Highlands County, FL"
33,2015,Oct,35405,32791,2614,7.4,"Highlands County, FL"
34,2015,Nov,35323,32750,2573,7.3,"Highlands County, FL"
35,2015,Dec,35870,33410,2460,6.9,"Highlands County, FL"
36,2016,Jan,35885,33391,2494,6.9,"Highlands County, FL"
37,2016,Feb,35910,33587,2323,6.5,"Highlands County, FL"
38,2016,Mar,36508,34201,2307,6.3,"Highlands County, FL"
39,2016,Apr,35898,33709,2189,6.1,"Highlands County, FL"
40,2016,May,36030,33855,2175,6.0,"Highlands County, FL"
41,2016,Jun,34873,32473,2400,6.9,"Highlands County, FL"
42,2016,Jul,34591,32070,2521,7.3,"Highlands County, FL"
43,2016,Aug,35931,33391,2540,7.1,"Highlands County, FL"
44,2016,Sep,35992,33526,2466,6.9,"Highlands County, FL"
45,2016,Oct,35951,33558,2393,6.7,"Highlands County, FL"
46,2016,Nov,36243,33911,2332,6.4,"Highlands County, FL"
47,2016,Dec,36336,34097,2239,6.2,"Highlands County, FL"
48,2017,Jan,36190,33849,2341,6.5,"Highlands County, FL"
49,2017,Feb,36274,34124,2150,5.9,"Highlands County, FL"
50,2017,Mar,36534,34569,1965,5.4,"Highlands County, FL"
51,2017,Apr,36511,34668,1843,5.0,"Highlands County, FL"
52,2017,May,36677,34734,1943,5.3,"Highlands County, FL"
53,2017,Jun,35560,33446,2114,5.9,"Highlands County, FL"
54,2017,Jul,35004,32741,2263,6.5,"Highlands County, FL"
55,2017,Aug,35988,33711,2277,6.3,"Highlands County, FL"
56,2017,Sep,35445,33317,2128,6.0,"Highlands County, FL"
57,2017,Oct,36081,34048,2033,5.6,"Highlands County, FL"
58,2017,Nov,36446,34449,1997,5.5,"Highlands County, FL"
59,2017,Dec,36770,34900,1870,5.1,"Highlands County, FL"
60,2018,Jan,37027,35020,2007,5.4,"Highlands County, FL"
61,2018,Feb,37037,35182,1855,5.0,"Highlands County, FL"
62,2018,Mar,36993,35230,1763,4.8,"Highlands County, FL"
63,2018,Apr,36737,35122,1615,4.4,"Highlands County, FL"
64,2018,May,36090,34465,1625,4.5,"Highlands County, FL"
65,2018,Jun,36414,34448,1966,5.4,"Highlands County, FL"
66,2018,Jul,35654,33659,1995,5.6,"Highlands County, FL"
67,2018,Aug,35465,33529,1936,5.5,"Highlands County, FL"
68,2018,Sep,35788,34030,1758,4.9,"Highlands County, FL"
69,2018,Oct,35921,34186,1735,4.8,"Highlands County, FL"
70,2018,Nov,35768,34091,1677,4.7,"Highlands County, FL"
71,2018,Dec,36150,34461,1689,4.7,"Highlands County, FL"
72,2019,Jan,35922,33990,1932,5.4,"Highlands County, FL"
73,2019,Feb,35803,34096,1707,4.8,"Highlands County, FL"
74,2019,Mar,35687,34050,1637,4.6,"Highlands County, FL"
75,2019,Apr,35855,34381,1474,4.1,"Highlands County, FL"
76,2019,May,36042,34460,1582,4.4,"Highlands County, FL"
77,2019,Jun,35993,34181,1812,5.0,"Highlands County, FL"
78,2019,Jul,35196,33307,1889,5.4,"Highlands County, FL"
79,2019,Aug,35292,33429,1863,5.3,"Highlands County, FL"
80,2019,Sep,35451,33816,1635,4.6,"Highlands County, FL"
81,2019,Oct,35264,33682,1582,4.5,"Highlands County, FL"
82,2019,Nov,35255,33716,1539,4.4,"Highlands County, FL"
83,2019,Dec,35181,33720,1461,4.2,"Highlands County, FL"
84,2020,Jan,35431,33765,1666,4.7,"Highlands County, FL"
85,2020,Feb,35336,33885,1451,4.1,"Highlands County, FL"
86,2020,Mar,35130,33010,2120,6.0,"Highlands County, FL"
87,2020,Apr,31804,28509,3295,10.4,"Highlands County, FL"
88,2020,May,34123,30221,3902,11.4,"Highlands County, FL"
89,2020,Jun,34574,30915,3659,10.6,"Highlands County, FL"
90,2020,Jul,34857,30549,4308,12.4,"Highlands County, FL"
91,2020,Aug,34330,31278,3052,8.9,"Highlands County, FL"
92,2020,Sep,34742,31739,3003,8.6,"Highlands County, FL"
93,2020,Oct,35080,32488,2592,7.4,"Highlands County, FL"
94,2020,Nov,35164,32745,2419,6.9,"Highlands County, FL"
95,2020,Dec,35301,32882,2419,6.9,"Highlands County, FL"
96,2021,Jan,34829,32234,2595,7.5,"Highlands County, FL"
97,2021,Feb,34752,32524,2228,6.4,"Highlands County, FL"
98,2021,Mar,34916,32756,2160,6.2,"Highlands County, FL"
99,2021,Apr,35001,32932,2069,5.9,"Highlands County, FL"
100,2021,May,35281,33251,2030,5.8,"Highlands County, FL"
101,2021,Jun,35885,33458,2427,6.8,"Highlands County, FL"
102,2021,Jul,34977,32707,2270,6.5,"Highlands County, FL"
103,2021,Aug,35114,32879,2235,6.4,"Highlands County, FL"
104,2021,Sep,35446,33426,2020,5.7,"Highlands County, FL"
105,2021,Oct,35640,33808,1832,5.1,"Highlands County, FL"
106,2021,Nov,35541,33796,1745,4.9,"Highlands County, FL"
107,2021,Dec,35478,33966,1512,4.3,"Highlands County, FL"
108,2022,Jan,36465,34608,1857,5.1,"Highlands County, FL"
109,2022,Feb,36372,34748,1624,4.5,"Highlands County, FL"
110,2022,Mar,36783,35286,1497,4.1,"Highlands County, FL"
111,2022,Apr,36211,34853,1358,3.8,"Highlands County, FL"
112,2022,May,36169,34806,1363,3.8,"Highlands County, FL"
113,2022,Jun,36497,34835,1662,4.6,"Highlands County, FL"
114,2022,Jul,35664,34101,1563,4.4,"Highlands County, FL"
115,2022,Aug,36010,34420,1590,4.4,"Highlands County, FL"
116,2022,Sep,36237,34785,1452,4.0,"Highlands County, FL"
117,2022,Oct,36166,34703,1463,4.0,"Highlands County, FL"
118,2022,Nov,35760,34338,1422,4.0,"Highlands County, FL"
119,2022,Dec,36090,34835,1255,3.5,"Highlands County, FL"
120,2023,Jan,36094,34682,1412,3.9,"Highlands County, FL"
121,2023,Feb,36494,35129,1365,3.7,"Highlands County, FL"
122,2023,Mar,36913,35529,1384,3.7,"Highlands County, FL"
123,2023,Apr,36824,35630,1194,3.2,"Highlands County, FL"
124,2023,May,36848,35385,1463,4.0,"Highlands County, FL"
125,2023,Jun,37251,35548,1703,4.6,"Highlands County, FL"
126,2023,Jul,37047,35302,1745,4.7,"Highlands County, FL"
127,2023,Aug,37549,35744,1805,4.8,"Highlands County, FL"
128,2023,Sep,37157,35405,1752,4.7,"Highlands County, FL"
129,2023,Oct,37065,35388,1677,4.5,"Highlands County, FL"
0,2013,Jan,13123,11182,1941,14.8,"Glenn County, CA"
1,2013,Feb,13045,11201,1844,14.1,"Glenn County, CA"
2,2013,Mar,12938,11208,1730,13.4,"Glenn County, CA"
3,2013,Apr,12753,11153,1600,12.5,"Glenn County, CA"
4,2013,May,12850,11317,1533,11.9,"Glenn County, CA"
5,2013,Jun,13080,11397,1683,12.9,"Glenn County, CA"
6,2013,Jul,12682,11032,1650,13.0,"Glenn County, CA"
7,2013,Aug,12799,11266,1533,12.0,"Glenn County, CA"
8,2013,Sep,12906,11541,1365,10.6,"Glenn County, CA"
9,2013,Oct,13288,11968,1320,9.9,"Glenn County, CA"
10,2013,Nov,13201,11805,1396,10.6,"Glenn County, CA"
11,2013,Dec,12735,11296,1439,11.3,"Glenn County, CA"
12,2014,Jan,12719,11057,1662,13.1,"Glenn County, CA"
13,2014,Feb,12745,11112,1633,12.8,"Glenn County, CA"
14,2014,Mar,12825,11177,1648,12.8,"Glenn County, CA"
15,2014,Apr,12726,11300,1426,11.2,"Glenn County, CA"
16,2014,May,12868,11518,1350,10.5,"Glenn County, CA"
17,2014,Jun,12815,11421,1394,10.9,"Glenn County, CA"
18,2014,Jul,12746,11294,1452,11.4,"Glenn County, CA"
19,2014,Aug,12717,11381,1336,10.5,"Glenn County, CA"
20,2014,Sep,13014,11873,1141,8.8,"Glenn County, CA"
21,2014,Oct,13031,11961,1070,8.2,"Glenn County, CA"
22,2014,Nov,12593,11456,1137,9.0,"Glenn County, CA"
23,2014,Dec,12594,11306,1288,10.2,"Glenn County, CA"
24,2015,Jan,12969,11564,1405,10.8,"Glenn County, CA"
25,2015,Feb,13013,11679,1334,10.3,"Glenn County, CA"
26,2015,Mar,13107,11846,1261,9.6,"Glenn County, CA"
27,2015,Apr,12913,11728,1185,9.2,"Glenn County, CA"
28,2015,May,13057,11935,1122,8.6,"Glenn County, CA"
29,2015,Jun,12854,11686,1168,9.1,"Glenn County, CA"
30,2015,Jul,12797,11599,1198,9.4,"Glenn County, CA"
31,2015,Aug,12954,11894,1060,8.2,"Glenn County, CA"
32,2015,Sep,13211,12303,908,6.9,"Glenn County, CA"
33,2015,Oct,13257,12381,876,6.6,"Glenn County, CA"
34,2015,Nov,12747,11736,1011,7.9,"Glenn County, CA"
35,2015,Dec,12688,11575,1113,8.8,"Glenn County, CA"
36,2016,Jan,12825,11536,1289,10.1,"Glenn County, CA"
37,2016,Feb,12965,11726,1239,9.6,"Glenn County, CA"
38,2016,Mar,13072,11766,1306,10.0,"Glenn County, CA"
39,2016,Apr,12984,11892,1092,8.4,"Glenn County, CA"
40,2016,May,12941,11968,973,7.5,"Glenn County, CA"
41,2016,Jun,12957,11857,1100,8.5,"Glenn County, CA"
42,2016,Jul,12899,11778,1121,8.7,"Glenn County, CA"
43,2016,Aug,12880,11855,1025,8.0,"Glenn County, CA"
44,2016,Sep,13043,12144,899,6.9,"Glenn County, CA"
45,2016,Oct,13064,12198,866,6.6,"Glenn County, CA"
46,2016,Nov,12856,11919,937,7.3,"Glenn County, CA"
47,2016,Dec,12895,11764,1131,8.8,"Glenn County, CA"
48,2017,Jan,12915,11682,1233,9.5,"Glenn County, CA"
49,2017,Feb,12993,11739,1254,9.7,"Glenn County, CA"
50,2017,Mar,13025,11866,1159,8.9,"Glenn County, CA"
51,2017,Apr,12854,11825,1029,8.0,"Glenn County, CA"
52,2017,May,12781,11854,927,7.3,"Glenn County, CA"
53,2017,Jun,12700,11716,984,7.7,"Glenn County, CA"
54,2017,Jul,12651,11661,990,7.8,"Glenn County, CA"
55,2017,Aug,12688,11766,922,7.3,"Glenn County, CA"
56,2017,Sep,13018,12254,764,5.9,"Glenn County, CA"
57,2017,Oct,12891,12176,715,5.5,"Glenn County, CA"
58,2017,Nov,12566,11813,753,6.0,"Glenn County, CA"
59,2017,Dec,12556,11725,831,6.6,"Glenn County, CA"
60,2018,Jan,12615,11616,999,7.9,"Glenn County, CA"
61,2018,Feb,12915,11924,991,7.7,"Glenn County, CA"
62,2018,Mar,12845,11848,997,7.8,"Glenn County, CA"
63,2018,Apr,12719,11858,861,6.8,"Glenn County, CA"
64,2018,May,12732,11975,757,5.9,"Glenn County, CA"
65,2018,Jun,12625,11771,854,6.8,"Glenn County, CA"
66,2018,Jul,12592,11702,890,7.1,"Glenn County, CA"
67,2018,Aug,12602,11801,801,6.4,"Glenn County, CA"
68,2018,Sep,12894,12198,696,5.4,"Glenn County, CA"
69,2018,Oct,13148,12497,651,5.0,"Glenn County, CA"
70,2018,Nov,12672,11963,709,5.6,"Glenn County, CA"
71,2018,Dec,12836,11968,868,6.8,"Glenn County, CA"
72,2019,Jan,12953,11883,1070,8.3,"Glenn County, CA"
73,2019,Feb,13144,12127,1017,7.7,"Glenn County, CA"
74,2019,Mar,13058,12064,994,7.6,"Glenn County, CA"
75,2019,Apr,12923,12099,824,6.4,"Glenn County, CA"
76,2019,May,12910,12178,732,5.7,"Glenn County, CA"
77,2019,Jun,12917,12115,802,6.2,"Glenn County, CA"
78,2019,Jul,12928,12104,824,6.4,"Glenn County, CA"
79,2019,Aug,12976,12200,776,6.0,"Glenn County, CA"
80,2019,Sep,13307,12689,618,4.6,"Glenn County, CA"
81,2019,Oct,13386,12779,607,4.5,"Glenn County, CA"
82,2019,Nov,12828,12187,641,5.0,"Glenn County, CA"
83,2019,Dec,12780,12045,735,5.8,"Glenn County, CA"
84,2020,Jan,12931,11946,985,7.6,"Glenn County, CA"
85,2020,Feb,13258,12327,931,7.0,"Glenn County, CA"
86,2020,Mar,13374,12048,1326,9.9,"Glenn County, CA"
87,2020,Apr,12773,10909,1864,14.6,"Glenn County, CA"
88,2020,May,12572,11075,1497,11.9,"Glenn County, CA"
89,2020,Jun,12712,11390,1322,10.4,"Glenn County, CA"
90,2020,Jul,12462,11207,1255,10.1,"Glenn County, CA"
91,2020,Aug,12512,11494,1018,8.1,"Glenn County, CA"
92,2020,Sep,12684,11746,938,7.4,"Glenn County, CA"
93,2020,Oct,12831,11986,845,6.6,"Glenn County, CA"
94,2020,Nov,12544,11668,876,7.0,"Glenn County, CA"
95,2020,Dec,12761,11803,958,7.5,"Glenn County, CA"
96,2021,Jan,12652,11600,1052,8.3,"Glenn County, CA"
97,2021,Feb,12793,11720,1073,8.4,"Glenn County, CA"
98,2021,Mar,13028,11986,1042,8.0,"Glenn County, CA"
99,2021,Apr,12589,11615,974,7.7,"Glenn County, CA"
100,2021,May,12569,11682,887,7.1,"Glenn County, CA"
101,2021,Jun,12603,11623,980,7.8,"Glenn County, CA"
102,2021,Jul,12453,11524,929,7.5,"Glenn County, CA"
103,2021,Aug,12554,11650,904,7.2,"Glenn County, CA"
104,2021,Sep,12792,12051,741,5.8,"Glenn County, CA"
105,2021,Oct,12648,11941,707,5.6,"Glenn County, CA"
106,2021,Nov,12404,11728,676,5.4,"Glenn County, CA"
107,2021,Dec,12460,11776,684,5.5,"Glenn County, CA"
108,2022,Jan,12810,11952,858,6.7,"Glenn County, CA"
109,2022,Feb,12907,12119,788,6.1,"Glenn County, CA"
110,2022,Mar,12995,12276,719,5.5,"Glenn County, CA"
111,2022,Apr,12733,12093,640,5.0,"Glenn County, CA"
112,2022,May,12774,12180,594,4.7,"Glenn County, CA"
113,2022,Jun,12724,12046,678,5.3,"Glenn County, CA"
114,2022,Jul,12539,11864,675,5.4,"Glenn County, CA"
115,2022,Aug,12965,12289,676,5.2,"Glenn County, CA"
116,2022,Sep,12997,12405,592,4.6,"Glenn County, CA"
117,2022,Oct,13111,12485,626,4.8,"Glenn County, CA"
118,2022,Nov,12838,12167,671,5.2,"Glenn County, CA"
119,2022,Dec,12947,12228,719,5.6,"Glenn County, CA"
120,2023,Jan,12882,11961,921,7.1,"Glenn County, CA"
121,2023,Feb,13106,12190,916,7.0,"Glenn County, CA"
122,2023,Mar,13043,12104,939,7.2,"Glenn County, CA"
123,2023,Apr,12506,11731,775,6.2,"Glenn County, CA"
124,2023,May,12615,11811,804,6.4,"Glenn County, CA"
125,2023,Jun,12539,11729,810,6.5,"Glenn County, CA"
126,2023,Jul,12090,11329,761,6.3,"Glenn County, CA"
127,2023,Aug,12247,11455,792,6.5,"Glenn County, CA"
128,2023,Sep,12764,12073,691,5.4,"Glenn County, CA"
129,2023,Oct,12924,12225,699,5.4,"Glenn County, CA"
0,2013,Jan,25146,21656,3490,13.9,"Tehama County, CA"
1,2013,Feb,24847,21505,3342,13.5,"Tehama County, CA"
2,2013,Mar,24703,21470,3233,13.1,"Tehama County, CA"
3,2013,Apr,24609,21624,2985,12.1,"Tehama County, CA"
4,2013,May,24843,21988,2855,11.5,"Tehama County, CA"
5,2013,Jun,25242,22133,3109,12.3,"Tehama County, CA"
6,2013,Jul,24947,21930,3017,12.1,"Tehama County, CA"
7,2013,Aug,25262,22448,2814,11.1,"Tehama County, CA"
8,2013,Sep,25549,22905,2644,10.3,"Tehama County, CA"
9,2013,Oct,25634,23022,2612,10.2,"Tehama County, CA"
10,2013,Nov,24816,22214,2602,10.5,"Tehama County, CA"
11,2013,Dec,24474,21888,2586,10.6,"Tehama County, CA"
12,2014,Jan,25048,22219,2829,11.3,"Tehama County, CA"
13,2014,Feb,24989,22128,2861,11.4,"Tehama County, CA"
14,2014,Mar,25013,22125,2888,11.5,"Tehama County, CA"
15,2014,Apr,24821,22363,2458,9.9,"Tehama County, CA"
16,2014,May,25030,22706,2324,9.3,"Tehama County, CA"
17,2014,Jun,25241,22780,2461,9.8,"Tehama County, CA"
18,2014,Jul,24754,22179,2575,10.4,"Tehama County, CA"
19,2014,Aug,24991,22624,2367,9.5,"Tehama County, CA"
20,2014,Sep,25434,23312,2122,8.3,"Tehama County, CA"
21,2014,Oct,25651,23603,2048,8.0,"Tehama County, CA"
22,2014,Nov,25002,22890,2112,8.4,"Tehama County, CA"
23,2014,Dec,24515,22325,2190,8.9,"Tehama County, CA"
24,2015,Jan,24976,22571,2405,9.6,"Tehama County, CA"
25,2015,Feb,24734,22449,2285,9.2,"Tehama County, CA"
26,2015,Mar,24785,22562,2223,9.0,"Tehama County, CA"
27,2015,Apr,24805,22822,1983,8.0,"Tehama County, CA"
28,2015,May,24926,22982,1944,7.8,"Tehama County, CA"
29,2015,Jun,25215,23171,2044,8.1,"Tehama County, CA"
30,2015,Jul,24807,22712,2095,8.4,"Tehama County, CA"
31,2015,Aug,25210,23307,1903,7.5,"Tehama County, CA"
32,2015,Sep,25711,23983,1728,6.7,"Tehama County, CA"
33,2015,Oct,25677,23981,1696,6.6,"Tehama County, CA"
34,2015,Nov,24846,23089,1757,7.1,"Tehama County, CA"
35,2015,Dec,24546,22724,1822,7.4,"Tehama County, CA"
36,2016,Jan,24567,22521,2046,8.3,"Tehama County, CA"
37,2016,Feb,24796,22816,1980,8.0,"Tehama County, CA"
38,2016,Mar,24786,22741,2045,8.3,"Tehama County, CA"
39,2016,Apr,24766,22959,1807,7.3,"Tehama County, CA"
40,2016,May,24862,23238,1624,6.5,"Tehama County, CA"
41,2016,Jun,25152,23289,1863,7.4,"Tehama County, CA"
42,2016,Jul,24864,22933,1931,7.8,"Tehama County, CA"
43,2016,Aug,25330,23531,1799,7.1,"Tehama County, CA"
44,2016,Sep,26032,24430,1602,6.2,"Tehama County, CA"
45,2016,Oct,25789,24256,1533,5.9,"Tehama County, CA"
46,2016,Nov,25187,23625,1562,6.2,"Tehama County, CA"
47,2016,Dec,24726,23025,1701,6.9,"Tehama County, CA"
48,2017,Jan,25159,23159,2000,7.9,"Tehama County, CA"
49,2017,Feb,25253,23250,2003,7.9,"Tehama County, CA"
50,2017,Mar,25405,23501,1904,7.5,"Tehama County, CA"
51,2017,Apr,25166,23458,1708,6.8,"Tehama County, CA"
52,2017,May,25268,23708,1560,6.2,"Tehama County, CA"
53,2017,Jun,25665,23961,1704,6.6,"Tehama County, CA"
54,2017,Jul,25435,23700,1735,6.8,"Tehama County, CA"
55,2017,Aug,25626,23985,1641,6.4,"Tehama County, CA"
56,2017,Sep,26037,24650,1387,5.3,"Tehama County, CA"
57,2017,Oct,26436,25152,1284,4.9,"Tehama County, CA"
58,2017,Nov,25581,24281,1300,5.1,"Tehama County, CA"
59,2017,Dec,25101,23700,1401,5.6,"Tehama County, CA"
60,2018,Jan,25299,23651,1648,6.5,"Tehama County, CA"
61,2018,Feb,25604,23933,1671,6.5,"Tehama County, CA"
62,2018,Mar,25310,23627,1683,6.6,"Tehama County, CA"
63,2018,Apr,25223,23760,1463,5.8,"Tehama County, CA"
64,2018,May,25293,23987,1306,5.2,"Tehama County, CA"
65,2018,Jun,25573,24076,1497,5.9,"Tehama County, CA"
66,2018,Jul,25376,23817,1559,6.1,"Tehama County, CA"
67,2018,Aug,25413,23969,1444,5.7,"Tehama County, CA"
68,2018,Sep,25795,24523,1272,4.9,"Tehama County, CA"
69,2018,Oct,26102,24856,1246,4.8,"Tehama County, CA"
70,2018,Nov,25529,24253,1276,5.0,"Tehama County, CA"
71,2018,Dec,25302,23821,1481,5.9,"Tehama County, CA"
72,2019,Jan,25524,23662,1862,7.3,"Tehama County, CA"
73,2019,Feb,25566,23839,1727,6.8,"Tehama County, CA"
74,2019,Mar,25443,23712,1731,6.8,"Tehama County, CA"
75,2019,Apr,25177,23737,1440,5.7,"Tehama County, CA"
76,2019,May,25357,24069,1288,5.1,"Tehama County, CA"
77,2019,Jun,25606,24161,1445,5.6,"Tehama County, CA"
78,2019,Jul,25482,23964,1518,6.0,"Tehama County, CA"
79,2019,Aug,25567,24151,1416,5.5,"Tehama County, CA"
80,2019,Sep,26097,24920,1177,4.5,"Tehama County, CA"
81,2019,Oct,26180,24965,1215,4.6,"Tehama County, CA"
82,2019,Nov,25835,24610,1225,4.7,"Tehama County, CA"
83,2019,Dec,25388,24078,1310,5.2,"Tehama County, CA"
84,2020,Jan,26056,24384,1672,6.4,"Tehama County, CA"
85,2020,Feb,26218,24624,1594,6.1,"Tehama County, CA"
86,2020,Mar,26389,24144,2245,8.5,"Tehama County, CA"
87,2020,Apr,25397,21566,3831,15.1,"Tehama County, CA"
88,2020,May,24563,21433,3130,12.7,"Tehama County, CA"
89,2020,Jun,25691,22930,2761,10.7,"Tehama County, CA"
90,2020,Jul,25504,22875,2629,10.3,"Tehama County, CA"
91,2020,Aug,25924,23733,2191,8.5,"Tehama County, CA"
92,2020,Sep,25997,23907,2090,8.0,"Tehama County, CA"
93,2020,Oct,26155,24262,1893,7.2,"Tehama County, CA"
94,2020,Nov,25507,23562,1945,7.6,"Tehama County, CA"
95,2020,Dec,25285,23215,2070,8.2,"Tehama County, CA"
96,2021,Jan,25333,23169,2164,8.5,"Tehama County, CA"
97,2021,Feb,25509,23265,2244,8.8,"Tehama County, CA"
98,2021,Mar,25542,23342,2200,8.6,"Tehama County, CA"
99,2021,Apr,25397,23364,2033,8.0,"Tehama County, CA"
100,2021,May,25541,23698,1843,7.2,"Tehama County, CA"
101,2021,Jun,25804,23733,2071,8.0,"Tehama County, CA"
102,2021,Jul,25506,23531,1975,7.7,"Tehama County, CA"
103,2021,Aug,25980,24160,1820,7.0,"Tehama County, CA"
104,2021,Sep,25905,24353,1552,6.0,"Tehama County, CA"
105,2021,Oct,26116,24630,1486,5.7,"Tehama County, CA"
106,2021,Nov,25537,24127,1410,5.5,"Tehama County, CA"
107,2021,Dec,25228,23895,1333,5.3,"Tehama County, CA"
108,2022,Jan,25674,24082,1592,6.2,"Tehama County, CA"
109,2022,Feb,25717,24252,1465,5.7,"Tehama County, CA"
110,2022,Mar,25759,24440,1319,5.1,"Tehama County, CA"
111,2022,Apr,25292,24141,1151,4.6,"Tehama County, CA"
112,2022,May,25626,24567,1059,4.1,"Tehama County, CA"
113,2022,Jun,25616,24393,1223,4.8,"Tehama County, CA"
114,2022,Jul,25208,23975,1233,4.9,"Tehama County, CA"
115,2022,Aug,26210,24978,1232,4.7,"Tehama County, CA"
116,2022,Sep,26186,25090,1096,4.2,"Tehama County, CA"
117,2022,Oct,26356,25213,1143,4.3,"Tehama County, CA"
118,2022,Nov,25755,24531,1224,4.8,"Tehama County, CA"
119,2022,Dec,25427,24184,1243,4.9,"Tehama County, CA"
120,2023,Jan,25591,24009,1582,6.2,"Tehama County, CA"
121,2023,Feb,25667,24015,1652,6.4,"Tehama County, CA"
122,2023,Mar,25891,24145,1746,6.7,"Tehama County, CA"
123,2023,Apr,25184,23711,1473,5.8,"Tehama County, CA"
124,2023,May,25271,23813,1458,5.8,"Tehama County, CA"
125,2023,Jun,25407,23825,1582,6.2,"Tehama County, CA"
126,2023,Jul,25053,23538,1515,6.0,"Tehama County, CA"
127,2023,Aug,25714,24159,1555,6.0,"Tehama County, CA"
128,2023,Sep,25851,24465,1386,5.4,"Tehama County, CA"
129,2023,Oct,25891,24512,1379,5.3,"Tehama County, CA"
0,2013,Jan,277294,250946,26348,9.5,"Polk County, FL"
1,2013,Feb,276118,251907,24211,8.8,"Polk County, FL"
2,2013,Mar,276827,253736,23091,8.3,"Polk County, FL"
3,2013,Apr,278378,256110,22268,8.0,"Polk County, FL"
4,2013,May,280744,257364,23380,8.3,"Polk County, FL"
5,2013,Jun,279272,253960,25312,9.1,"Polk County, FL"
6,2013,Jul,278167,252695,25472,9.2,"Polk County, FL"
7,2013,Aug,278949,253657,25292,9.1,"Polk County, FL"
8,2013,Sep,279964,255632,24332,8.7,"Polk County, FL"
9,2013,Oct,278516,254906,23610,8.5,"Polk County, FL"
10,2013,Nov,276667,254621,22046,8.0,"Polk County, FL"
11,2013,Dec,276616,255798,20818,7.5,"Polk County, FL"
12,2014,Jan,276680,254857,21823,7.9,"Polk County, FL"
13,2014,Feb,277333,256168,21165,7.6,"Polk County, FL"
14,2014,Mar,278798,258122,20676,7.4,"Polk County, FL"
15,2014,Apr,276848,258012,18836,6.8,"Polk County, FL"
16,2014,May,279936,259931,20005,7.1,"Polk County, FL"
17,2014,Jun,278295,257115,21180,7.6,"Polk County, FL"
18,2014,Jul,278275,255733,22542,8.1,"Polk County, FL"
19,2014,Aug,278455,256194,22261,8.0,"Polk County, FL"
20,2014,Sep,279692,258760,20932,7.5,"Polk County, FL"
21,2014,Oct,278650,258902,19748,7.1,"Polk County, FL"
22,2014,Nov,277322,257699,19623,7.1,"Polk County, FL"
23,2014,Dec,277248,259022,18226,6.6,"Polk County, FL"
24,2015,Jan,278754,259102,19652,7.0,"Polk County, FL"
25,2015,Feb,277766,259681,18085,6.5,"Polk County, FL"
26,2015,Mar,278593,261448,17145,6.2,"Polk County, FL"
27,2015,Apr,279734,263073,16661,6.0,"Polk County, FL"
28,2015,May,283445,265584,17861,6.3,"Polk County, FL"
29,2015,Jun,282468,263671,18797,6.7,"Polk County, FL"
30,2015,Jul,282060,262340,19720,7.0,"Polk County, FL"
31,2015,Aug,282600,263649,18951,6.7,"Polk County, FL"
32,2015,Sep,283258,265284,17974,6.3,"Polk County, FL"
33,2015,Oct,280895,263561,17334,6.2,"Polk County, FL"
34,2015,Nov,281249,264269,16980,6.0,"Polk County, FL"
35,2015,Dec,281885,265768,16117,5.7,"Polk County, FL"
36,2016,Jan,283206,266305,16901,6.0,"Polk County, FL"
37,2016,Feb,284357,268758,15599,5.5,"Polk County, FL"
38,2016,Mar,286176,270827,15349,5.4,"Polk County, FL"
39,2016,Apr,286144,271344,14800,5.2,"Polk County, FL"
40,2016,May,289579,274950,14629,5.1,"Polk County, FL"
41,2016,Jun,288982,272190,16792,5.8,"Polk County, FL"
42,2016,Jul,288413,271084,17329,6.0,"Polk County, FL"
43,2016,Aug,290170,272720,17450,6.0,"Polk County, FL"
44,2016,Sep,291782,274638,17144,5.9,"Polk County, FL"
45,2016,Oct,289074,272851,16223,5.6,"Polk County, FL"
46,2016,Nov,287705,272148,15557,5.4,"Polk County, FL"
47,2016,Dec,288533,273622,14911,5.2,"Polk County, FL"
48,2017,Jan,288304,272057,16247,5.6,"Polk County, FL"
49,2017,Feb,288594,273855,14739,5.1,"Polk County, FL"
50,2017,Mar,291134,277291,13843,4.8,"Polk County, FL"
51,2017,Apr,290852,277874,12978,4.5,"Polk County, FL"
52,2017,May,292031,278698,13333,4.6,"Polk County, FL"
53,2017,Jun,292906,278162,14744,5.0,"Polk County, FL"
54,2017,Jul,291495,276257,15238,5.2,"Polk County, FL"
55,2017,Aug,292271,276941,15330,5.2,"Polk County, FL"
56,2017,Sep,293691,279625,14066,4.8,"Polk County, FL"
57,2017,Oct,290510,276997,13513,4.7,"Polk County, FL"
58,2017,Nov,290745,277172,13573,4.7,"Polk County, FL"
59,2017,Dec,290924,278319,12605,4.3,"Polk County, FL"
60,2018,Jan,291662,277659,14003,4.8,"Polk County, FL"
61,2018,Feb,291995,279099,12896,4.4,"Polk County, FL"
62,2018,Mar,292515,280126,12389,4.2,"Polk County, FL"
63,2018,Apr,294558,282935,11623,3.9,"Polk County, FL"
64,2018,May,295665,284098,11567,3.9,"Polk County, FL"
65,2018,Jun,297509,283662,13847,4.7,"Polk County, FL"
66,2018,Jul,298960,285238,13722,4.6,"Polk County, FL"
67,2018,Aug,298330,285018,13312,4.5,"Polk County, FL"
68,2018,Sep,300648,288354,12294,4.1,"Polk County, FL"
69,2018,Oct,300839,288626,12213,4.1,"Polk County, FL"
70,2018,Nov,300678,289220,11458,3.8,"Polk County, FL"
71,2018,Dec,299744,288396,11348,3.8,"Polk County, FL"
72,2019,Jan,299381,286075,13306,4.4,"Polk County, FL"
73,2019,Feb,298819,287286,11533,3.9,"Polk County, FL"
74,2019,Mar,300255,288905,11350,3.8,"Polk County, FL"
75,2019,Apr,299990,289789,10201,3.4,"Polk County, FL"
76,2019,May,301971,291072,10899,3.6,"Polk County, FL"
77,2019,Jun,304610,291930,12680,4.2,"Polk County, FL"
78,2019,Jul,305603,292350,13253,4.3,"Polk County, FL"
79,2019,Aug,307653,294750,12903,4.2,"Polk County, FL"
80,2019,Sep,309778,298038,11740,3.8,"Polk County, FL"
81,2019,Oct,309298,297852,11446,3.7,"Polk County, FL"
82,2019,Nov,308747,298002,10745,3.5,"Polk County, FL"
83,2019,Dec,309300,299407,9893,3.2,"Polk County, FL"
84,2020,Jan,311145,299483,11662,3.7,"Polk County, FL"
85,2020,Feb,311558,301616,9942,3.2,"Polk County, FL"
86,2020,Mar,309358,294551,14807,4.8,"Polk County, FL"
87,2020,Apr,299227,260821,38406,12.8,"Polk County, FL"
88,2020,May,330800,271453,59347,17.9,"Polk County, FL"
89,2020,Jun,328460,278429,50031,15.2,"Polk County, FL"
90,2020,Jul,327554,280749,46805,14.3,"Polk County, FL"
91,2020,Aug,323730,290365,33365,10.3,"Polk County, FL"
92,2020,Sep,325296,294285,31011,9.5,"Polk County, FL"
93,2020,Oct,324324,298744,25580,7.9,"Polk County, FL"
94,2020,Nov,322719,299319,23400,7.3,"Polk County, FL"
95,2020,Dec,325238,303486,21752,6.7,"Polk County, FL"
96,2021,Jan,322380,300531,21849,6.8,"Polk County, FL"
97,2021,Feb,323884,304090,19794,6.1,"Polk County, FL"
98,2021,Mar,324560,305927,18633,5.7,"Polk County, FL"
99,2021,Apr,326127,307951,18176,5.6,"Polk County, FL"
100,2021,May,327061,309146,17915,5.5,"Polk County, FL"
101,2021,Jun,328555,308160,20395,6.2,"Polk County, FL"
102,2021,Jul,327869,308552,19317,5.9,"Polk County, FL"
103,2021,Aug,329307,311031,18276,5.5,"Polk County, FL"
104,2021,Sep,332897,316434,16463,4.9,"Polk County, FL"
105,2021,Oct,333534,317920,15614,4.7,"Polk County, FL"
106,2021,Nov,332388,317892,14496,4.4,"Polk County, FL"
107,2021,Dec,330670,318169,12501,3.8,"Polk County, FL"
108,2022,Jan,332526,317604,14922,4.5,"Polk County, FL"
109,2022,Feb,333154,320269,12885,3.9,"Polk County, FL"
110,2022,Mar,335591,324007,11584,3.5,"Polk County, FL"
111,2022,Apr,335912,325138,10774,3.2,"Polk County, FL"
112,2022,May,337649,326677,10972,3.2,"Polk County, FL"
113,2022,Jun,338624,325819,12805,3.8,"Polk County, FL"
114,2022,Jul,338282,325954,12328,3.6,"Polk County, FL"
115,2022,Aug,341248,328732,12516,3.7,"Polk County, FL"
116,2022,Sep,343156,332102,11054,3.2,"Polk County, FL"
117,2022,Oct,341062,329755,11307,3.3,"Polk County, FL"
118,2022,Nov,341477,330705,10772,3.2,"Polk County, FL"
119,2022,Dec,341181,331805,9376,2.7,"Polk County, FL"
120,2023,Jan,341350,330818,10532,3.1,"Polk County, FL"
121,2023,Feb,342460,332003,10457,3.1,"Polk County, FL"
122,2023,Mar,346383,335678,10705,3.1,"Polk County, FL"
123,2023,Apr,346038,336329,9709,2.8,"Polk County, FL"
124,2023,May,346063,334642,11421,3.3,"Polk County, FL"
125,2023,Jun,347505,334424,13081,3.8,"Polk County, FL"
126,2023,Jul,348083,334413,13670,3.9,"Polk County, FL"
127,2023,Aug,351554,337592,13962,4.0,"Polk County, FL"
128,2023,Sep,352249,338845,13404,3.8,"Polk County, FL"
129,2023,Oct,351506,337758,13748,3.9,"Polk County, FL"
0,2013,Jan,5887,5384,503,8.5,"Gulf County, FL"
1,2013,Feb,5972,5511,461,7.7,"Gulf County, FL"
2,2013,Mar,6134,5699,435,7.1,"Gulf County, FL"
3,2013,Apr,6133,5733,400,6.5,"Gulf County, FL"
4,2013,May,6211,5798,413,6.6,"Gulf County, FL"
5,2013,Jun,6334,5892,442,7.0,"Gulf County, FL"
6,2013,Jul,6396,5948,448,7.0,"Gulf County, FL"
7,2013,Aug,6324,5890,434,6.9,"Gulf County, FL"
8,2013,Sep,6250,5827,423,6.8,"Gulf County, FL"
9,2013,Oct,6144,5716,428,7.0,"Gulf County, FL"
10,2013,Nov,6000,5587,413,6.9,"Gulf County, FL"
11,2013,Dec,5950,5557,393,6.6,"Gulf County, FL"
12,2014,Jan,5841,5397,444,7.6,"Gulf County, FL"
13,2014,Feb,5917,5515,402,6.8,"Gulf County, FL"
14,2014,Mar,6155,5747,408,6.6,"Gulf County, FL"
15,2014,Apr,6154,5793,361,5.9,"Gulf County, FL"
16,2014,May,6233,5849,384,6.2,"Gulf County, FL"
17,2014,Jun,6313,5925,388,6.1,"Gulf County, FL"
18,2014,Jul,6352,5937,415,6.5,"Gulf County, FL"
19,2014,Aug,6254,5859,395,6.3,"Gulf County, FL"
20,2014,Sep,6158,5810,348,5.7,"Gulf County, FL"
21,2014,Oct,6085,5740,345,5.7,"Gulf County, FL"
22,2014,Nov,5984,5632,352,5.9,"Gulf County, FL"
23,2014,Dec,5918,5577,341,5.8,"Gulf County, FL"
24,2015,Jan,5832,5451,381,6.5,"Gulf County, FL"
25,2015,Feb,5850,5517,333,5.7,"Gulf County, FL"
26,2015,Mar,6008,5699,309,5.1,"Gulf County, FL"
27,2015,Apr,6012,5706,306,5.1,"Gulf County, FL"
28,2015,May,6099,5785,314,5.1,"Gulf County, FL"
29,2015,Jun,6204,5871,333,5.4,"Gulf County, FL"
30,2015,Jul,6202,5858,344,5.5,"Gulf County, FL"
31,2015,Aug,6145,5824,321,5.2,"Gulf County, FL"
32,2015,Sep,6084,5777,307,5.0,"Gulf County, FL"
33,2015,Oct,6016,5726,290,4.8,"Gulf County, FL"
34,2015,Nov,5917,5624,293,5.0,"Gulf County, FL"
35,2015,Dec,5854,5547,307,5.2,"Gulf County, FL"
36,2016,Jan,5824,5507,317,5.4,"Gulf County, FL"
37,2016,Feb,5859,5577,282,4.8,"Gulf County, FL"
38,2016,Mar,5990,5712,278,4.6,"Gulf County, FL"
39,2016,Apr,5942,5675,267,4.5,"Gulf County, FL"
40,2016,May,6048,5789,259,4.3,"Gulf County, FL"
41,2016,Jun,6174,5885,289,4.7,"Gulf County, FL"
42,2016,Jul,6193,5900,293,4.7,"Gulf County, FL"
43,2016,Aug,6126,5830,296,4.8,"Gulf County, FL"
44,2016,Sep,6043,5757,286,4.7,"Gulf County, FL"
45,2016,Oct,5964,5700,264,4.4,"Gulf County, FL"
46,2016,Nov,5859,5595,264,4.5,"Gulf County, FL"
47,2016,Dec,5794,5522,272,4.7,"Gulf County, FL"
48,2017,Jan,5772,5474,298,5.2,"Gulf County, FL"
49,2017,Feb,5781,5531,250,4.3,"Gulf County, FL"
50,2017,Mar,5911,5682,229,3.9,"Gulf County, FL"
51,2017,Apr,5924,5701,223,3.8,"Gulf County, FL"
52,2017,May,5993,5771,222,3.7,"Gulf County, FL"
53,2017,Jun,6166,5923,243,3.9,"Gulf County, FL"
54,2017,Jul,6140,5886,254,4.1,"Gulf County, FL"
55,2017,Aug,6137,5882,255,4.2,"Gulf County, FL"
56,2017,Sep,6111,5883,228,3.7,"Gulf County, FL"
57,2017,Oct,5953,5753,200,3.4,"Gulf County, FL"
58,2017,Nov,5888,5673,215,3.7,"Gulf County, FL"
59,2017,Dec,5809,5589,220,3.8,"Gulf County, FL"
60,2018,Jan,5786,5532,254,4.4,"Gulf County, FL"
61,2018,Feb,5830,5592,238,4.1,"Gulf County, FL"
62,2018,Mar,5905,5689,216,3.7,"Gulf County, FL"
63,2018,Apr,5971,5775,196,3.3,"Gulf County, FL"
64,2018,May,6056,5867,189,3.1,"Gulf County, FL"
65,2018,Jun,6233,5984,249,4.0,"Gulf County, FL"
66,2018,Jul,6247,6004,243,3.9,"Gulf County, FL"
67,2018,Aug,6114,5892,222,3.6,"Gulf County, FL"
68,2018,Sep,6046,5857,189,3.1,"Gulf County, FL"
69,2018,Oct,5659,5471,188,3.3,"Gulf County, FL"
70,2018,Nov,5872,5280,592,10.1,"Gulf County, FL"
71,2018,Dec,5784,5295,489,8.5,"Gulf County, FL"
72,2019,Jan,5104,4711,393,7.7,"Gulf County, FL"
73,2019,Feb,5110,4784,326,6.4,"Gulf County, FL"
74,2019,Mar,5116,4833,283,5.5,"Gulf County, FL"
75,2019,Apr,5115,4866,249,4.9,"Gulf County, FL"
76,2019,May,5210,4961,249,4.8,"Gulf County, FL"
77,2019,Jun,5307,5050,257,4.8,"Gulf County, FL"
78,2019,Jul,5287,5039,248,4.7,"Gulf County, FL"
79,2019,Aug,5239,5005,234,4.5,"Gulf County, FL"
80,2019,Sep,5229,5016,213,4.1,"Gulf County, FL"
81,2019,Oct,5164,4970,194,3.8,"Gulf County, FL"
82,2019,Nov,5093,4909,184,3.6,"Gulf County, FL"
83,2019,Dec,5036,4861,175,3.5,"Gulf County, FL"
84,2020,Jan,5095,4895,200,3.9,"Gulf County, FL"
85,2020,Feb,5108,4951,157,3.1,"Gulf County, FL"
86,2020,Mar,5100,4873,227,4.5,"Gulf County, FL"
87,2020,Apr,4469,4076,393,8.8,"Gulf County, FL"
88,2020,May,4951,4499,452,9.1,"Gulf County, FL"
89,2020,Jun,5108,4712,396,7.8,"Gulf County, FL"
90,2020,Jul,5250,4784,466,8.9,"Gulf County, FL"
91,2020,Aug,5185,4827,358,6.9,"Gulf County, FL"
92,2020,Sep,5219,4902,317,6.1,"Gulf County, FL"
93,2020,Oct,5225,4964,261,5.0,"Gulf County, FL"
94,2020,Nov,5154,4901,253,4.9,"Gulf County, FL"
95,2020,Dec,5117,4862,255,5.0,"Gulf County, FL"
96,2021,Jan,5105,4856,249,4.9,"Gulf County, FL"
97,2021,Feb,5170,4924,246,4.8,"Gulf County, FL"
98,2021,Mar,5221,5021,200,3.8,"Gulf County, FL"
99,2021,Apr,5233,5048,185,3.5,"Gulf County, FL"
100,2021,May,5314,5136,178,3.3,"Gulf County, FL"
101,2021,Jun,5403,5193,210,3.9,"Gulf County, FL"
102,2021,Jul,5382,5180,202,3.8,"Gulf County, FL"
103,2021,Aug,5332,5135,197,3.7,"Gulf County, FL"
104,2021,Sep,5333,5160,173,3.2,"Gulf County, FL"
105,2021,Oct,5289,5121,168,3.2,"Gulf County, FL"
106,2021,Nov,5252,5088,164,3.1,"Gulf County, FL"
107,2021,Dec,5243,5074,169,3.2,"Gulf County, FL"
108,2022,Jan,5229,5036,193,3.7,"Gulf County, FL"
109,2022,Feb,5265,5095,170,3.2,"Gulf County, FL"
110,2022,Mar,5348,5202,146,2.7,"Gulf County, FL"
111,2022,Apr,5363,5240,123,2.3,"Gulf County, FL"
112,2022,May,5448,5326,122,2.2,"Gulf County, FL"
113,2022,Jun,5512,5357,155,2.8,"Gulf County, FL"
114,2022,Jul,5558,5400,158,2.8,"Gulf County, FL"
115,2022,Aug,5554,5398,156,2.8,"Gulf County, FL"
116,2022,Sep,5518,5383,135,2.4,"Gulf County, FL"
117,2022,Oct,5501,5358,143,2.6,"Gulf County, FL"
118,2022,Nov,5441,5305,136,2.5,"Gulf County, FL"
119,2022,Dec,5445,5328,117,2.1,"Gulf County, FL"
120,2023,Jan,5401,5277,124,2.3,"Gulf County, FL"
121,2023,Feb,5442,5321,121,2.2,"Gulf County, FL"
122,2023,Mar,5533,5411,122,2.2,"Gulf County, FL"
123,2023,Apr,5552,5444,108,1.9,"Gulf County, FL"
124,2023,May,5600,5474,126,2.3,"Gulf County, FL"
125,2023,Jun,5716,5568,148,2.6,"Gulf County, FL"
126,2023,Jul,5718,5563,155,2.7,"Gulf County, FL"
127,2023,Aug,5763,5596,167,2.9,"Gulf County, FL"
128,2023,Sep,5747,5579,168,2.9,"Gulf County, FL"
129,2023,Oct,5708,5555,153,2.7,"Gulf County, FL"
0,2013,Jan,201770,180167,21603,10.7,"Solano County, CA"
1,2013,Feb,201743,181497,20246,10.0,"Solano County, CA"
2,2013,Mar,202180,182761,19419,9.6,"Solano County, CA"
3,2013,Apr,200719,182610,18109,9.0,"Solano County, CA"
4,2013,May,201801,183888,17913,8.9,"Solano County, CA"
5,2013,Jun,203211,183838,19373,9.5,"Solano County, CA"
6,2013,Jul,204633,185441,19192,9.4,"Solano County, CA"
7,2013,Aug,202427,184106,18321,9.1,"Solano County, CA"
8,2013,Sep,203074,185524,17550,8.6,"Solano County, CA"
9,2013,Oct,202180,184593,17587,8.7,"Solano County, CA"
10,2013,Nov,202193,185012,17181,8.5,"Solano County, CA"
11,2013,Dec,202120,185586,16534,8.2,"Solano County, CA"
12,2014,Jan,200854,183197,17657,8.8,"Solano County, CA"
13,2014,Feb,200739,183337,17402,8.7,"Solano County, CA"
14,2014,Mar,201973,184451,17522,8.7,"Solano County, CA"
15,2014,Apr,200313,185173,15140,7.6,"Solano County, CA"
16,2014,May,201787,186913,14874,7.4,"Solano County, CA"
17,2014,Jun,202427,186850,15577,7.7,"Solano County, CA"
18,2014,Jul,203880,187631,16249,8.0,"Solano County, CA"
19,2014,Aug,202368,186953,15415,7.6,"Solano County, CA"
20,2014,Sep,202505,188461,14044,6.9,"Solano County, CA"
21,2014,Oct,203894,190063,13831,6.8,"Solano County, CA"
22,2014,Nov,204345,190413,13932,6.8,"Solano County, CA"
23,2014,Dec,203610,190224,13386,6.6,"Solano County, CA"
24,2015,Jan,203286,188837,14449,7.1,"Solano County, CA"
25,2015,Feb,203915,189944,13971,6.9,"Solano County, CA"
26,2015,Mar,204285,190604,13681,6.7,"Solano County, CA"
27,2015,Apr,203641,191147,12494,6.1,"Solano County, CA"
28,2015,May,204693,192347,12346,6.0,"Solano County, CA"
29,2015,Jun,205235,192276,12959,6.3,"Solano County, CA"
30,2015,Jul,205187,191944,13243,6.5,"Solano County, CA"
31,2015,Aug,204742,192372,12370,6.0,"Solano County, CA"
32,2015,Sep,205008,193624,11384,5.6,"Solano County, CA"
33,2015,Oct,205705,194083,11622,5.6,"Solano County, CA"
34,2015,Nov,206561,194888,11673,5.7,"Solano County, CA"
35,2015,Dec,206167,194774,11393,5.5,"Solano County, CA"
36,2016,Jan,205478,193221,12257,6.0,"Solano County, CA"
37,2016,Feb,206851,194834,12017,5.8,"Solano County, CA"
38,2016,Mar,207949,195619,12330,5.9,"Solano County, CA"
39,2016,Apr,205874,194729,11145,5.4,"Solano County, CA"
40,2016,May,206205,196008,10197,4.9,"Solano County, CA"
41,2016,Jun,207784,195933,11851,5.7,"Solano County, CA"
42,2016,Jul,207265,195238,12027,5.8,"Solano County, CA"
43,2016,Aug,206886,195227,11659,5.6,"Solano County, CA"
44,2016,Sep,208160,197054,11106,5.3,"Solano County, CA"
45,2016,Oct,208323,197279,11044,5.3,"Solano County, CA"
46,2016,Nov,208617,197834,10783,5.2,"Solano County, CA"
47,2016,Dec,207880,197039,10841,5.2,"Solano County, CA"
48,2017,Jan,206806,194780,12026,5.8,"Solano County, CA"
49,2017,Feb,207089,195586,11503,5.6,"Solano County, CA"
50,2017,Mar,207951,197063,10888,5.2,"Solano County, CA"
51,2017,Apr,206621,196746,9875,4.8,"Solano County, CA"
52,2017,May,207541,198340,9201,4.4,"Solano County, CA"
53,2017,Jun,208311,198131,10180,4.9,"Solano County, CA"
54,2017,Jul,208910,198298,10612,5.1,"Solano County, CA"
55,2017,Aug,208710,198425,10285,4.9,"Solano County, CA"
56,2017,Sep,209617,200620,8997,4.3,"Solano County, CA"
57,2017,Oct,207811,198987,8824,4.2,"Solano County, CA"
58,2017,Nov,208066,199302,8764,4.2,"Solano County, CA"
59,2017,Dec,207924,199228,8696,4.2,"Solano County, CA"
60,2018,Jan,206811,197292,9519,4.6,"Solano County, CA"
61,2018,Feb,208542,199378,9164,4.4,"Solano County, CA"
62,2018,Mar,208460,199683,8777,4.2,"Solano County, CA"
63,2018,Apr,207870,200024,7846,3.8,"Solano County, CA"
64,2018,May,208512,201390,7122,3.4,"Solano County, CA"
65,2018,Jun,209457,200929,8528,4.1,"Solano County, CA"
66,2018,Jul,210333,201743,8590,4.1,"Solano County, CA"
67,2018,Aug,208769,200509,8260,4.0,"Solano County, CA"
68,2018,Sep,209344,201777,7567,3.6,"Solano County, CA"
69,2018,Oct,210152,202442,7710,3.7,"Solano County, CA"
70,2018,Nov,210501,202783,7718,3.7,"Solano County, CA"
71,2018,Dec,209963,201735,8228,3.9,"Solano County, CA"
72,2019,Jan,209037,199076,9961,4.8,"Solano County, CA"
73,2019,Feb,209877,200910,8967,4.3,"Solano County, CA"
74,2019,Mar,209500,200586,8914,4.3,"Solano County, CA"
75,2019,Apr,207589,200211,7378,3.6,"Solano County, CA"
76,2019,May,207771,200875,6896,3.3,"Solano County, CA"
77,2019,Jun,207992,199946,8046,3.9,"Solano County, CA"
78,2019,Jul,209208,200714,8494,4.1,"Solano County, CA"
79,2019,Aug,208185,200263,7922,3.8,"Solano County, CA"
80,2019,Sep,209102,202303,6799,3.3,"Solano County, CA"
81,2019,Oct,208300,201125,7175,3.4,"Solano County, CA"
82,2019,Nov,207896,200617,7279,3.5,"Solano County, CA"
83,2019,Dec,207605,200314,7291,3.5,"Solano County, CA"
84,2020,Jan,206001,197392,8609,4.2,"Solano County, CA"
85,2020,Feb,207945,199805,8140,3.9,"Solano County, CA"
86,2020,Mar,206458,194548,11910,5.8,"Solano County, CA"
87,2020,Apr,201239,168910,32329,16.1,"Solano County, CA"
88,2020,May,197477,168041,29436,14.9,"Solano County, CA"
89,2020,Jun,203440,177279,26161,12.9,"Solano County, CA"
90,2020,Jul,204003,179106,24897,12.2,"Solano County, CA"
91,2020,Aug,201482,180358,21124,10.5,"Solano County, CA"
92,2020,Sep,200565,180283,20282,10.1,"Solano County, CA"
93,2020,Oct,200113,181946,18167,9.1,"Solano County, CA"
94,2020,Nov,199069,181264,17805,8.9,"Solano County, CA"
95,2020,Dec,198825,180864,17961,9.0,"Solano County, CA"
96,2021,Jan,199089,180779,18310,9.2,"Solano County, CA"
97,2021,Feb,199487,181691,17796,8.9,"Solano County, CA"
98,2021,Mar,199806,182762,17044,8.5,"Solano County, CA"
99,2021,Apr,199225,182776,16449,8.3,"Solano County, CA"
100,2021,May,199440,184337,15103,7.6,"Solano County, CA"
101,2021,Jun,201379,184685,16694,8.3,"Solano County, CA"
102,2021,Jul,202216,186384,15832,7.8,"Solano County, CA"
103,2021,Aug,201438,186540,14898,7.4,"Solano County, CA"
104,2021,Sep,201289,188518,12771,6.3,"Solano County, CA"
105,2021,Oct,201781,189567,12214,6.1,"Solano County, CA"
106,2021,Nov,201916,190753,11163,5.5,"Solano County, CA"
107,2021,Dec,201013,190671,10342,5.1,"Solano County, CA"
108,2022,Jan,201079,189373,11706,5.8,"Solano County, CA"
109,2022,Feb,202166,191751,10415,5.2,"Solano County, CA"
110,2022,Mar,202944,193709,9235,4.6,"Solano County, CA"
111,2022,Apr,200053,192109,7944,4.0,"Solano County, CA"
112,2022,May,201347,194172,7175,3.6,"Solano County, CA"
113,2022,Jun,201522,193396,8126,4.0,"Solano County, CA"
114,2022,Jul,202793,194714,8079,4.0,"Solano County, CA"
115,2022,Aug,202547,194278,8269,4.1,"Solano County, CA"
116,2022,Sep,202668,195306,7362,3.6,"Solano County, CA"
117,2022,Oct,203671,195844,7827,3.8,"Solano County, CA"
118,2022,Nov,202773,194602,8171,4.0,"Solano County, CA"
119,2022,Dec,203724,195962,7762,3.8,"Solano County, CA"
120,2023,Jan,201242,191684,9558,4.7,"Solano County, CA"
121,2023,Feb,203263,193506,9757,4.8,"Solano County, CA"
122,2023,Mar,203938,194060,9878,4.8,"Solano County, CA"
123,2023,Apr,201735,193245,8490,4.2,"Solano County, CA"
124,2023,May,201560,192889,8671,4.3,"Solano County, CA"
125,2023,Jun,201021,191614,9407,4.7,"Solano County, CA"
126,2023,Jul,202019,192740,9279,4.6,"Solano County, CA"
127,2023,Aug,202101,192223,9878,4.9,"Solano County, CA"
128,2023,Sep,203917,194699,9218,4.5,"Solano County, CA"
129,2023,Oct,202423,192924,9499,4.7,"Solano County, CA"
0,2013,Jan,3462,3251,211,6.1,"Lafayette County, FL"
1,2013,Feb,3484,3290,194,5.6,"Lafayette County, FL"
2,2013,Mar,3488,3305,183,5.2,"Lafayette County, FL"
3,2013,Apr,3504,3324,180,5.1,"Lafayette County, FL"
4,2013,May,3555,3374,181,5.1,"Lafayette County, FL"
5,2013,Jun,3520,3324,196,5.6,"Lafayette County, FL"
6,2013,Jul,3516,3310,206,5.9,"Lafayette County, FL"
7,2013,Aug,3513,3323,190,5.4,"Lafayette County, FL"
8,2013,Sep,3542,3354,188,5.3,"Lafayette County, FL"
9,2013,Oct,3537,3351,186,5.3,"Lafayette County, FL"
10,2013,Nov,3415,3233,182,5.3,"Lafayette County, FL"
11,2013,Dec,3331,3156,175,5.3,"Lafayette County, FL"
12,2014,Jan,3329,3146,183,5.5,"Lafayette County, FL"
13,2014,Feb,3342,3170,172,5.1,"Lafayette County, FL"
14,2014,Mar,3369,3198,171,5.1,"Lafayette County, FL"
15,2014,Apr,3325,3161,164,4.9,"Lafayette County, FL"
16,2014,May,3361,3181,180,5.4,"Lafayette County, FL"
17,2014,Jun,3347,3160,187,5.6,"Lafayette County, FL"
18,2014,Jul,3395,3206,189,5.6,"Lafayette County, FL"
19,2014,Aug,3405,3222,183,5.4,"Lafayette County, FL"
20,2014,Sep,3363,3196,167,5.0,"Lafayette County, FL"
21,2014,Oct,3344,3166,178,5.3,"Lafayette County, FL"
22,2014,Nov,3323,3143,180,5.4,"Lafayette County, FL"
23,2014,Dec,3274,3106,168,5.1,"Lafayette County, FL"
24,2015,Jan,3269,3093,176,5.4,"Lafayette County, FL"
25,2015,Feb,3206,3043,163,5.1,"Lafayette County, FL"
26,2015,Mar,3223,3072,151,4.7,"Lafayette County, FL"
27,2015,Apr,3243,3097,146,4.5,"Lafayette County, FL"
28,2015,May,3350,3199,151,4.5,"Lafayette County, FL"
29,2015,Jun,3249,3096,153,4.7,"Lafayette County, FL"
30,2015,Jul,3220,3070,150,4.7,"Lafayette County, FL"
31,2015,Aug,3224,3075,149,4.6,"Lafayette County, FL"
32,2015,Sep,3211,3064,147,4.6,"Lafayette County, FL"
33,2015,Oct,3172,3034,138,4.4,"Lafayette County, FL"
34,2015,Nov,3132,2994,138,4.4,"Lafayette County, FL"
35,2015,Dec,3101,2973,128,4.1,"Lafayette County, FL"
36,2016,Jan,2986,2848,138,4.6,"Lafayette County, FL"
37,2016,Feb,3011,2883,128,4.3,"Lafayette County, FL"
38,2016,Mar,3014,2879,135,4.5,"Lafayette County, FL"
39,2016,Apr,2981,2855,126,4.2,"Lafayette County, FL"
40,2016,May,3016,2896,120,4.0,"Lafayette County, FL"
41,2016,Jun,2956,2816,140,4.7,"Lafayette County, FL"
42,2016,Jul,2930,2791,139,4.7,"Lafayette County, FL"
43,2016,Aug,3000,2864,136,4.5,"Lafayette County, FL"
44,2016,Sep,3011,2872,139,4.6,"Lafayette County, FL"
45,2016,Oct,2983,2852,131,4.4,"Lafayette County, FL"
46,2016,Nov,2929,2806,123,4.2,"Lafayette County, FL"
47,2016,Dec,2907,2789,118,4.1,"Lafayette County, FL"
48,2017,Jan,2905,2777,128,4.4,"Lafayette County, FL"
49,2017,Feb,2920,2804,116,4.0,"Lafayette County, FL"
50,2017,Mar,2938,2829,109,3.7,"Lafayette County, FL"
51,2017,Apr,2964,2860,104,3.5,"Lafayette County, FL"
52,2017,May,3001,2897,104,3.5,"Lafayette County, FL"
53,2017,Jun,2927,2805,122,4.2,"Lafayette County, FL"
54,2017,Jul,2833,2716,117,4.1,"Lafayette County, FL"
55,2017,Aug,2967,2852,115,3.9,"Lafayette County, FL"
56,2017,Sep,2974,2868,106,3.6,"Lafayette County, FL"
57,2017,Oct,2901,2792,109,3.8,"Lafayette County, FL"
58,2017,Nov,2864,2755,109,3.8,"Lafayette County, FL"
59,2017,Dec,2826,2731,95,3.4,"Lafayette County, FL"
60,2018,Jan,2842,2732,110,3.9,"Lafayette County, FL"
61,2018,Feb,2849,2747,102,3.6,"Lafayette County, FL"
62,2018,Mar,2847,2750,97,3.4,"Lafayette County, FL"
63,2018,Apr,2842,2747,95,3.3,"Lafayette County, FL"
64,2018,May,2857,2766,91,3.2,"Lafayette County, FL"
65,2018,Jun,2744,2633,111,4.0,"Lafayette County, FL"
66,2018,Jul,2703,2599,104,3.8,"Lafayette County, FL"
67,2018,Aug,2787,2687,100,3.6,"Lafayette County, FL"
68,2018,Sep,2862,2768,94,3.3,"Lafayette County, FL"
69,2018,Oct,2830,2737,93,3.3,"Lafayette County, FL"
70,2018,Nov,2802,2715,87,3.1,"Lafayette County, FL"
71,2018,Dec,2763,2674,89,3.2,"Lafayette County, FL"
72,2019,Jan,2875,2775,100,3.5,"Lafayette County, FL"
73,2019,Feb,2873,2789,84,2.9,"Lafayette County, FL"
74,2019,Mar,2876,2792,84,2.9,"Lafayette County, FL"
75,2019,Apr,2827,2752,75,2.7,"Lafayette County, FL"
76,2019,May,2855,2777,78,2.7,"Lafayette County, FL"
77,2019,Jun,2741,2646,95,3.5,"Lafayette County, FL"
78,2019,Jul,2742,2643,99,3.6,"Lafayette County, FL"
79,2019,Aug,2785,2695,90,3.2,"Lafayette County, FL"
80,2019,Sep,2874,2788,86,3.0,"Lafayette County, FL"
81,2019,Oct,2858,2777,81,2.8,"Lafayette County, FL"
82,2019,Nov,2855,2780,75,2.6,"Lafayette County, FL"
83,2019,Dec,2803,2735,68,2.4,"Lafayette County, FL"
84,2020,Jan,2853,2768,85,3.0,"Lafayette County, FL"
85,2020,Feb,2847,2778,69,2.4,"Lafayette County, FL"
86,2020,Mar,2799,2696,103,3.7,"Lafayette County, FL"
87,2020,Apr,2581,2482,99,3.8,"Lafayette County, FL"
88,2020,May,2718,2574,144,5.3,"Lafayette County, FL"
89,2020,Jun,2678,2542,136,5.1,"Lafayette County, FL"
90,2020,Jul,2707,2506,201,7.4,"Lafayette County, FL"
91,2020,Aug,2837,2699,138,4.9,"Lafayette County, FL"
92,2020,Sep,2868,2724,144,5.0,"Lafayette County, FL"
93,2020,Oct,2848,2714,134,4.7,"Lafayette County, FL"
94,2020,Nov,2785,2658,127,4.6,"Lafayette County, FL"
95,2020,Dec,2776,2648,128,4.6,"Lafayette County, FL"
96,2021,Jan,2770,2637,133,4.8,"Lafayette County, FL"
97,2021,Feb,2800,2675,125,4.5,"Lafayette County, FL"
98,2021,Mar,2831,2716,115,4.1,"Lafayette County, FL"
99,2021,Apr,2801,2699,102,3.6,"Lafayette County, FL"
100,2021,May,2833,2723,110,3.9,"Lafayette County, FL"
101,2021,Jun,2805,2678,127,4.5,"Lafayette County, FL"
102,2021,Jul,2822,2686,136,4.8,"Lafayette County, FL"
103,2021,Aug,2835,2712,123,4.3,"Lafayette County, FL"
104,2021,Sep,2820,2714,106,3.8,"Lafayette County, FL"
105,2021,Oct,2827,2728,99,3.5,"Lafayette County, FL"
106,2021,Nov,2795,2696,99,3.5,"Lafayette County, FL"
107,2021,Dec,2789,2706,83,3.0,"Lafayette County, FL"
108,2022,Jan,2769,2661,108,3.9,"Lafayette County, FL"
109,2022,Feb,2784,2683,101,3.6,"Lafayette County, FL"
110,2022,Mar,2824,2732,92,3.3,"Lafayette County, FL"
111,2022,Apr,2791,2708,83,3.0,"Lafayette County, FL"
112,2022,May,2826,2741,85,3.0,"Lafayette County, FL"
113,2022,Jun,2795,2705,90,3.2,"Lafayette County, FL"
114,2022,Jul,2806,2710,96,3.4,"Lafayette County, FL"
115,2022,Aug,2831,2741,90,3.2,"Lafayette County, FL"
116,2022,Sep,2837,2759,78,2.7,"Lafayette County, FL"
117,2022,Oct,2833,2755,78,2.8,"Lafayette County, FL"
118,2022,Nov,2804,2727,77,2.7,"Lafayette County, FL"
119,2022,Dec,2773,2711,62,2.2,"Lafayette County, FL"
120,2023,Jan,2813,2739,74,2.6,"Lafayette County, FL"
121,2023,Feb,2831,2753,78,2.8,"Lafayette County, FL"
122,2023,Mar,2867,2788,79,2.8,"Lafayette County, FL"
123,2023,Apr,2867,2798,69,2.4,"Lafayette County, FL"
124,2023,May,2886,2804,82,2.8,"Lafayette County, FL"
125,2023,Jun,2880,2787,93,3.2,"Lafayette County, FL"
126,2023,Jul,2882,2782,100,3.5,"Lafayette County, FL"
127,2023,Aug,2943,2837,106,3.6,"Lafayette County, FL"
128,2023,Sep,2967,2854,113,3.8,"Lafayette County, FL"
129,2023,Oct,2974,2862,112,3.8,"Lafayette County, FL"
0,2013,Jan,959870,882522,77348,8.1,"Broward County, FL"
1,2013,Feb,957377,885870,71507,7.5,"Broward County, FL"
2,2013,Mar,957618,889428,68190,7.1,"Broward County, FL"
3,2013,Apr,959619,893422,66197,6.9,"Broward County, FL"
4,2013,May,974222,905741,68481,7.0,"Broward County, FL"
5,2013,Jun,980776,907846,72930,7.4,"Broward County, FL"
6,2013,Jul,981828,910052,71776,7.3,"Broward County, FL"
7,2013,Aug,979558,909396,70162,7.2,"Broward County, FL"
8,2013,Sep,984899,917201,67698,6.9,"Broward County, FL"
9,2013,Oct,976762,910622,66140,6.8,"Broward County, FL"
10,2013,Nov,973690,910317,63373,6.5,"Broward County, FL"
11,2013,Dec,974582,914460,60122,6.2,"Broward County, FL"
12,2014,Jan,972523,908714,63809,6.6,"Broward County, FL"
13,2014,Feb,975543,912930,62613,6.4,"Broward County, FL"
14,2014,Mar,980408,918249,62159,6.3,"Broward County, FL"
15,2014,Apr,974359,916986,57373,5.9,"Broward County, FL"
16,2014,May,986266,925949,60317,6.1,"Broward County, FL"
17,2014,Jun,990306,928082,62224,6.3,"Broward County, FL"
18,2014,Jul,991262,926671,64591,6.5,"Broward County, FL"
19,2014,Aug,990404,926999,63405,6.4,"Broward County, FL"
20,2014,Sep,996014,936803,59211,5.9,"Broward County, FL"
21,2014,Oct,994635,937612,57023,5.7,"Broward County, FL"
22,2014,Nov,988893,932379,56514,5.7,"Broward County, FL"
23,2014,Dec,987068,934407,52661,5.3,"Broward County, FL"
24,2015,Jan,985474,928834,56640,5.7,"Broward County, FL"
25,2015,Feb,979577,926931,52646,5.4,"Broward County, FL"
26,2015,Mar,980235,929647,50588,5.2,"Broward County, FL"
27,2015,Apr,980139,930928,49211,5.0,"Broward County, FL"
28,2015,May,994479,942087,52392,5.3,"Broward County, FL"
29,2015,Jun,997325,943578,53747,5.4,"Broward County, FL"
30,2015,Jul,997302,942838,54464,5.5,"Broward County, FL"
31,2015,Aug,996908,944336,52572,5.3,"Broward County, FL"
32,2015,Sep,998720,948689,50031,5.0,"Broward County, FL"
33,2015,Oct,1000095,950721,49374,4.9,"Broward County, FL"
34,2015,Nov,995914,947392,48522,4.9,"Broward County, FL"
35,2015,Dec,998228,952036,46192,4.6,"Broward County, FL"
36,2016,Jan,995113,947288,47825,4.8,"Broward County, FL"
37,2016,Feb,998057,953349,44708,4.5,"Broward County, FL"
38,2016,Mar,999721,955358,44363,4.4,"Broward County, FL"
39,2016,Apr,997596,954306,43290,4.3,"Broward County, FL"
40,2016,May,1006324,963304,43020,4.3,"Broward County, FL"
41,2016,Jun,1011784,964008,47776,4.7,"Broward County, FL"
42,2016,Jul,1013383,964703,48680,4.8,"Broward County, FL"
43,2016,Aug,1013141,964449,48692,4.8,"Broward County, FL"
44,2016,Sep,1018251,970610,47641,4.7,"Broward County, FL"
45,2016,Oct,1015724,969641,46083,4.5,"Broward County, FL"
46,2016,Nov,1009147,964824,44323,4.4,"Broward County, FL"
47,2016,Dec,1008867,966162,42705,4.2,"Broward County, FL"
48,2017,Jan,1002559,956419,46140,4.6,"Broward County, FL"
49,2017,Feb,1006331,963534,42797,4.3,"Broward County, FL"
50,2017,Mar,1009026,968764,40262,4.0,"Broward County, FL"
51,2017,Apr,1008081,969838,38243,3.8,"Broward County, FL"
52,2017,May,1017355,977739,39616,3.9,"Broward County, FL"
53,2017,Jun,1023331,980782,42549,4.2,"Broward County, FL"
54,2017,Jul,1022699,979298,43401,4.2,"Broward County, FL"
55,2017,Aug,1018543,975274,43269,4.2,"Broward County, FL"
56,2017,Sep,1017794,977845,39949,3.9,"Broward County, FL"
57,2017,Oct,1016945,977893,39052,3.8,"Broward County, FL"
58,2017,Nov,1013345,974491,38854,3.8,"Broward County, FL"
59,2017,Dec,1012152,975727,36425,3.6,"Broward County, FL"
60,2018,Jan,1012146,972758,39388,3.9,"Broward County, FL"
61,2018,Feb,1016238,979555,36683,3.6,"Broward County, FL"
62,2018,Mar,1017535,981946,35589,3.5,"Broward County, FL"
63,2018,Apr,1017442,984039,33403,3.3,"Broward County, FL"
64,2018,May,1026582,993084,33498,3.3,"Broward County, FL"
65,2018,Jun,1032065,993100,38965,3.8,"Broward County, FL"
66,2018,Jul,1034452,996465,37987,3.7,"Broward County, FL"
67,2018,Aug,1028072,991237,36835,3.6,"Broward County, FL"
68,2018,Sep,1035029,1001127,33902,3.3,"Broward County, FL"
69,2018,Oct,1035873,1001915,33958,3.3,"Broward County, FL"
70,2018,Nov,1027273,994915,32358,3.1,"Broward County, FL"
71,2018,Dec,1025251,992993,32258,3.1,"Broward County, FL"
72,2019,Jan,1020377,982752,37625,3.7,"Broward County, FL"
73,2019,Feb,1021082,988264,32818,3.2,"Broward County, FL"
74,2019,Mar,1020483,988935,31548,3.1,"Broward County, FL"
75,2019,Apr,1020076,991570,28506,2.8,"Broward County, FL"
76,2019,May,1031377,1000842,30535,3.0,"Broward County, FL"
77,2019,Jun,1038068,1003519,34549,3.3,"Broward County, FL"
78,2019,Jul,1040661,1005256,35405,3.4,"Broward County, FL"
79,2019,Aug,1042119,1007371,34748,3.3,"Broward County, FL"
80,2019,Sep,1046873,1015324,31549,3.0,"Broward County, FL"
81,2019,Oct,1048875,1017407,31468,3.0,"Broward County, FL"
82,2019,Nov,1044930,1015037,29893,2.9,"Broward County, FL"
83,2019,Dec,1044972,1017427,27545,2.6,"Broward County, FL"
84,2020,Jan,1041217,1009785,31432,3.0,"Broward County, FL"
85,2020,Feb,1043644,1014391,29253,2.8,"Broward County, FL"
86,2020,Mar,1025492,977136,48356,4.7,"Broward County, FL"
87,2020,Apr,948418,806816,141602,14.9,"Broward County, FL"
88,2020,May,1025800,851554,174246,17.0,"Broward County, FL"
89,2020,Jun,1033497,888080,145417,14.1,"Broward County, FL"
90,2020,Jul,1051116,897270,153846,14.6,"Broward County, FL"
91,2020,Aug,1024261,915756,108505,10.6,"Broward County, FL"
92,2020,Sep,1023291,926644,96647,9.4,"Broward County, FL"
93,2020,Oct,1023879,944909,78970,7.7,"Broward County, FL"
94,2020,Nov,1011135,940155,70980,7.0,"Broward County, FL"
95,2020,Dec,1009705,943294,66411,6.6,"Broward County, FL"
96,2021,Jan,1012294,946588,65706,6.5,"Broward County, FL"
97,2021,Feb,1015198,955932,59266,5.8,"Broward County, FL"
98,2021,Mar,1016621,961148,55473,5.5,"Broward County, FL"
99,2021,Apr,1021290,968014,53276,5.2,"Broward County, FL"
100,2021,May,1028801,977072,51729,5.0,"Broward County, FL"
101,2021,Jun,1035577,978669,56908,5.5,"Broward County, FL"
102,2021,Jul,1040471,987537,52934,5.1,"Broward County, FL"
103,2021,Aug,1041030,990318,50712,4.9,"Broward County, FL"
104,2021,Sep,1044647,998816,45831,4.4,"Broward County, FL"
105,2021,Oct,1048092,1005118,42974,4.1,"Broward County, FL"
106,2021,Nov,1045365,1005613,39752,3.8,"Broward County, FL"
107,2021,Dec,1042947,1008687,34260,3.3,"Broward County, FL"
108,2022,Jan,1051021,1010575,40446,3.8,"Broward County, FL"
109,2022,Feb,1053487,1018569,34918,3.3,"Broward County, FL"
110,2022,Mar,1056976,1025579,31397,3.0,"Broward County, FL"
111,2022,Apr,1055128,1026365,28763,2.7,"Broward County, FL"
112,2022,May,1065995,1037185,28810,2.7,"Broward County, FL"
113,2022,Jun,1068831,1036394,32437,3.0,"Broward County, FL"
114,2022,Jul,1069190,1038241,30949,2.9,"Broward County, FL"
115,2022,Aug,1073283,1041657,31626,2.9,"Broward County, FL"
116,2022,Sep,1078321,1050101,28220,2.6,"Broward County, FL"
117,2022,Oct,1078465,1050351,28114,2.6,"Broward County, FL"
118,2022,Nov,1065099,1038374,26725,2.5,"Broward County, FL"
119,2022,Dec,1064280,1040981,23299,2.2,"Broward County, FL"
120,2023,Jan,1064855,1038366,26489,2.5,"Broward County, FL"
121,2023,Feb,1070001,1043194,26807,2.5,"Broward County, FL"
122,2023,Mar,1080560,1053197,27363,2.5,"Broward County, FL"
123,2023,Apr,1082552,1057893,24659,2.3,"Broward County, FL"
124,2023,May,1086472,1057804,28668,2.6,"Broward County, FL"
125,2023,Jun,1097004,1064886,32118,2.9,"Broward County, FL"
126,2023,Jul,1103343,1069766,33577,3.0,"Broward County, FL"
127,2023,Aug,1111502,1076957,34545,3.1,"Broward County, FL"
128,2023,Sep,1117523,1083782,33741,3.0,"Broward County, FL"
129,2023,Oct,1121695,1087798,33897,3.0,"Broward County, FL"
0,2013,Jan,89207,80245,8962,10.0,"El Dorado County, CA"
1,2013,Feb,89016,80537,8479,9.5,"El Dorado County, CA"
2,2013,Mar,88711,80520,8191,9.2,"El Dorado County, CA"
3,2013,Apr,87985,80445,7540,8.6,"El Dorado County, CA"
4,2013,May,88272,80796,7476,8.5,"El Dorado County, CA"
5,2013,Jun,88486,80637,7849,8.9,"El Dorado County, CA"
6,2013,Jul,88589,80799,7790,8.8,"El Dorado County, CA"
7,2013,Aug,87930,80603,7327,8.3,"El Dorado County, CA"
8,2013,Sep,88188,81185,7003,7.9,"El Dorado County, CA"
9,2013,Oct,87537,80440,7097,8.1,"El Dorado County, CA"
10,2013,Nov,87972,81044,6928,7.9,"El Dorado County, CA"
11,2013,Dec,87479,80872,6607,7.6,"El Dorado County, CA"
12,2014,Jan,87493,80411,7082,8.1,"El Dorado County, CA"
13,2014,Feb,87866,80729,7137,8.1,"El Dorado County, CA"
14,2014,Mar,88116,80999,7117,8.1,"El Dorado County, CA"
15,2014,Apr,86870,80782,6088,7.0,"El Dorado County, CA"
16,2014,May,87473,81398,6075,6.9,"El Dorado County, CA"
17,2014,Jun,88039,81805,6234,7.1,"El Dorado County, CA"
18,2014,Jul,88091,81634,6457,7.3,"El Dorado County, CA"
19,2014,Aug,87605,81567,6038,6.9,"El Dorado County, CA"
20,2014,Sep,87683,82091,5592,6.4,"El Dorado County, CA"
21,2014,Oct,88004,82404,5600,6.4,"El Dorado County, CA"
22,2014,Nov,88143,82543,5600,6.4,"El Dorado County, CA"
23,2014,Dec,87383,82023,5360,6.1,"El Dorado County, CA"
24,2015,Jan,87822,81909,5913,6.7,"El Dorado County, CA"
25,2015,Feb,87680,82055,5625,6.4,"El Dorado County, CA"
26,2015,Mar,87911,82410,5501,6.3,"El Dorado County, CA"
27,2015,Apr,87552,82369,5183,5.9,"El Dorado County, CA"
28,2015,May,87958,82921,5037,5.7,"El Dorado County, CA"
29,2015,Jun,88001,82862,5139,5.8,"El Dorado County, CA"
30,2015,Jul,88283,83101,5182,5.9,"El Dorado County, CA"
31,2015,Aug,87791,83020,4771,5.4,"El Dorado County, CA"
32,2015,Sep,87483,83055,4428,5.1,"El Dorado County, CA"
33,2015,Oct,87889,83294,4595,5.2,"El Dorado County, CA"
34,2015,Nov,88159,83483,4676,5.3,"El Dorado County, CA"
35,2015,Dec,88177,83599,4578,5.2,"El Dorado County, CA"
36,2016,Jan,88504,83516,4988,5.6,"El Dorado County, CA"
37,2016,Feb,88962,84063,4899,5.5,"El Dorado County, CA"
38,2016,Mar,89228,84193,5035,5.6,"El Dorado County, CA"
39,2016,Apr,88218,83697,4521,5.1,"El Dorado County, CA"
40,2016,May,88474,84224,4250,4.8,"El Dorado County, CA"
41,2016,Jun,88784,84142,4642,5.2,"El Dorado County, CA"
42,2016,Jul,89388,84656,4732,5.3,"El Dorado County, CA"
43,2016,Aug,89084,84549,4535,5.1,"El Dorado County, CA"
44,2016,Sep,89010,84654,4356,4.9,"El Dorado County, CA"
45,2016,Oct,88845,84447,4398,5.0,"El Dorado County, CA"
46,2016,Nov,88790,84505,4285,4.8,"El Dorado County, CA"
47,2016,Dec,88607,84334,4273,4.8,"El Dorado County, CA"
48,2017,Jan,89484,84633,4851,5.4,"El Dorado County, CA"
49,2017,Feb,89774,85110,4664,5.2,"El Dorado County, CA"
50,2017,Mar,89821,85417,4404,4.9,"El Dorado County, CA"
51,2017,Apr,89153,85206,3947,4.4,"El Dorado County, CA"
52,2017,May,89259,85572,3687,4.1,"El Dorado County, CA"
53,2017,Jun,89593,85543,4050,4.5,"El Dorado County, CA"
54,2017,Jul,90223,86085,4138,4.6,"El Dorado County, CA"
55,2017,Aug,89694,85701,3993,4.5,"El Dorado County, CA"
56,2017,Sep,90098,86577,3521,3.9,"El Dorado County, CA"
57,2017,Oct,89927,86532,3395,3.8,"El Dorado County, CA"
58,2017,Nov,89805,86452,3353,3.7,"El Dorado County, CA"
59,2017,Dec,89715,86362,3353,3.7,"El Dorado County, CA"
60,2018,Jan,90156,86409,3747,4.2,"El Dorado County, CA"
61,2018,Feb,90928,87224,3704,4.1,"El Dorado County, CA"
62,2018,Mar,90937,87321,3616,4.0,"El Dorado County, CA"
63,2018,Apr,90197,87010,3187,3.5,"El Dorado County, CA"
64,2018,May,90578,87710,2868,3.2,"El Dorado County, CA"
65,2018,Jun,90785,87349,3436,3.8,"El Dorado County, CA"
66,2018,Jul,91635,88302,3333,3.6,"El Dorado County, CA"
67,2018,Aug,90999,87729,3270,3.6,"El Dorado County, CA"
68,2018,Sep,91317,88341,2976,3.3,"El Dorado County, CA"
69,2018,Oct,91578,88465,3113,3.4,"El Dorado County, CA"
70,2018,Nov,91656,88495,3161,3.4,"El Dorado County, CA"
71,2018,Dec,91622,88302,3320,3.6,"El Dorado County, CA"
72,2019,Jan,92495,88424,4071,4.4,"El Dorado County, CA"
73,2019,Feb,92961,89141,3820,4.1,"El Dorado County, CA"
74,2019,Mar,92884,89096,3788,4.1,"El Dorado County, CA"
75,2019,Apr,91349,88253,3096,3.4,"El Dorado County, CA"
76,2019,May,91499,88657,2842,3.1,"El Dorado County, CA"
77,2019,Jun,91555,88261,3294,3.6,"El Dorado County, CA"
78,2019,Jul,92693,89269,3424,3.7,"El Dorado County, CA"
79,2019,Aug,92439,89160,3279,3.5,"El Dorado County, CA"
80,2019,Sep,92495,89724,2771,3.0,"El Dorado County, CA"
81,2019,Oct,92754,89825,2929,3.2,"El Dorado County, CA"
82,2019,Nov,92579,89580,2999,3.2,"El Dorado County, CA"
83,2019,Dec,92315,89345,2970,3.2,"El Dorado County, CA"
84,2020,Jan,92403,88873,3530,3.8,"El Dorado County, CA"
85,2020,Feb,93111,89735,3376,3.6,"El Dorado County, CA"
86,2020,Mar,92362,87485,4877,5.3,"El Dorado County, CA"
87,2020,Apr,91375,76908,14467,15.8,"El Dorado County, CA"
88,2020,May,90165,76422,13743,15.2,"El Dorado County, CA"
89,2020,Jun,91767,80842,10925,11.9,"El Dorado County, CA"
90,2020,Jul,91043,81934,9109,10.0,"El Dorado County, CA"
91,2020,Aug,90102,82824,7278,8.1,"El Dorado County, CA"
92,2020,Sep,90196,83330,6866,7.6,"El Dorado County, CA"
93,2020,Oct,90318,84266,6052,6.7,"El Dorado County, CA"
94,2020,Nov,89920,83928,5992,6.7,"El Dorado County, CA"
95,2020,Dec,89997,83716,6281,7.0,"El Dorado County, CA"
96,2021,Jan,90937,84287,6650,7.3,"El Dorado County, CA"
97,2021,Feb,91442,84960,6482,7.1,"El Dorado County, CA"
98,2021,Mar,91750,85521,6229,6.8,"El Dorado County, CA"
99,2021,Apr,90943,85138,5805,6.4,"El Dorado County, CA"
100,2021,May,90984,85698,5286,5.8,"El Dorado County, CA"
101,2021,Jun,91573,85727,5846,6.4,"El Dorado County, CA"
102,2021,Jul,92667,87174,5493,5.9,"El Dorado County, CA"
103,2021,Aug,92328,87115,5213,5.6,"El Dorado County, CA"
104,2021,Sep,92486,87849,4637,5.0,"El Dorado County, CA"
105,2021,Oct,92513,88114,4399,4.8,"El Dorado County, CA"
106,2021,Nov,92597,88523,4074,4.4,"El Dorado County, CA"
107,2021,Dec,92320,88524,3796,4.1,"El Dorado County, CA"
108,2022,Jan,92644,88285,4359,4.7,"El Dorado County, CA"
109,2022,Feb,93229,89365,3864,4.1,"El Dorado County, CA"
110,2022,Mar,93704,90260,3444,3.7,"El Dorado County, CA"
111,2022,Apr,92439,89544,2895,3.1,"El Dorado County, CA"
112,2022,May,92875,90249,2626,2.8,"El Dorado County, CA"
113,2022,Jun,92677,89643,3034,3.3,"El Dorado County, CA"
114,2022,Jul,93581,90632,2949,3.2,"El Dorado County, CA"
115,2022,Aug,93915,90882,3033,3.2,"El Dorado County, CA"
116,2022,Sep,93883,91163,2720,2.9,"El Dorado County, CA"
117,2022,Oct,94086,91179,2907,3.1,"El Dorado County, CA"
118,2022,Nov,93870,90790,3080,3.3,"El Dorado County, CA"
119,2022,Dec,93681,90775,2906,3.1,"El Dorado County, CA"
120,2023,Jan,93532,89862,3670,3.9,"El Dorado County, CA"
121,2023,Feb,94531,90697,3834,4.1,"El Dorado County, CA"
122,2023,Mar,94805,90879,3926,4.1,"El Dorado County, CA"
123,2023,Apr,93872,90513,3359,3.6,"El Dorado County, CA"
124,2023,May,93774,90348,3426,3.7,"El Dorado County, CA"
125,2023,Jun,93396,89703,3693,4.0,"El Dorado County, CA"
126,2023,Jul,94227,90630,3597,3.8,"El Dorado County, CA"
127,2023,Aug,93638,89774,3864,4.1,"El Dorado County, CA"
128,2023,Sep,94526,90840,3686,3.9,"El Dorado County, CA"
129,2023,Oct,94512,90728,3784,4.0,"El Dorado County, CA"
0,2013,Jan,132240,119010,13230,10.0,"Marion County, FL"
1,2013,Feb,129112,116992,12120,9.4,"Marion County, FL"
2,2013,Mar,128886,117304,11582,9.0,"Marion County, FL"
3,2013,Apr,130416,119328,11088,8.5,"Marion County, FL"
4,2013,May,131896,120320,11576,8.8,"Marion County, FL"
5,2013,Jun,131935,119729,12206,9.3,"Marion County, FL"
6,2013,Jul,132303,120156,12147,9.2,"Marion County, FL"
7,2013,Aug,131724,119922,11802,9.0,"Marion County, FL"
8,2013,Sep,131797,120372,11425,8.7,"Marion County, FL"
9,2013,Oct,130578,119282,11296,8.7,"Marion County, FL"
10,2013,Nov,129634,118762,10872,8.4,"Marion County, FL"
11,2013,Dec,128874,118514,10360,8.0,"Marion County, FL"
12,2014,Jan,129192,118391,10801,8.4,"Marion County, FL"
13,2014,Feb,130042,119577,10465,8.0,"Marion County, FL"
14,2014,Mar,130576,120296,10280,7.9,"Marion County, FL"
15,2014,Apr,131128,121891,9237,7.0,"Marion County, FL"
16,2014,May,132331,122493,9838,7.4,"Marion County, FL"
17,2014,Jun,131616,121675,9941,7.6,"Marion County, FL"
18,2014,Jul,132721,122306,10415,7.8,"Marion County, FL"
19,2014,Aug,132522,122247,10275,7.8,"Marion County, FL"
20,2014,Sep,132906,123303,9603,7.2,"Marion County, FL"
21,2014,Oct,132659,123307,9352,7.0,"Marion County, FL"
22,2014,Nov,131132,121773,9359,7.1,"Marion County, FL"
23,2014,Dec,130485,121691,8794,6.7,"Marion County, FL"
24,2015,Jan,130310,120766,9544,7.3,"Marion County, FL"
25,2015,Feb,129630,120742,8888,6.9,"Marion County, FL"
26,2015,Mar,130232,121710,8522,6.5,"Marion County, FL"
27,2015,Apr,130188,121982,8206,6.3,"Marion County, FL"
28,2015,May,131404,122620,8784,6.7,"Marion County, FL"
29,2015,Jun,131043,122125,8918,6.8,"Marion County, FL"
30,2015,Jul,131595,122519,9076,6.9,"Marion County, FL"
31,2015,Aug,131233,122537,8696,6.6,"Marion County, FL"
32,2015,Sep,131023,122798,8225,6.3,"Marion County, FL"
33,2015,Oct,131264,123117,8147,6.2,"Marion County, FL"
34,2015,Nov,130360,122309,8051,6.2,"Marion County, FL"
35,2015,Dec,130096,122349,7747,6.0,"Marion County, FL"
36,2016,Jan,130054,121875,8179,6.3,"Marion County, FL"
37,2016,Feb,130438,122797,7641,5.9,"Marion County, FL"
38,2016,Mar,130982,123435,7547,5.8,"Marion County, FL"
39,2016,Apr,132016,124740,7276,5.5,"Marion County, FL"
40,2016,May,132814,125545,7269,5.5,"Marion County, FL"
41,2016,Jun,133234,125163,8071,6.1,"Marion County, FL"
42,2016,Jul,133602,125278,8324,6.2,"Marion County, FL"
43,2016,Aug,133424,125191,8233,6.2,"Marion County, FL"
44,2016,Sep,133909,125833,8076,6.0,"Marion County, FL"
45,2016,Oct,133738,125895,7843,5.9,"Marion County, FL"
46,2016,Nov,132713,125166,7547,5.7,"Marion County, FL"
47,2016,Dec,132668,125355,7313,5.5,"Marion County, FL"
48,2017,Jan,131501,123559,7942,6.0,"Marion County, FL"
49,2017,Feb,131381,124090,7291,5.5,"Marion County, FL"
50,2017,Mar,132135,125322,6813,5.2,"Marion County, FL"
51,2017,Apr,132881,126491,6390,4.8,"Marion County, FL"
52,2017,May,132973,126435,6538,4.9,"Marion County, FL"
53,2017,Jun,133718,126721,6997,5.2,"Marion County, FL"
54,2017,Jul,133732,126572,7160,5.4,"Marion County, FL"
55,2017,Aug,132975,125819,7156,5.4,"Marion County, FL"
56,2017,Sep,133579,127035,6544,4.9,"Marion County, FL"
57,2017,Oct,133063,126748,6315,4.7,"Marion County, FL"
58,2017,Nov,132531,126138,6393,4.8,"Marion County, FL"
59,2017,Dec,132140,126053,6087,4.6,"Marion County, FL"
60,2018,Jan,133188,126517,6671,5.0,"Marion County, FL"
61,2018,Feb,133942,127738,6204,4.6,"Marion County, FL"
62,2018,Mar,133674,127724,5950,4.5,"Marion County, FL"
63,2018,Apr,134394,128784,5610,4.2,"Marion County, FL"
64,2018,May,134740,129151,5589,4.1,"Marion County, FL"
65,2018,Jun,135755,129179,6576,4.8,"Marion County, FL"
66,2018,Jul,135523,129134,6389,4.7,"Marion County, FL"
67,2018,Aug,134563,128357,6206,4.6,"Marion County, FL"
68,2018,Sep,135402,129733,5669,4.2,"Marion County, FL"
69,2018,Oct,136420,130725,5695,4.2,"Marion County, FL"
70,2018,Nov,135578,130087,5491,4.1,"Marion County, FL"
71,2018,Dec,135664,130227,5437,4.0,"Marion County, FL"
72,2019,Jan,136773,130397,6376,4.7,"Marion County, FL"
73,2019,Feb,136603,131050,5553,4.1,"Marion County, FL"
74,2019,Mar,136686,131290,5396,3.9,"Marion County, FL"
75,2019,Apr,136728,131870,4858,3.6,"Marion County, FL"
76,2019,May,137839,132719,5120,3.7,"Marion County, FL"
77,2019,Jun,138980,133082,5898,4.2,"Marion County, FL"
78,2019,Jul,139258,133339,5919,4.3,"Marion County, FL"
79,2019,Aug,138893,133013,5880,4.2,"Marion County, FL"
80,2019,Sep,139596,134381,5215,3.7,"Marion County, FL"
81,2019,Oct,140238,135123,5115,3.6,"Marion County, FL"
82,2019,Nov,139552,134570,4982,3.6,"Marion County, FL"
83,2019,Dec,139487,134860,4627,3.3,"Marion County, FL"
84,2020,Jan,139280,133826,5454,3.9,"Marion County, FL"
85,2020,Feb,139599,134896,4703,3.4,"Marion County, FL"
86,2020,Mar,137808,130884,6924,5.0,"Marion County, FL"
87,2020,Apr,129480,114735,14745,11.4,"Marion County, FL"
88,2020,May,137793,122136,15657,11.4,"Marion County, FL"
89,2020,Jun,138527,125107,13420,9.7,"Marion County, FL"
90,2020,Jul,141301,126126,15175,10.7,"Marion County, FL"
91,2020,Aug,140370,129370,11000,7.8,"Marion County, FL"
92,2020,Sep,141109,130668,10441,7.4,"Marion County, FL"
93,2020,Oct,141781,132587,9194,6.5,"Marion County, FL"
94,2020,Nov,141156,132338,8818,6.2,"Marion County, FL"
95,2020,Dec,141230,132752,8478,6.0,"Marion County, FL"
96,2021,Jan,140961,132458,8503,6.0,"Marion County, FL"
97,2021,Feb,141855,133927,7928,5.6,"Marion County, FL"
98,2021,Mar,141678,134120,7558,5.3,"Marion County, FL"
99,2021,Apr,141373,134268,7105,5.0,"Marion County, FL"
100,2021,May,142388,135438,6950,4.9,"Marion County, FL"
101,2021,Jun,143410,135344,8066,5.6,"Marion County, FL"
102,2021,Jul,144165,136577,7588,5.3,"Marion County, FL"
103,2021,Aug,143867,136427,7440,5.2,"Marion County, FL"
104,2021,Sep,144426,137696,6730,4.7,"Marion County, FL"
105,2021,Oct,144638,138254,6384,4.4,"Marion County, FL"
106,2021,Nov,144484,138467,6017,4.2,"Marion County, FL"
107,2021,Dec,144579,139327,5252,3.6,"Marion County, FL"
108,2022,Jan,146471,139974,6497,4.4,"Marion County, FL"
109,2022,Feb,146416,140819,5597,3.8,"Marion County, FL"
110,2022,Mar,146742,141658,5084,3.5,"Marion County, FL"
111,2022,Apr,146503,141928,4575,3.1,"Marion County, FL"
112,2022,May,148254,143431,4823,3.3,"Marion County, FL"
113,2022,Jun,148565,143012,5553,3.7,"Marion County, FL"
114,2022,Jul,148774,143473,5301,3.6,"Marion County, FL"
115,2022,Aug,149169,143772,5397,3.6,"Marion County, FL"
116,2022,Sep,149827,144929,4898,3.3,"Marion County, FL"
117,2022,Oct,149788,144996,4792,3.2,"Marion County, FL"
118,2022,Nov,149341,144665,4676,3.1,"Marion County, FL"
119,2022,Dec,149506,145399,4107,2.7,"Marion County, FL"
120,2023,Jan,149679,144940,4739,3.2,"Marion County, FL"
121,2023,Feb,150345,145619,4726,3.1,"Marion County, FL"
122,2023,Mar,151637,146829,4808,3.2,"Marion County, FL"
123,2023,Apr,151228,146926,4302,2.8,"Marion County, FL"
124,2023,May,152037,147003,5034,3.3,"Marion County, FL"
125,2023,Jun,152598,146928,5670,3.7,"Marion County, FL"
126,2023,Jul,153153,147272,5881,3.8,"Marion County, FL"
127,2023,Aug,153840,147771,6069,3.9,"Marion County, FL"
128,2023,Sep,154516,148527,5989,3.9,"Marion County, FL"
129,2023,Oct,154367,148462,5905,3.8,"Marion County, FL"
0,2013,Jan,81696,77317,4379,5.4,"Maui County, HI"
1,2013,Feb,79443,75277,4166,5.2,"Maui County, HI"
2,2013,Mar,79577,75613,3964,5.0,"Maui County, HI"
3,2013,Apr,80509,76725,3784,4.7,"Maui County, HI"
4,2013,May,79888,76125,3763,4.7,"Maui County, HI"
5,2013,Jun,81266,76796,4470,5.5,"Maui County, HI"
6,2013,Jul,81582,77599,3983,4.9,"Maui County, HI"
7,2013,Aug,81728,77817,3911,4.8,"Maui County, HI"
8,2013,Sep,80923,76740,4183,5.2,"Maui County, HI"
9,2013,Oct,80278,76171,4107,5.1,"Maui County, HI"
10,2013,Nov,80776,76811,3965,4.9,"Maui County, HI"
11,2013,Dec,81136,77455,3681,4.5,"Maui County, HI"
12,2014,Jan,82593,78593,4000,4.8,"Maui County, HI"
13,2014,Feb,82116,78118,3998,4.9,"Maui County, HI"
14,2014,Mar,82925,79056,3869,4.7,"Maui County, HI"
15,2014,Apr,83025,79411,3614,4.4,"Maui County, HI"
16,2014,May,82629,79069,3560,4.3,"Maui County, HI"
17,2014,Jun,83693,79604,4089,4.9,"Maui County, HI"
18,2014,Jul,84453,80703,3750,4.4,"Maui County, HI"
19,2014,Aug,84260,80707,3553,4.2,"Maui County, HI"
20,2014,Sep,83212,79772,3440,4.1,"Maui County, HI"
21,2014,Oct,82928,79708,3220,3.9,"Maui County, HI"
22,2014,Nov,83336,80051,3285,3.9,"Maui County, HI"
23,2014,Dec,83231,80256,2975,3.6,"Maui County, HI"
24,2015,Jan,84476,81034,3442,4.1,"Maui County, HI"
25,2015,Feb,83609,80363,3246,3.9,"Maui County, HI"
26,2015,Mar,84406,81250,3156,3.7,"Maui County, HI"
27,2015,Apr,84368,81344,3024,3.6,"Maui County, HI"
28,2015,May,84489,81561,2928,3.5,"Maui County, HI"
29,2015,Jun,85314,81925,3389,4.0,"Maui County, HI"
30,2015,Jul,85845,83044,2801,3.3,"Maui County, HI"
31,2015,Aug,85724,82938,2786,3.2,"Maui County, HI"
32,2015,Sep,85061,82094,2967,3.5,"Maui County, HI"
33,2015,Oct,84002,81274,2728,3.2,"Maui County, HI"
34,2015,Nov,84395,81679,2716,3.2,"Maui County, HI"
35,2015,Dec,85140,82641,2499,2.9,"Maui County, HI"
36,2016,Jan,86653,83942,2711,3.1,"Maui County, HI"
37,2016,Feb,86001,83346,2655,3.1,"Maui County, HI"
38,2016,Mar,86474,83840,2634,3.0,"Maui County, HI"
39,2016,Apr,86154,83619,2535,2.9,"Maui County, HI"
40,2016,May,85989,83536,2453,2.9,"Maui County, HI"
41,2016,Jun,87167,84110,3057,3.5,"Maui County, HI"
42,2016,Jul,87904,85180,2724,3.1,"Maui County, HI"
43,2016,Aug,87616,85096,2520,2.9,"Maui County, HI"
44,2016,Sep,86348,83674,2674,3.1,"Maui County, HI"
45,2016,Oct,86336,83835,2501,2.9,"Maui County, HI"
46,2016,Nov,86652,84344,2308,2.7,"Maui County, HI"
47,2016,Dec,86988,84879,2109,2.4,"Maui County, HI"
48,2017,Jan,90146,87418,2728,3.0,"Maui County, HI"
49,2017,Feb,89881,87425,2456,2.7,"Maui County, HI"
50,2017,Mar,90257,87957,2300,2.5,"Maui County, HI"
51,2017,Apr,90160,87822,2338,2.6,"Maui County, HI"
52,2017,May,89674,87542,2132,2.4,"Maui County, HI"
53,2017,Jun,90979,88369,2610,2.9,"Maui County, HI"
54,2017,Jul,90908,88798,2110,2.3,"Maui County, HI"
55,2017,Aug,90421,88524,1897,2.1,"Maui County, HI"
56,2017,Sep,88824,86987,1837,2.1,"Maui County, HI"
57,2017,Oct,88476,86842,1634,1.8,"Maui County, HI"
58,2017,Nov,88703,86966,1737,2.0,"Maui County, HI"
59,2017,Dec,88879,87404,1475,1.7,"Maui County, HI"
60,2018,Jan,89882,87972,1910,2.1,"Maui County, HI"
61,2018,Feb,89559,87699,1860,2.1,"Maui County, HI"
62,2018,Mar,90369,88536,1833,2.0,"Maui County, HI"
63,2018,Apr,90314,88441,1873,2.1,"Maui County, HI"
64,2018,May,90366,88516,1850,2.0,"Maui County, HI"
65,2018,Jun,91291,88644,2647,2.9,"Maui County, HI"
66,2018,Jul,92376,90209,2167,2.3,"Maui County, HI"
67,2018,Aug,91307,89193,2114,2.3,"Maui County, HI"
68,2018,Sep,89820,87489,2331,2.6,"Maui County, HI"
69,2018,Oct,89817,87424,2393,2.7,"Maui County, HI"
70,2018,Nov,89594,87314,2280,2.5,"Maui County, HI"
71,2018,Dec,89348,87206,2142,2.4,"Maui County, HI"
72,2019,Jan,90436,87831,2605,2.9,"Maui County, HI"
73,2019,Feb,89702,87337,2365,2.6,"Maui County, HI"
74,2019,Mar,89693,87400,2293,2.6,"Maui County, HI"
75,2019,Apr,89190,87088,2102,2.4,"Maui County, HI"
76,2019,May,88665,86667,1998,2.3,"Maui County, HI"
77,2019,Jun,89850,87262,2588,2.9,"Maui County, HI"
78,2019,Jul,90413,88195,2218,2.5,"Maui County, HI"
79,2019,Aug,90228,88140,2088,2.3,"Maui County, HI"
80,2019,Sep,89443,87277,2166,2.4,"Maui County, HI"
81,2019,Oct,89481,87345,2136,2.4,"Maui County, HI"
82,2019,Nov,89491,87480,2011,2.2,"Maui County, HI"
83,2019,Dec,89769,88036,1733,1.9,"Maui County, HI"
84,2020,Jan,90170,88112,2058,2.3,"Maui County, HI"
85,2020,Feb,89777,87983,1794,2.0,"Maui County, HI"
86,2020,Mar,89051,87185,1866,2.1,"Maui County, HI"
87,2020,Apr,86657,57736,28921,33.4,"Maui County, HI"
88,2020,May,86254,59333,26921,31.2,"Maui County, HI"
89,2020,Jun,86066,62296,23770,27.6,"Maui County, HI"
90,2020,Jul,85506,63546,21960,25.7,"Maui County, HI"
91,2020,Aug,83480,65223,18257,21.9,"Maui County, HI"
92,2020,Sep,76644,59797,16847,22.0,"Maui County, HI"
93,2020,Oct,80390,65790,14600,18.2,"Maui County, HI"
94,2020,Nov,83226,69759,13467,16.2,"Maui County, HI"
95,2020,Dec,84807,72962,11845,14.0,"Maui County, HI"
96,2021,Jan,86391,75380,11011,12.7,"Maui County, HI"
97,2021,Feb,86739,76157,10582,12.2,"Maui County, HI"
98,2021,Mar,87889,78169,9720,11.1,"Maui County, HI"
99,2021,Apr,88233,79324,8909,10.1,"Maui County, HI"
100,2021,May,87739,80127,7612,8.7,"Maui County, HI"
101,2021,Jun,88518,80621,7897,8.9,"Maui County, HI"
102,2021,Jul,88773,82662,6111,6.9,"Maui County, HI"
103,2021,Aug,88283,83190,5093,5.8,"Maui County, HI"
104,2021,Sep,86701,82510,4191,4.8,"Maui County, HI"
105,2021,Oct,85822,82425,3397,4.0,"Maui County, HI"
106,2021,Nov,86441,83351,3090,3.6,"Maui County, HI"
107,2021,Dec,86325,83643,2682,3.1,"Maui County, HI"
108,2022,Jan,86563,83432,3131,3.6,"Maui County, HI"
109,2022,Feb,86353,83364,2989,3.5,"Maui County, HI"
110,2022,Mar,87036,84176,2860,3.3,"Maui County, HI"
111,2022,Apr,86688,83896,2792,3.2,"Maui County, HI"
112,2022,May,86724,83942,2782,3.2,"Maui County, HI"
113,2022,Jun,87251,83855,3396,3.9,"Maui County, HI"
114,2022,Jul,87860,84871,2989,3.4,"Maui County, HI"
115,2022,Aug,88914,85870,3044,3.4,"Maui County, HI"
116,2022,Sep,87582,84522,3060,3.5,"Maui County, HI"
117,2022,Oct,87186,84003,3183,3.7,"Maui County, HI"
118,2022,Nov,87401,84155,3246,3.7,"Maui County, HI"
119,2022,Dec,87661,84759,2902,3.3,"Maui County, HI"
120,2023,Jan,88130,85416,2714,3.1,"Maui County, HI"
121,2023,Feb,87081,84302,2779,3.2,"Maui County, HI"
122,2023,Mar,87906,84913,2993,3.4,"Maui County, HI"
123,2023,Apr,87391,84926,2465,2.8,"Maui County, HI"
124,2023,May,86386,84230,2156,2.5,"Maui County, HI"
125,2023,Jun,87328,84610,2718,3.1,"Maui County, HI"
126,2023,Jul,87216,85040,2176,2.5,"Maui County, HI"
127,2023,Aug,88957,84925,4032,4.5,"Maui County, HI"
128,2023,Sep,87368,80151,7217,8.3,"Maui County, HI"
129,2023,Oct,86989,80850,6139,7.1,"Maui County, HI"
0,2013,Jan,43235,38946,4289,9.9,"Flagler County, FL"
1,2013,Feb,43274,39334,3940,9.1,"Flagler County, FL"
2,2013,Mar,43567,39831,3736,8.6,"Flagler County, FL"
3,2013,Apr,43579,39927,3652,8.4,"Flagler County, FL"
4,2013,May,44181,40362,3819,8.6,"Flagler County, FL"
5,2013,Jun,44319,40281,4038,9.1,"Flagler County, FL"
6,2013,Jul,44483,40470,4013,9.0,"Flagler County, FL"
7,2013,Aug,44357,40413,3944,8.9,"Flagler County, FL"
8,2013,Sep,44499,40696,3803,8.5,"Flagler County, FL"
9,2013,Oct,44364,40600,3764,8.5,"Flagler County, FL"
10,2013,Nov,43847,40261,3586,8.2,"Flagler County, FL"
11,2013,Dec,43471,40094,3377,7.8,"Flagler County, FL"
12,2014,Jan,42544,38946,3598,8.5,"Flagler County, FL"
13,2014,Feb,43136,39627,3509,8.1,"Flagler County, FL"
14,2014,Mar,43423,39978,3445,7.9,"Flagler County, FL"
15,2014,Apr,42962,39868,3094,7.2,"Flagler County, FL"
16,2014,May,43523,40262,3261,7.5,"Flagler County, FL"
17,2014,Jun,43401,40073,3328,7.7,"Flagler County, FL"
18,2014,Jul,43601,40147,3454,7.9,"Flagler County, FL"
19,2014,Aug,43390,40001,3389,7.8,"Flagler County, FL"
20,2014,Sep,43366,40261,3105,7.2,"Flagler County, FL"
21,2014,Oct,43257,40225,3032,7.0,"Flagler County, FL"
22,2014,Nov,42795,39766,3029,7.1,"Flagler County, FL"
23,2014,Dec,42570,39722,2848,6.7,"Flagler County, FL"
24,2015,Jan,43155,40066,3089,7.2,"Flagler County, FL"
25,2015,Feb,43460,40553,2907,6.7,"Flagler County, FL"
26,2015,Mar,43633,40846,2787,6.4,"Flagler County, FL"
27,2015,Apr,43597,40939,2658,6.1,"Flagler County, FL"
28,2015,May,44205,41356,2849,6.4,"Flagler County, FL"
29,2015,Jun,44035,41166,2869,6.5,"Flagler County, FL"
30,2015,Jul,44116,41206,2910,6.6,"Flagler County, FL"
31,2015,Aug,43977,41191,2786,6.3,"Flagler County, FL"
32,2015,Sep,44123,41485,2638,6.0,"Flagler County, FL"
33,2015,Oct,44215,41517,2698,6.1,"Flagler County, FL"
34,2015,Nov,43811,41174,2637,6.0,"Flagler County, FL"
35,2015,Dec,43816,41268,2548,5.8,"Flagler County, FL"
36,2016,Jan,44418,41738,2680,6.0,"Flagler County, FL"
37,2016,Feb,45111,42592,2519,5.6,"Flagler County, FL"
38,2016,Mar,45178,42712,2466,5.5,"Flagler County, FL"
39,2016,Apr,45214,42835,2379,5.3,"Flagler County, FL"
40,2016,May,45757,43391,2366,5.2,"Flagler County, FL"
41,2016,Jun,45720,43136,2584,5.7,"Flagler County, FL"
42,2016,Jul,46037,43390,2647,5.7,"Flagler County, FL"
43,2016,Aug,45857,43229,2628,5.7,"Flagler County, FL"
44,2016,Sep,46168,43584,2584,5.6,"Flagler County, FL"
45,2016,Oct,45680,43151,2529,5.5,"Flagler County, FL"
46,2016,Nov,45455,42942,2513,5.5,"Flagler County, FL"
47,2016,Dec,45304,42902,2402,5.3,"Flagler County, FL"
48,2017,Jan,45148,42572,2576,5.7,"Flagler County, FL"
49,2017,Feb,45548,43166,2382,5.2,"Flagler County, FL"
50,2017,Mar,45872,43645,2227,4.9,"Flagler County, FL"
51,2017,Apr,45873,43786,2087,4.5,"Flagler County, FL"
52,2017,May,46086,43925,2161,4.7,"Flagler County, FL"
53,2017,Jun,46120,43841,2279,4.9,"Flagler County, FL"
54,2017,Jul,46218,43855,2363,5.1,"Flagler County, FL"
55,2017,Aug,46005,43555,2450,5.3,"Flagler County, FL"
56,2017,Sep,46053,43890,2163,4.7,"Flagler County, FL"
57,2017,Oct,45704,43605,2099,4.6,"Flagler County, FL"
58,2017,Nov,45519,43414,2105,4.6,"Flagler County, FL"
59,2017,Dec,45437,43475,1962,4.3,"Flagler County, FL"
60,2018,Jan,45508,43343,2165,4.8,"Flagler County, FL"
61,2018,Feb,46119,44118,2001,4.3,"Flagler County, FL"
62,2018,Mar,46180,44242,1938,4.2,"Flagler County, FL"
63,2018,Apr,46074,44273,1801,3.9,"Flagler County, FL"
64,2018,May,46412,44577,1835,4.0,"Flagler County, FL"
65,2018,Jun,46699,44585,2114,4.5,"Flagler County, FL"
66,2018,Jul,46799,44772,2027,4.3,"Flagler County, FL"
67,2018,Aug,46505,44516,1989,4.3,"Flagler County, FL"
68,2018,Sep,46758,44892,1866,4.0,"Flagler County, FL"
69,2018,Oct,46717,44778,1939,4.2,"Flagler County, FL"
70,2018,Nov,46372,44497,1875,4.0,"Flagler County, FL"
71,2018,Dec,46159,44301,1858,4.0,"Flagler County, FL"
72,2019,Jan,46645,44487,2158,4.6,"Flagler County, FL"
73,2019,Feb,47157,45246,1911,4.1,"Flagler County, FL"
74,2019,Mar,47078,45239,1839,3.9,"Flagler County, FL"
75,2019,Apr,46970,45321,1649,3.5,"Flagler County, FL"
76,2019,May,47408,45632,1776,3.7,"Flagler County, FL"
77,2019,Jun,47667,45650,2017,4.2,"Flagler County, FL"
78,2019,Jul,47799,45777,2022,4.2,"Flagler County, FL"
79,2019,Aug,47822,45814,2008,4.2,"Flagler County, FL"
80,2019,Sep,47993,46199,1794,3.7,"Flagler County, FL"
81,2019,Oct,47862,46093,1769,3.7,"Flagler County, FL"
82,2019,Nov,47533,45795,1738,3.7,"Flagler County, FL"
83,2019,Dec,47412,45781,1631,3.4,"Flagler County, FL"
84,2020,Jan,48346,46471,1875,3.9,"Flagler County, FL"
85,2020,Feb,48538,46921,1617,3.3,"Flagler County, FL"
86,2020,Mar,47884,45560,2324,4.9,"Flagler County, FL"
87,2020,Apr,43855,37785,6070,13.8,"Flagler County, FL"
88,2020,May,46748,40181,6567,14.0,"Flagler County, FL"
89,2020,Jun,46487,41438,5049,10.9,"Flagler County, FL"
90,2020,Jul,47703,42384,5319,11.2,"Flagler County, FL"
91,2020,Aug,47366,43653,3713,7.8,"Flagler County, FL"
92,2020,Sep,47574,43978,3596,7.6,"Flagler County, FL"
93,2020,Oct,47473,44432,3041,6.4,"Flagler County, FL"
94,2020,Nov,46955,44122,2833,6.0,"Flagler County, FL"
95,2020,Dec,46797,44016,2781,5.9,"Flagler County, FL"
96,2021,Jan,47088,44311,2777,5.9,"Flagler County, FL"
97,2021,Feb,47486,44982,2504,5.3,"Flagler County, FL"
98,2021,Mar,47814,45368,2446,5.1,"Flagler County, FL"
99,2021,Apr,47991,45686,2305,4.8,"Flagler County, FL"
100,2021,May,48090,45893,2197,4.6,"Flagler County, FL"
101,2021,Jun,48625,46023,2602,5.4,"Flagler County, FL"
102,2021,Jul,48781,46349,2432,5.0,"Flagler County, FL"
103,2021,Aug,48987,46610,2377,4.9,"Flagler County, FL"
104,2021,Sep,49392,47269,2123,4.3,"Flagler County, FL"
105,2021,Oct,49504,47454,2050,4.1,"Flagler County, FL"
106,2021,Nov,49370,47399,1971,4.0,"Flagler County, FL"
107,2021,Dec,49170,47461,1709,3.5,"Flagler County, FL"
108,2022,Jan,49454,47337,2117,4.3,"Flagler County, FL"
109,2022,Feb,49823,47967,1856,3.7,"Flagler County, FL"
110,2022,Mar,50061,48379,1682,3.4,"Flagler County, FL"
111,2022,Apr,49799,48296,1503,3.0,"Flagler County, FL"
112,2022,May,50181,48618,1563,3.1,"Flagler County, FL"
113,2022,Jun,50587,48735,1852,3.7,"Flagler County, FL"
114,2022,Jul,50512,48771,1741,3.4,"Flagler County, FL"
115,2022,Aug,50931,49165,1766,3.5,"Flagler County, FL"
116,2022,Sep,51229,49608,1621,3.2,"Flagler County, FL"
117,2022,Oct,51161,49505,1656,3.2,"Flagler County, FL"
118,2022,Nov,50838,49216,1622,3.2,"Flagler County, FL"
119,2022,Dec,50984,49557,1427,2.8,"Flagler County, FL"
120,2023,Jan,51151,49503,1648,3.2,"Flagler County, FL"
121,2023,Feb,51617,49972,1645,3.2,"Flagler County, FL"
122,2023,Mar,52163,50505,1658,3.2,"Flagler County, FL"
123,2023,Apr,52070,50583,1487,2.9,"Flagler County, FL"
124,2023,May,52256,50523,1733,3.3,"Flagler County, FL"
125,2023,Jun,52889,50976,1913,3.6,"Flagler County, FL"
126,2023,Jul,53190,51213,1977,3.7,"Flagler County, FL"
127,2023,Aug,53584,51472,2112,3.9,"Flagler County, FL"
128,2023,Sep,53439,51315,2124,4.0,"Flagler County, FL"
129,2023,Oct,53150,51058,2092,3.9,"Flagler County, FL"
0,2013,Jan,5708,5261,447,7.8,"Glades County, FL"
1,2013,Feb,5542,5143,399,7.2,"Glades County, FL"
2,2013,Mar,5538,5155,383,6.9,"Glades County, FL"
3,2013,Apr,5552,5188,364,6.6,"Glades County, FL"
4,2013,May,5591,5178,413,7.4,"Glades County, FL"
5,2013,Jun,5519,5064,455,8.2,"Glades County, FL"
6,2013,Jul,5431,4948,483,8.9,"Glades County, FL"
7,2013,Aug,5327,4860,467,8.8,"Glades County, FL"
8,2013,Sep,5208,4769,439,8.4,"Glades County, FL"
9,2013,Oct,5284,4859,425,8.0,"Glades County, FL"
10,2013,Nov,5286,4876,410,7.8,"Glades County, FL"
11,2013,Dec,5467,5078,389,7.1,"Glades County, FL"
12,2014,Jan,4990,4589,401,8.0,"Glades County, FL"
13,2014,Feb,5007,4618,389,7.8,"Glades County, FL"
14,2014,Mar,4843,4464,379,7.8,"Glades County, FL"
15,2014,Apr,5039,4698,341,6.8,"Glades County, FL"
16,2014,May,5245,4855,390,7.4,"Glades County, FL"
17,2014,Jun,5003,4594,409,8.2,"Glades County, FL"
18,2014,Jul,5062,4619,443,8.8,"Glades County, FL"
19,2014,Aug,4807,4366,441,9.2,"Glades County, FL"
20,2014,Sep,4787,4389,398,8.3,"Glades County, FL"
21,2014,Oct,4802,4428,374,7.8,"Glades County, FL"
22,2014,Nov,4689,4328,361,7.7,"Glades County, FL"
23,2014,Dec,4702,4373,329,7.0,"Glades County, FL"
24,2015,Jan,4634,4285,349,7.5,"Glades County, FL"
25,2015,Feb,4636,4318,318,6.9,"Glades County, FL"
26,2015,Mar,4641,4338,303,6.5,"Glades County, FL"
27,2015,Apr,4765,4470,295,6.2,"Glades County, FL"
28,2015,May,4830,4485,345,7.1,"Glades County, FL"
29,2015,Jun,4829,4454,375,7.8,"Glades County, FL"
30,2015,Jul,4708,4305,403,8.6,"Glades County, FL"
31,2015,Aug,4797,4410,387,8.1,"Glades County, FL"
32,2015,Sep,4686,4331,355,7.6,"Glades County, FL"
33,2015,Oct,4708,4372,336,7.1,"Glades County, FL"
34,2015,Nov,4748,4424,324,6.8,"Glades County, FL"
35,2015,Dec,4767,4465,302,6.3,"Glades County, FL"
36,2016,Jan,4826,4519,307,6.4,"Glades County, FL"
37,2016,Feb,4852,4567,285,5.9,"Glades County, FL"
38,2016,Mar,4822,4547,275,5.7,"Glades County, FL"
39,2016,Apr,4744,4477,267,5.6,"Glades County, FL"
40,2016,May,4832,4574,258,5.3,"Glades County, FL"
41,2016,Jun,4673,4357,316,6.8,"Glades County, FL"
42,2016,Jul,4547,4210,337,7.4,"Glades County, FL"
43,2016,Aug,4658,4318,340,7.3,"Glades County, FL"
44,2016,Sep,4610,4282,328,7.1,"Glades County, FL"
45,2016,Oct,4751,4450,301,6.3,"Glades County, FL"
46,2016,Nov,4699,4412,287,6.1,"Glades County, FL"
47,2016,Dec,4790,4513,277,5.8,"Glades County, FL"
48,2017,Jan,5029,4721,308,6.1,"Glades County, FL"
49,2017,Feb,5008,4728,280,5.6,"Glades County, FL"
50,2017,Mar,5021,4766,255,5.1,"Glades County, FL"
51,2017,Apr,5124,4881,243,4.7,"Glades County, FL"
52,2017,May,5101,4860,241,4.7,"Glades County, FL"
53,2017,Jun,4757,4476,281,5.9,"Glades County, FL"
54,2017,Jul,4416,4118,298,6.7,"Glades County, FL"
55,2017,Aug,4773,4464,309,6.5,"Glades County, FL"
56,2017,Sep,4637,4364,273,5.9,"Glades County, FL"
57,2017,Oct,4980,4733,247,5.0,"Glades County, FL"
58,2017,Nov,4972,4728,244,4.9,"Glades County, FL"
59,2017,Dec,5145,4915,230,4.5,"Glades County, FL"
60,2018,Jan,5186,4956,230,4.4,"Glades County, FL"
61,2018,Feb,5301,5083,218,4.1,"Glades County, FL"
62,2018,Mar,5269,5064,205,3.9,"Glades County, FL"
63,2018,Apr,5293,5103,190,3.6,"Glades County, FL"
64,2018,May,5286,5099,187,3.5,"Glades County, FL"
65,2018,Jun,4884,4653,231,4.7,"Glades County, FL"
66,2018,Jul,4745,4497,248,5.2,"Glades County, FL"
67,2018,Aug,5037,4810,227,4.5,"Glades County, FL"
68,2018,Sep,5108,4897,211,4.1,"Glades County, FL"
69,2018,Oct,5431,5233,198,3.6,"Glades County, FL"
70,2018,Nov,5372,5186,186,3.5,"Glades County, FL"
71,2018,Dec,5415,5230,185,3.4,"Glades County, FL"
72,2019,Jan,5466,5244,222,4.1,"Glades County, FL"
73,2019,Feb,5562,5360,202,3.6,"Glades County, FL"
74,2019,Mar,5504,5301,203,3.7,"Glades County, FL"
75,2019,Apr,5467,5273,194,3.5,"Glades County, FL"
76,2019,May,5522,5318,204,3.7,"Glades County, FL"
77,2019,Jun,4883,4644,239,4.9,"Glades County, FL"
78,2019,Jul,4862,4609,253,5.2,"Glades County, FL"
79,2019,Aug,5166,4918,248,4.8,"Glades County, FL"
80,2019,Sep,5204,4984,220,4.2,"Glades County, FL"
81,2019,Oct,5386,5178,208,3.9,"Glades County, FL"
82,2019,Nov,5384,5184,200,3.7,"Glades County, FL"
83,2019,Dec,5388,5199,189,3.5,"Glades County, FL"
84,2020,Jan,5319,5107,212,4.0,"Glades County, FL"
85,2020,Feb,5315,5128,187,3.5,"Glades County, FL"
86,2020,Mar,5332,5072,260,4.9,"Glades County, FL"
87,2020,Apr,4893,4599,294,6.0,"Glades County, FL"
88,2020,May,5169,4766,403,7.8,"Glades County, FL"
89,2020,Jun,4772,4361,411,8.6,"Glades County, FL"
90,2020,Jul,4750,4259,491,10.3,"Glades County, FL"
91,2020,Aug,5048,4707,341,6.8,"Glades County, FL"
92,2020,Sep,5079,4766,313,6.2,"Glades County, FL"
93,2020,Oct,5166,4907,259,5.0,"Glades County, FL"
94,2020,Nov,5059,4798,261,5.2,"Glades County, FL"
95,2020,Dec,5043,4791,252,5.0,"Glades County, FL"
96,2021,Jan,4931,4667,264,5.4,"Glades County, FL"
97,2021,Feb,4949,4727,222,4.5,"Glades County, FL"
98,2021,Mar,5015,4791,224,4.5,"Glades County, FL"
99,2021,Apr,5000,4800,200,4.0,"Glades County, FL"
100,2021,May,4972,4773,199,4.0,"Glades County, FL"
101,2021,Jun,4910,4655,255,5.2,"Glades County, FL"
102,2021,Jul,4894,4642,252,5.1,"Glades County, FL"
103,2021,Aug,4910,4666,244,5.0,"Glades County, FL"
104,2021,Sep,4927,4725,202,4.1,"Glades County, FL"
105,2021,Oct,5038,4845,193,3.8,"Glades County, FL"
106,2021,Nov,5030,4853,177,3.5,"Glades County, FL"
107,2021,Dec,5028,4862,166,3.3,"Glades County, FL"
108,2022,Jan,5137,4935,202,3.9,"Glades County, FL"
109,2022,Feb,5161,4982,179,3.5,"Glades County, FL"
110,2022,Mar,5151,4992,159,3.1,"Glades County, FL"
111,2022,Apr,5144,5004,140,2.7,"Glades County, FL"
112,2022,May,5195,5042,153,2.9,"Glades County, FL"
113,2022,Jun,5151,4952,199,3.9,"Glades County, FL"
114,2022,Jul,5030,4845,185,3.7,"Glades County, FL"
115,2022,Aug,5112,4929,183,3.6,"Glades County, FL"
116,2022,Sep,5117,4957,160,3.1,"Glades County, FL"
117,2022,Oct,5267,5113,154,2.9,"Glades County, FL"
118,2022,Nov,5221,5069,152,2.9,"Glades County, FL"
119,2022,Dec,5237,5111,126,2.4,"Glades County, FL"
120,2023,Jan,5327,5167,160,3.0,"Glades County, FL"
121,2023,Feb,5376,5220,156,2.9,"Glades County, FL"
122,2023,Mar,5438,5271,167,3.1,"Glades County, FL"
123,2023,Apr,5431,5290,141,2.6,"Glades County, FL"
124,2023,May,5452,5283,169,3.1,"Glades County, FL"
125,2023,Jun,5275,5073,202,3.8,"Glades County, FL"
126,2023,Jul,5216,4990,226,4.3,"Glades County, FL"
127,2023,Aug,5420,5186,234,4.3,"Glades County, FL"
128,2023,Sep,5427,5211,216,4.0,"Glades County, FL"
129,2023,Oct,5651,5433,218,3.9,"Glades County, FL"
0,2013,Jan,13489,12286,1203,8.9,"DeSoto County, FL"
1,2013,Feb,13256,12157,1099,8.3,"DeSoto County, FL"
2,2013,Mar,13488,12446,1042,7.7,"DeSoto County, FL"
3,2013,Apr,13757,12750,1007,7.3,"DeSoto County, FL"
4,2013,May,13794,12761,1033,7.5,"DeSoto County, FL"
5,2013,Jun,13014,11839,1175,9.0,"DeSoto County, FL"
6,2013,Jul,12681,11449,1232,9.7,"DeSoto County, FL"
7,2013,Aug,12648,11425,1223,9.7,"DeSoto County, FL"
8,2013,Sep,12659,11432,1227,9.7,"DeSoto County, FL"
9,2013,Oct,12602,11421,1181,9.4,"DeSoto County, FL"
10,2013,Nov,12674,11594,1080,8.5,"DeSoto County, FL"
11,2013,Dec,13215,12251,964,7.3,"DeSoto County, FL"
12,2014,Jan,13424,12415,1009,7.5,"DeSoto County, FL"
13,2014,Feb,13227,12247,980,7.4,"DeSoto County, FL"
14,2014,Mar,13454,12479,975,7.2,"DeSoto County, FL"
15,2014,Apr,13622,12768,854,6.3,"DeSoto County, FL"
16,2014,May,13712,12814,898,6.5,"DeSoto County, FL"
17,2014,Jun,12839,11865,974,7.6,"DeSoto County, FL"
18,2014,Jul,12957,11895,1062,8.2,"DeSoto County, FL"
19,2014,Aug,13001,11926,1075,8.3,"DeSoto County, FL"
20,2014,Sep,12912,11906,1006,7.8,"DeSoto County, FL"
21,2014,Oct,12792,11802,990,7.7,"DeSoto County, FL"
22,2014,Nov,12767,11819,948,7.4,"DeSoto County, FL"
23,2014,Dec,13119,12285,834,6.4,"DeSoto County, FL"
24,2015,Jan,13869,12986,883,6.4,"DeSoto County, FL"
25,2015,Feb,13575,12773,802,5.9,"DeSoto County, FL"
26,2015,Mar,13611,12845,766,5.6,"DeSoto County, FL"
27,2015,Apr,13817,13100,717,5.2,"DeSoto County, FL"
28,2015,May,13899,13145,754,5.4,"DeSoto County, FL"
29,2015,Jun,13146,12363,783,6.0,"DeSoto County, FL"
30,2015,Jul,12561,11702,859,6.8,"DeSoto County, FL"
31,2015,Aug,13038,12185,853,6.5,"DeSoto County, FL"
32,2015,Sep,13089,12287,802,6.1,"DeSoto County, FL"
33,2015,Oct,13232,12457,775,5.9,"DeSoto County, FL"
34,2015,Nov,13372,12612,760,5.7,"DeSoto County, FL"
35,2015,Dec,13964,13259,705,5.0,"DeSoto County, FL"
36,2016,Jan,14136,13401,735,5.2,"DeSoto County, FL"
37,2016,Feb,13728,13059,669,4.9,"DeSoto County, FL"
38,2016,Mar,13949,13286,663,4.8,"DeSoto County, FL"
39,2016,Apr,14058,13419,639,4.5,"DeSoto County, FL"
40,2016,May,13995,13372,623,4.5,"DeSoto County, FL"
41,2016,Jun,12944,12212,732,5.7,"DeSoto County, FL"
42,2016,Jul,12886,12120,766,5.9,"DeSoto County, FL"
43,2016,Aug,13086,12298,788,6.0,"DeSoto County, FL"
44,2016,Sep,13196,12393,803,6.1,"DeSoto County, FL"
45,2016,Oct,13290,12525,765,5.8,"DeSoto County, FL"
46,2016,Nov,13255,12509,746,5.6,"DeSoto County, FL"
47,2016,Dec,13668,12972,696,5.1,"DeSoto County, FL"
48,2017,Jan,14188,13449,739,5.2,"DeSoto County, FL"
49,2017,Feb,14243,13581,662,4.6,"DeSoto County, FL"
50,2017,Mar,14286,13667,619,4.3,"DeSoto County, FL"
51,2017,Apr,14875,14312,563,3.8,"DeSoto County, FL"
52,2017,May,14889,14322,567,3.8,"DeSoto County, FL"
53,2017,Jun,13637,12991,646,4.7,"DeSoto County, FL"
54,2017,Jul,12959,12278,681,5.3,"DeSoto County, FL"
55,2017,Aug,13367,12679,688,5.1,"DeSoto County, FL"
56,2017,Sep,13308,12659,649,4.9,"DeSoto County, FL"
57,2017,Oct,13551,12938,613,4.5,"DeSoto County, FL"
58,2017,Nov,13572,12967,605,4.5,"DeSoto County, FL"
59,2017,Dec,14387,13831,556,3.9,"DeSoto County, FL"
60,2018,Jan,13952,13330,622,4.5,"DeSoto County, FL"
61,2018,Feb,13686,13115,571,4.2,"DeSoto County, FL"
62,2018,Mar,14138,13597,541,3.8,"DeSoto County, FL"
63,2018,Apr,13971,13476,495,3.5,"DeSoto County, FL"
64,2018,May,13921,13442,479,3.4,"DeSoto County, FL"
65,2018,Jun,13377,12786,591,4.4,"DeSoto County, FL"
66,2018,Jul,13165,12579,586,4.5,"DeSoto County, FL"
67,2018,Aug,13437,12857,580,4.3,"DeSoto County, FL"
68,2018,Sep,13314,12780,534,4.0,"DeSoto County, FL"
69,2018,Oct,13385,12849,536,4.0,"DeSoto County, FL"
70,2018,Nov,13273,12753,520,3.9,"DeSoto County, FL"
71,2018,Dec,13829,13285,544,3.9,"DeSoto County, FL"
72,2019,Jan,14368,13747,621,4.3,"DeSoto County, FL"
73,2019,Feb,14309,13779,530,3.7,"DeSoto County, FL"
74,2019,Mar,14450,13946,504,3.5,"DeSoto County, FL"
75,2019,Apr,14454,14008,446,3.1,"DeSoto County, FL"
76,2019,May,14431,13981,450,3.1,"DeSoto County, FL"
77,2019,Jun,13962,13419,543,3.9,"DeSoto County, FL"
78,2019,Jul,13581,13024,557,4.1,"DeSoto County, FL"
79,2019,Aug,13873,13330,543,3.9,"DeSoto County, FL"
80,2019,Sep,13900,13409,491,3.5,"DeSoto County, FL"
81,2019,Oct,13843,13339,504,3.6,"DeSoto County, FL"
82,2019,Nov,13808,13323,485,3.5,"DeSoto County, FL"
83,2019,Dec,14616,14160,456,3.1,"DeSoto County, FL"
84,2020,Jan,14930,14402,528,3.5,"DeSoto County, FL"
85,2020,Feb,14994,14541,453,3.0,"DeSoto County, FL"
86,2020,Mar,14830,14141,689,4.6,"DeSoto County, FL"
87,2020,Apr,13727,12830,897,6.5,"DeSoto County, FL"
88,2020,May,14455,13437,1018,7.0,"DeSoto County, FL"
89,2020,Jun,14007,13026,981,7.0,"DeSoto County, FL"
90,2020,Jul,13866,12720,1146,8.3,"DeSoto County, FL"
91,2020,Aug,14249,13431,818,5.7,"DeSoto County, FL"
92,2020,Sep,14536,13740,796,5.5,"DeSoto County, FL"
93,2020,Oct,14226,13538,688,4.8,"DeSoto County, FL"
94,2020,Nov,14251,13586,665,4.7,"DeSoto County, FL"
95,2020,Dec,14423,13756,667,4.6,"DeSoto County, FL"
96,2021,Jan,13409,12708,701,5.2,"DeSoto County, FL"
97,2021,Feb,13442,12790,652,4.9,"DeSoto County, FL"
98,2021,Mar,13783,13154,629,4.6,"DeSoto County, FL"
99,2021,Apr,13936,13377,559,4.0,"DeSoto County, FL"
100,2021,May,13875,13331,544,3.9,"DeSoto County, FL"
101,2021,Jun,13564,12913,651,4.8,"DeSoto County, FL"
102,2021,Jul,13394,12764,630,4.7,"DeSoto County, FL"
103,2021,Aug,13451,12852,599,4.5,"DeSoto County, FL"
104,2021,Sep,13711,13176,535,3.9,"DeSoto County, FL"
105,2021,Oct,13848,13326,522,3.8,"DeSoto County, FL"
106,2021,Nov,13519,13035,484,3.6,"DeSoto County, FL"
107,2021,Dec,13624,13208,416,3.1,"DeSoto County, FL"
108,2022,Jan,13755,13221,534,3.9,"DeSoto County, FL"
109,2022,Feb,13679,13209,470,3.4,"DeSoto County, FL"
110,2022,Mar,13735,13296,439,3.2,"DeSoto County, FL"
111,2022,Apr,13829,13439,390,2.8,"DeSoto County, FL"
112,2022,May,14259,13835,424,3.0,"DeSoto County, FL"
113,2022,Jun,14036,13544,492,3.5,"DeSoto County, FL"
114,2022,Jul,13601,13142,459,3.4,"DeSoto County, FL"
115,2022,Aug,13838,13368,470,3.4,"DeSoto County, FL"
116,2022,Sep,14041,13603,438,3.1,"DeSoto County, FL"
117,2022,Oct,13920,13429,491,3.5,"DeSoto County, FL"
118,2022,Nov,13752,13297,455,3.3,"DeSoto County, FL"
119,2022,Dec,13896,13515,381,2.7,"DeSoto County, FL"
120,2023,Jan,13920,13500,420,3.0,"DeSoto County, FL"
121,2023,Feb,13940,13516,424,3.0,"DeSoto County, FL"
122,2023,Mar,14048,13620,428,3.0,"DeSoto County, FL"
123,2023,Apr,14091,13724,367,2.6,"DeSoto County, FL"
124,2023,May,14582,14148,434,3.0,"DeSoto County, FL"
125,2023,Jun,14305,13819,486,3.4,"DeSoto County, FL"
126,2023,Jul,13937,13429,508,3.6,"DeSoto County, FL"
127,2023,Aug,14248,13733,515,3.6,"DeSoto County, FL"
128,2023,Sep,14569,14052,517,3.5,"DeSoto County, FL"
129,2023,Oct,14503,13980,523,3.6,"DeSoto County, FL"
0,2013,Jan,61841,55180,6661,10.8,"Indian River County, FL"
1,2013,Feb,61501,55371,6130,10.0,"Indian River County, FL"
2,2013,Mar,61216,55418,5798,9.5,"Indian River County, FL"
3,2013,Apr,61098,55439,5659,9.3,"Indian River County, FL"
4,2013,May,61752,55665,6087,9.9,"Indian River County, FL"
5,2013,Jun,61742,55111,6631,10.7,"Indian River County, FL"
6,2013,Jul,61445,54733,6712,10.9,"Indian River County, FL"
7,2013,Aug,61203,54480,6723,11.0,"Indian River County, FL"
8,2013,Sep,60914,54514,6400,10.5,"Indian River County, FL"
9,2013,Oct,61019,54845,6174,10.1,"Indian River County, FL"
10,2013,Nov,61460,55785,5675,9.2,"Indian River County, FL"
11,2013,Dec,61618,56317,5301,8.6,"Indian River County, FL"
12,2014,Jan,62013,56503,5510,8.9,"Indian River County, FL"
13,2014,Feb,62115,56842,5273,8.5,"Indian River County, FL"
14,2014,Mar,62430,57295,5135,8.2,"Indian River County, FL"
15,2014,Apr,61373,56721,4652,7.6,"Indian River County, FL"
16,2014,May,61599,56606,4993,8.1,"Indian River County, FL"
17,2014,Jun,61381,56111,5270,8.6,"Indian River County, FL"
18,2014,Jul,61526,55912,5614,9.1,"Indian River County, FL"
19,2014,Aug,61344,55792,5552,9.1,"Indian River County, FL"
20,2014,Sep,61193,56111,5082,8.3,"Indian River County, FL"
21,2014,Oct,61669,57143,4526,7.3,"Indian River County, FL"
22,2014,Nov,61798,57403,4395,7.1,"Indian River County, FL"
23,2014,Dec,61716,57674,4042,6.5,"Indian River County, FL"
24,2015,Jan,61783,57454,4329,7.0,"Indian River County, FL"
25,2015,Feb,61025,57042,3983,6.5,"Indian River County, FL"
26,2015,Mar,61213,57397,3816,6.2,"Indian River County, FL"
27,2015,Apr,60830,56993,3837,6.3,"Indian River County, FL"
28,2015,May,61640,57336,4304,7.0,"Indian River County, FL"
29,2015,Jun,61602,57049,4553,7.4,"Indian River County, FL"
30,2015,Jul,61318,56450,4868,7.9,"Indian River County, FL"
31,2015,Aug,61210,56485,4725,7.7,"Indian River County, FL"
32,2015,Sep,61026,56597,4429,7.3,"Indian River County, FL"
33,2015,Oct,61535,57275,4260,6.9,"Indian River County, FL"
34,2015,Nov,62112,58081,4031,6.5,"Indian River County, FL"
35,2015,Dec,62224,58389,3835,6.2,"Indian River County, FL"
36,2016,Jan,62293,58348,3945,6.3,"Indian River County, FL"
37,2016,Feb,62316,58656,3660,5.9,"Indian River County, FL"
38,2016,Mar,62491,58932,3559,5.7,"Indian River County, FL"
39,2016,Apr,62043,58595,3448,5.6,"Indian River County, FL"
40,2016,May,61996,58470,3526,5.7,"Indian River County, FL"
41,2016,Jun,62312,58385,3927,6.3,"Indian River County, FL"
42,2016,Jul,62181,58080,4101,6.6,"Indian River County, FL"
43,2016,Aug,62315,58096,4219,6.8,"Indian River County, FL"
44,2016,Sep,62475,58375,4100,6.6,"Indian River County, FL"
45,2016,Oct,62340,58459,3881,6.2,"Indian River County, FL"
46,2016,Nov,62920,59288,3632,5.8,"Indian River County, FL"
47,2016,Dec,63048,59562,3486,5.5,"Indian River County, FL"
48,2017,Jan,63660,60008,3652,5.7,"Indian River County, FL"
49,2017,Feb,63499,60174,3325,5.2,"Indian River County, FL"
50,2017,Mar,63637,60562,3075,4.8,"Indian River County, FL"
51,2017,Apr,63237,60329,2908,4.6,"Indian River County, FL"
52,2017,May,63385,60259,3126,4.9,"Indian River County, FL"
53,2017,Jun,63498,60139,3359,5.3,"Indian River County, FL"
54,2017,Jul,63147,59599,3548,5.6,"Indian River County, FL"
55,2017,Aug,63021,59390,3631,5.8,"Indian River County, FL"
56,2017,Sep,62693,59372,3321,5.3,"Indian River County, FL"
57,2017,Oct,63526,60428,3098,4.9,"Indian River County, FL"
58,2017,Nov,63932,60919,3013,4.7,"Indian River County, FL"
59,2017,Dec,64223,61350,2873,4.5,"Indian River County, FL"
60,2018,Jan,64088,61019,3069,4.8,"Indian River County, FL"
61,2018,Feb,64510,61642,2868,4.4,"Indian River County, FL"
62,2018,Mar,64544,61771,2773,4.3,"Indian River County, FL"
63,2018,Apr,64295,61702,2593,4.0,"Indian River County, FL"
64,2018,May,64299,61621,2678,4.2,"Indian River County, FL"
65,2018,Jun,64451,61282,3169,4.9,"Indian River County, FL"
66,2018,Jul,64415,61214,3201,5.0,"Indian River County, FL"
67,2018,Aug,64072,60924,3148,4.9,"Indian River County, FL"
68,2018,Sep,64446,61591,2855,4.4,"Indian River County, FL"
69,2018,Oct,64840,62095,2745,4.2,"Indian River County, FL"
70,2018,Nov,65101,62513,2588,4.0,"Indian River County, FL"
71,2018,Dec,65318,62771,2547,3.9,"Indian River County, FL"
72,2019,Jan,65226,62352,2874,4.4,"Indian River County, FL"
73,2019,Feb,65072,62541,2531,3.9,"Indian River County, FL"
74,2019,Mar,65247,62761,2486,3.8,"Indian River County, FL"
75,2019,Apr,65033,62771,2262,3.5,"Indian River County, FL"
76,2019,May,64932,62526,2406,3.7,"Indian River County, FL"
77,2019,Jun,65273,62496,2777,4.3,"Indian River County, FL"
78,2019,Jul,65219,62312,2907,4.5,"Indian River County, FL"
79,2019,Aug,65144,62217,2927,4.5,"Indian River County, FL"
80,2019,Sep,64699,62082,2617,4.0,"Indian River County, FL"
81,2019,Oct,65231,62758,2473,3.8,"Indian River County, FL"
82,2019,Nov,65579,63229,2350,3.6,"Indian River County, FL"
83,2019,Dec,65983,63804,2179,3.3,"Indian River County, FL"
84,2020,Jan,66555,64061,2494,3.7,"Indian River County, FL"
85,2020,Feb,66416,64275,2141,3.2,"Indian River County, FL"
86,2020,Mar,65325,62164,3161,4.8,"Indian River County, FL"
87,2020,Apr,59686,51877,7809,13.1,"Indian River County, FL"
88,2020,May,64101,55848,8253,12.9,"Indian River County, FL"
89,2020,Jun,63721,56977,6744,10.6,"Indian River County, FL"
90,2020,Jul,64558,57139,7419,11.5,"Indian River County, FL"
91,2020,Aug,63742,58483,5259,8.3,"Indian River County, FL"
92,2020,Sep,63968,59025,4943,7.7,"Indian River County, FL"
93,2020,Oct,64069,59901,4168,6.5,"Indian River County, FL"
94,2020,Nov,64039,60170,3869,6.0,"Indian River County, FL"
95,2020,Dec,64529,60851,3678,5.7,"Indian River County, FL"
96,2021,Jan,64883,61180,3703,5.7,"Indian River County, FL"
97,2021,Feb,65053,61690,3363,5.2,"Indian River County, FL"
98,2021,Mar,65304,62021,3283,5.0,"Indian River County, FL"
99,2021,Apr,64750,61594,3156,4.9,"Indian River County, FL"
100,2021,May,64914,61852,3062,4.7,"Indian River County, FL"
101,2021,Jun,65286,61692,3594,5.5,"Indian River County, FL"
102,2021,Jul,65804,62383,3421,5.2,"Indian River County, FL"
103,2021,Aug,65959,62583,3376,5.1,"Indian River County, FL"
104,2021,Sep,65975,62981,2994,4.5,"Indian River County, FL"
105,2021,Oct,66221,63437,2784,4.2,"Indian River County, FL"
106,2021,Nov,66483,63843,2640,4.0,"Indian River County, FL"
107,2021,Dec,67277,64979,2298,3.4,"Indian River County, FL"
108,2022,Jan,67610,64775,2835,4.2,"Indian River County, FL"
109,2022,Feb,67447,64955,2492,3.7,"Indian River County, FL"
110,2022,Mar,68139,65884,2255,3.3,"Indian River County, FL"
111,2022,Apr,67976,65877,2099,3.1,"Indian River County, FL"
112,2022,May,68299,66092,2207,3.2,"Indian River County, FL"
113,2022,Jun,68325,65728,2597,3.8,"Indian River County, FL"
114,2022,Jul,67999,65521,2478,3.6,"Indian River County, FL"
115,2022,Aug,68075,65561,2514,3.7,"Indian River County, FL"
116,2022,Sep,68082,65865,2217,3.3,"Indian River County, FL"
117,2022,Oct,68081,65943,2138,3.1,"Indian River County, FL"
118,2022,Nov,67521,65513,2008,3.0,"Indian River County, FL"
119,2022,Dec,67806,66008,1798,2.7,"Indian River County, FL"
120,2023,Jan,67863,65821,2042,3.0,"Indian River County, FL"
121,2023,Feb,68399,66340,2059,3.0,"Indian River County, FL"
122,2023,Mar,68935,66841,2094,3.0,"Indian River County, FL"
123,2023,Apr,68638,66778,1860,2.7,"Indian River County, FL"
124,2023,May,68697,66497,2200,3.2,"Indian River County, FL"
125,2023,Jun,69482,66965,2517,3.6,"Indian River County, FL"
126,2023,Jul,69802,67167,2635,3.8,"Indian River County, FL"
127,2023,Aug,70120,67309,2811,4.0,"Indian River County, FL"
128,2023,Sep,70037,67211,2826,4.0,"Indian River County, FL"
129,2023,Oct,70071,67410,2661,3.8,"Indian River County, FL"
0,2013,Jan,168140,153717,14423,8.6,"Sarasota County, FL"
1,2013,Feb,168035,155261,12774,7.6,"Sarasota County, FL"
2,2013,Mar,168107,155950,12157,7.2,"Sarasota County, FL"
3,2013,Apr,168666,156680,11986,7.1,"Sarasota County, FL"
4,2013,May,170896,158566,12330,7.2,"Sarasota County, FL"
5,2013,Jun,171218,158190,13028,7.6,"Sarasota County, FL"
6,2013,Jul,171589,158670,12919,7.5,"Sarasota County, FL"
7,2013,Aug,170675,158052,12623,7.4,"Sarasota County, FL"
8,2013,Sep,171568,159160,12408,7.2,"Sarasota County, FL"
9,2013,Oct,171247,159045,12202,7.1,"Sarasota County, FL"
10,2013,Nov,171656,160262,11394,6.6,"Sarasota County, FL"
11,2013,Dec,171665,160997,10668,6.2,"Sarasota County, FL"
12,2014,Jan,171645,160186,11459,6.7,"Sarasota County, FL"
13,2014,Feb,172752,161857,10895,6.3,"Sarasota County, FL"
14,2014,Mar,174059,163257,10802,6.2,"Sarasota County, FL"
15,2014,Apr,172451,162711,9740,5.6,"Sarasota County, FL"
16,2014,May,174183,163688,10495,6.0,"Sarasota County, FL"
17,2014,Jun,174501,163853,10648,6.1,"Sarasota County, FL"
18,2014,Jul,175131,163821,11310,6.5,"Sarasota County, FL"
19,2014,Aug,174727,163744,10983,6.3,"Sarasota County, FL"
20,2014,Sep,175717,165240,10477,6.0,"Sarasota County, FL"
21,2014,Oct,177207,167051,10156,5.7,"Sarasota County, FL"
22,2014,Nov,176534,166640,9894,5.6,"Sarasota County, FL"
23,2014,Dec,176730,167531,9199,5.2,"Sarasota County, FL"
24,2015,Jan,177422,167119,10303,5.8,"Sarasota County, FL"
25,2015,Feb,176308,166958,9350,5.3,"Sarasota County, FL"
26,2015,Mar,177423,168455,8968,5.1,"Sarasota County, FL"
27,2015,Apr,177648,168814,8834,5.0,"Sarasota County, FL"
28,2015,May,179615,170325,9290,5.2,"Sarasota County, FL"
29,2015,Jun,179751,170424,9327,5.2,"Sarasota County, FL"
30,2015,Jul,178776,169186,9590,5.4,"Sarasota County, FL"
31,2015,Aug,178440,169140,9300,5.2,"Sarasota County, FL"
32,2015,Sep,178515,169575,8940,5.0,"Sarasota County, FL"
33,2015,Oct,179707,170688,9019,5.0,"Sarasota County, FL"
34,2015,Nov,178858,170242,8616,4.8,"Sarasota County, FL"
35,2015,Dec,179588,171428,8160,4.5,"Sarasota County, FL"
36,2016,Jan,179299,170562,8737,4.9,"Sarasota County, FL"
37,2016,Feb,180290,172136,8154,4.5,"Sarasota County, FL"
38,2016,Mar,181288,173186,8102,4.5,"Sarasota County, FL"
39,2016,Apr,179980,172130,7850,4.4,"Sarasota County, FL"
40,2016,May,181007,173193,7814,4.3,"Sarasota County, FL"
41,2016,Jun,181769,173250,8519,4.7,"Sarasota County, FL"
42,2016,Jul,182203,173382,8821,4.8,"Sarasota County, FL"
43,2016,Aug,181830,173070,8760,4.8,"Sarasota County, FL"
44,2016,Sep,182734,173947,8787,4.8,"Sarasota County, FL"
45,2016,Oct,183814,175205,8609,4.7,"Sarasota County, FL"
46,2016,Nov,182562,174456,8106,4.4,"Sarasota County, FL"
47,2016,Dec,182501,174745,7756,4.2,"Sarasota County, FL"
48,2017,Jan,181937,173376,8561,4.7,"Sarasota County, FL"
49,2017,Feb,182305,174448,7857,4.3,"Sarasota County, FL"
50,2017,Mar,183626,176357,7269,4.0,"Sarasota County, FL"
51,2017,Apr,182689,175831,6858,3.8,"Sarasota County, FL"
52,2017,May,183487,176348,7139,3.9,"Sarasota County, FL"
53,2017,Jun,183956,176438,7518,4.1,"Sarasota County, FL"
54,2017,Jul,183463,175718,7745,4.2,"Sarasota County, FL"
55,2017,Aug,183280,175440,7840,4.3,"Sarasota County, FL"
56,2017,Sep,183011,175815,7196,3.9,"Sarasota County, FL"
57,2017,Oct,183932,176978,6954,3.8,"Sarasota County, FL"
58,2017,Nov,183467,176631,6836,3.7,"Sarasota County, FL"
59,2017,Dec,183138,176705,6433,3.5,"Sarasota County, FL"
60,2018,Jan,183972,176760,7212,3.9,"Sarasota County, FL"
61,2018,Feb,185281,178628,6653,3.6,"Sarasota County, FL"
62,2018,Mar,186135,179767,6368,3.4,"Sarasota County, FL"
63,2018,Apr,185317,179336,5981,3.2,"Sarasota County, FL"
64,2018,May,186046,180021,6025,3.2,"Sarasota County, FL"
65,2018,Jun,186756,179566,7190,3.8,"Sarasota County, FL"
66,2018,Jul,185826,178996,6830,3.7,"Sarasota County, FL"
67,2018,Aug,185711,178937,6774,3.6,"Sarasota County, FL"
68,2018,Sep,185845,179606,6239,3.4,"Sarasota County, FL"
69,2018,Oct,187985,181726,6259,3.3,"Sarasota County, FL"
70,2018,Nov,186688,180602,6086,3.3,"Sarasota County, FL"
71,2018,Dec,185959,179944,6015,3.2,"Sarasota County, FL"
72,2019,Jan,186819,179841,6978,3.7,"Sarasota County, FL"
73,2019,Feb,187217,181104,6113,3.3,"Sarasota County, FL"
74,2019,Mar,187728,181670,6058,3.2,"Sarasota County, FL"
75,2019,Apr,186626,181193,5433,2.9,"Sarasota County, FL"
76,2019,May,187475,181807,5668,3.0,"Sarasota County, FL"
77,2019,Jun,188107,181527,6580,3.5,"Sarasota County, FL"
78,2019,Jul,187704,181168,6536,3.5,"Sarasota County, FL"
79,2019,Aug,187007,180466,6541,3.5,"Sarasota County, FL"
80,2019,Sep,188533,182756,5777,3.1,"Sarasota County, FL"
81,2019,Oct,189061,183400,5661,3.0,"Sarasota County, FL"
82,2019,Nov,188690,183141,5549,2.9,"Sarasota County, FL"
83,2019,Dec,189217,184062,5155,2.7,"Sarasota County, FL"
84,2020,Jan,189345,183256,6089,3.2,"Sarasota County, FL"
85,2020,Feb,189801,184587,5214,2.7,"Sarasota County, FL"
86,2020,Mar,187096,179492,7604,4.1,"Sarasota County, FL"
87,2020,Apr,170849,147376,23473,13.7,"Sarasota County, FL"
88,2020,May,183074,159452,23622,12.9,"Sarasota County, FL"
89,2020,Jun,184610,166370,18240,9.9,"Sarasota County, FL"
90,2020,Jul,186003,166795,19208,10.3,"Sarasota County, FL"
91,2020,Aug,183816,170565,13251,7.2,"Sarasota County, FL"
92,2020,Sep,184148,171766,12382,6.7,"Sarasota County, FL"
93,2020,Oct,184804,174339,10465,5.7,"Sarasota County, FL"
94,2020,Nov,183211,173426,9785,5.3,"Sarasota County, FL"
95,2020,Dec,184126,174685,9441,5.1,"Sarasota County, FL"
96,2021,Jan,184882,175745,9137,4.9,"Sarasota County, FL"
97,2021,Feb,186329,178014,8315,4.5,"Sarasota County, FL"
98,2021,Mar,187604,179440,8164,4.4,"Sarasota County, FL"
99,2021,Apr,187444,180090,7354,3.9,"Sarasota County, FL"
100,2021,May,188758,181652,7106,3.8,"Sarasota County, FL"
101,2021,Jun,191128,182519,8609,4.5,"Sarasota County, FL"
102,2021,Jul,190772,182598,8174,4.3,"Sarasota County, FL"
103,2021,Aug,190694,182684,8010,4.2,"Sarasota County, FL"
104,2021,Sep,190934,183886,7048,3.7,"Sarasota County, FL"
105,2021,Oct,192121,185422,6699,3.5,"Sarasota County, FL"
106,2021,Nov,191656,185231,6425,3.4,"Sarasota County, FL"
107,2021,Dec,192769,187171,5598,2.9,"Sarasota County, FL"
108,2022,Jan,193284,186224,7060,3.7,"Sarasota County, FL"
109,2022,Feb,193578,187461,6117,3.2,"Sarasota County, FL"
110,2022,Mar,194674,189089,5585,2.9,"Sarasota County, FL"
111,2022,Apr,194603,189704,4899,2.5,"Sarasota County, FL"
112,2022,May,196649,191487,5162,2.6,"Sarasota County, FL"
113,2022,Jun,197709,191576,6133,3.1,"Sarasota County, FL"
114,2022,Jul,197128,191440,5688,2.9,"Sarasota County, FL"
115,2022,Aug,196791,191032,5759,2.9,"Sarasota County, FL"
116,2022,Sep,196780,191457,5323,2.7,"Sarasota County, FL"
117,2022,Oct,197622,191896,5726,2.9,"Sarasota County, FL"
118,2022,Nov,196545,191145,5400,2.7,"Sarasota County, FL"
119,2022,Dec,196570,191870,4700,2.4,"Sarasota County, FL"
120,2023,Jan,198597,193283,5314,2.7,"Sarasota County, FL"
121,2023,Feb,199721,194459,5262,2.6,"Sarasota County, FL"
122,2023,Mar,201397,196077,5320,2.6,"Sarasota County, FL"
123,2023,Apr,200910,196330,4580,2.3,"Sarasota County, FL"
124,2023,May,201123,195645,5478,2.7,"Sarasota County, FL"
125,2023,Jun,203122,196988,6134,3.0,"Sarasota County, FL"
126,2023,Jul,204594,198116,6478,3.2,"Sarasota County, FL"
127,2023,Aug,203971,197244,6727,3.3,"Sarasota County, FL"
128,2023,Sep,202963,196166,6797,3.3,"Sarasota County, FL"
129,2023,Oct,203365,196797,6568,3.2,"Sarasota County, FL"
0,2013,Jan,447631,407879,39752,8.9,"Duval County, FL"
1,2013,Feb,447431,410632,36799,8.2,"Duval County, FL"
2,2013,Mar,448699,413598,35101,7.8,"Duval County, FL"
3,2013,Apr,450624,416287,34337,7.6,"Duval County, FL"
4,2013,May,457797,422379,35418,7.7,"Duval County, FL"
5,2013,Jun,462930,424434,38496,8.3,"Duval County, FL"
6,2013,Jul,465839,427654,38185,8.2,"Duval County, FL"
7,2013,Aug,464272,426611,37661,8.1,"Duval County, FL"
8,2013,Sep,463985,429049,34936,7.5,"Duval County, FL"
9,2013,Oct,459800,425193,34607,7.5,"Duval County, FL"
10,2013,Nov,454785,422089,32696,7.2,"Duval County, FL"
11,2013,Dec,454284,423158,31126,6.9,"Duval County, FL"
12,2014,Jan,450177,416860,33317,7.4,"Duval County, FL"
13,2014,Feb,452458,419552,32906,7.3,"Duval County, FL"
14,2014,Mar,455058,422619,32439,7.1,"Duval County, FL"
15,2014,Apr,453971,423974,29997,6.6,"Duval County, FL"
16,2014,May,460541,428944,31597,6.9,"Duval County, FL"
17,2014,Jun,463180,429821,33359,7.2,"Duval County, FL"
18,2014,Jul,465582,430787,34795,7.5,"Duval County, FL"
19,2014,Aug,465058,430594,34464,7.4,"Duval County, FL"
20,2014,Sep,463391,432318,31073,6.7,"Duval County, FL"
21,2014,Oct,464648,434770,29878,6.4,"Duval County, FL"
22,2014,Nov,459032,429382,29650,6.5,"Duval County, FL"
23,2014,Dec,458772,431065,27707,6.0,"Duval County, FL"
24,2015,Jan,454660,424915,29745,6.5,"Duval County, FL"
25,2015,Feb,455145,427395,27750,6.1,"Duval County, FL"
26,2015,Mar,457028,430386,26642,5.8,"Duval County, FL"
27,2015,Apr,457798,431800,25998,5.7,"Duval County, FL"
28,2015,May,464337,436840,27497,5.9,"Duval County, FL"
29,2015,Jun,467430,438269,29161,6.2,"Duval County, FL"
30,2015,Jul,468889,439088,29801,6.4,"Duval County, FL"
31,2015,Aug,467060,438480,28580,6.1,"Duval County, FL"
32,2015,Sep,466021,440225,25796,5.5,"Duval County, FL"
33,2015,Oct,466151,440620,25531,5.5,"Duval County, FL"
34,2015,Nov,461892,436852,25040,5.4,"Duval County, FL"
35,2015,Dec,462167,438579,23588,5.1,"Duval County, FL"
36,2016,Jan,457913,433418,24495,5.3,"Duval County, FL"
37,2016,Feb,460480,437528,22952,5.0,"Duval County, FL"
38,2016,Mar,462145,439718,22427,4.9,"Duval County, FL"
39,2016,Apr,463012,441249,21763,4.7,"Duval County, FL"
40,2016,May,468966,447192,21774,4.6,"Duval County, FL"
41,2016,Jun,472899,448468,24431,5.2,"Duval County, FL"
42,2016,Jul,476602,451275,25327,5.3,"Duval County, FL"
43,2016,Aug,476081,450790,25291,5.3,"Duval County, FL"
44,2016,Sep,477482,453578,23904,5.0,"Duval County, FL"
45,2016,Oct,473958,450981,22977,4.8,"Duval County, FL"
46,2016,Nov,470732,448416,22316,4.7,"Duval County, FL"
47,2016,Dec,469703,448279,21424,4.6,"Duval County, FL"
48,2017,Jan,463050,440087,22963,5.0,"Duval County, FL"
49,2017,Feb,465521,444241,21280,4.6,"Duval County, FL"
50,2017,Mar,466897,446932,19965,4.3,"Duval County, FL"
51,2017,Apr,469085,449943,19142,4.1,"Duval County, FL"
52,2017,May,473585,453857,19728,4.2,"Duval County, FL"
53,2017,Jun,478582,456735,21847,4.6,"Duval County, FL"
54,2017,Jul,482157,459462,22695,4.7,"Duval County, FL"
55,2017,Aug,479398,456664,22734,4.7,"Duval County, FL"
56,2017,Sep,481718,461816,19902,4.1,"Duval County, FL"
57,2017,Oct,479070,459954,19116,4.0,"Duval County, FL"
58,2017,Nov,477655,458772,18883,4.0,"Duval County, FL"
59,2017,Dec,476864,459035,17829,3.7,"Duval County, FL"
60,2018,Jan,472432,453052,19380,4.1,"Duval County, FL"
61,2018,Feb,474224,456165,18059,3.8,"Duval County, FL"
62,2018,Mar,474397,456842,17555,3.7,"Duval County, FL"
63,2018,Apr,474120,457618,16502,3.5,"Duval County, FL"
64,2018,May,479391,462644,16747,3.5,"Duval County, FL"
65,2018,Jun,485622,465502,20120,4.1,"Duval County, FL"
66,2018,Jul,487853,467572,20281,4.2,"Duval County, FL"
67,2018,Aug,484124,465263,18861,3.9,"Duval County, FL"
68,2018,Sep,486180,469233,16947,3.5,"Duval County, FL"
69,2018,Oct,484112,467082,17030,3.5,"Duval County, FL"
70,2018,Nov,481166,465159,16007,3.3,"Duval County, FL"
71,2018,Dec,481879,465998,15881,3.3,"Duval County, FL"
72,2019,Jan,474889,456390,18499,3.9,"Duval County, FL"
73,2019,Feb,475295,458933,16362,3.4,"Duval County, FL"
74,2019,Mar,475051,459042,16009,3.4,"Duval County, FL"
75,2019,Apr,474861,460540,14321,3.0,"Duval County, FL"
76,2019,May,481307,465857,15450,3.2,"Duval County, FL"
77,2019,Jun,487933,469755,18178,3.7,"Duval County, FL"
78,2019,Jul,491607,472579,19028,3.9,"Duval County, FL"
79,2019,Aug,491002,473060,17942,3.7,"Duval County, FL"
80,2019,Sep,492812,476720,16092,3.3,"Duval County, FL"
81,2019,Oct,491770,475908,15862,3.2,"Duval County, FL"
82,2019,Nov,488939,474015,14924,3.1,"Duval County, FL"
83,2019,Dec,489149,475322,13827,2.8,"Duval County, FL"
84,2020,Jan,483453,467343,16110,3.3,"Duval County, FL"
85,2020,Feb,483697,469689,14008,2.9,"Duval County, FL"
86,2020,Mar,476472,455273,21199,4.4,"Duval County, FL"
87,2020,Apr,440816,392486,48330,11.0,"Duval County, FL"
88,2020,May,473698,418758,54940,11.6,"Duval County, FL"
89,2020,Jun,478532,431973,46559,9.7,"Duval County, FL"
90,2020,Jul,492432,438501,53931,11.0,"Duval County, FL"
91,2020,Aug,487065,448351,38714,7.9,"Duval County, FL"
92,2020,Sep,490848,455269,35579,7.2,"Duval County, FL"
93,2020,Oct,490443,459852,30591,6.2,"Duval County, FL"
94,2020,Nov,487567,459071,28496,5.8,"Duval County, FL"
95,2020,Dec,487350,460147,27203,5.6,"Duval County, FL"
96,2021,Jan,483740,456130,27610,5.7,"Duval County, FL"
97,2021,Feb,484294,459096,25198,5.2,"Duval County, FL"
98,2021,Mar,485236,461578,23658,4.9,"Duval County, FL"
99,2021,Apr,486118,463664,22454,4.6,"Duval County, FL"
100,2021,May,490815,468935,21880,4.5,"Duval County, FL"
101,2021,Jun,495748,470550,25198,5.1,"Duval County, FL"
102,2021,Jul,497442,473474,23968,4.8,"Duval County, FL"
103,2021,Aug,498033,475190,22843,4.6,"Duval County, FL"
104,2021,Sep,500740,480165,20575,4.1,"Duval County, FL"
105,2021,Oct,501093,481390,19703,3.9,"Duval County, FL"
106,2021,Nov,501018,482553,18465,3.7,"Duval County, FL"
107,2021,Dec,501203,485099,16104,3.2,"Duval County, FL"
108,2022,Jan,502431,483108,19323,3.8,"Duval County, FL"
109,2022,Feb,501895,485147,16748,3.3,"Duval County, FL"
110,2022,Mar,504364,489041,15323,3.0,"Duval County, FL"
111,2022,Apr,505164,490790,14374,2.8,"Duval County, FL"
112,2022,May,510632,496010,14622,2.9,"Duval County, FL"
113,2022,Jun,514764,497290,17474,3.4,"Duval County, FL"
114,2022,Jul,517555,500760,16795,3.2,"Duval County, FL"
115,2022,Aug,518710,501719,16991,3.3,"Duval County, FL"
116,2022,Sep,518920,504556,14364,2.8,"Duval County, FL"
117,2022,Oct,519045,504755,14290,2.8,"Duval County, FL"
118,2022,Nov,515365,501720,13645,2.6,"Duval County, FL"
119,2022,Dec,520153,507994,12159,2.3,"Duval County, FL"
120,2023,Jan,520149,506446,13703,2.6,"Duval County, FL"
121,2023,Feb,525425,511687,13738,2.6,"Duval County, FL"
122,2023,Mar,528742,514338,14404,2.7,"Duval County, FL"
123,2023,Apr,527247,514456,12791,2.4,"Duval County, FL"
124,2023,May,531331,516442,14889,2.8,"Duval County, FL"
125,2023,Jun,541703,524180,17523,3.2,"Duval County, FL"
126,2023,Jul,543265,525061,18204,3.4,"Duval County, FL"
127,2023,Aug,547550,529093,18457,3.4,"Duval County, FL"
128,2023,Sep,546988,529856,17132,3.1,"Duval County, FL"
129,2023,Oct,547284,529916,17368,3.2,"Duval County, FL"
0,2013,Jan,207796,188757,19039,9.2,"Pasco County, FL"
1,2013,Feb,207059,189557,17502,8.5,"Pasco County, FL"
2,2013,Mar,207247,190593,16654,8.0,"Pasco County, FL"
3,2013,Apr,207962,191918,16044,7.7,"Pasco County, FL"
4,2013,May,210805,194170,16635,7.9,"Pasco County, FL"
5,2013,Jun,212101,194450,17651,8.3,"Pasco County, FL"
6,2013,Jul,212652,195231,17421,8.2,"Pasco County, FL"
7,2013,Aug,212275,195151,17124,8.1,"Pasco County, FL"
8,2013,Sep,212584,195966,16618,7.8,"Pasco County, FL"
9,2013,Oct,210890,194399,16491,7.8,"Pasco County, FL"
10,2013,Nov,209271,193522,15749,7.5,"Pasco County, FL"
11,2013,Dec,208370,193426,14944,7.2,"Pasco County, FL"
12,2014,Jan,209677,193767,15910,7.6,"Pasco County, FL"
13,2014,Feb,210287,194838,15449,7.3,"Pasco County, FL"
14,2014,Mar,211582,196416,15166,7.2,"Pasco County, FL"
15,2014,Apr,210723,197008,13715,6.5,"Pasco County, FL"
16,2014,May,213389,198946,14443,6.8,"Pasco County, FL"
17,2014,Jun,213983,199076,14907,7.0,"Pasco County, FL"
18,2014,Jul,215031,199461,15570,7.2,"Pasco County, FL"
19,2014,Aug,214582,199410,15172,7.1,"Pasco County, FL"
20,2014,Sep,214934,200727,14207,6.6,"Pasco County, FL"
21,2014,Oct,214360,200472,13888,6.5,"Pasco County, FL"
22,2014,Nov,212523,198655,13868,6.5,"Pasco County, FL"
23,2014,Dec,211696,198667,13029,6.2,"Pasco County, FL"
24,2015,Jan,213503,199162,14341,6.7,"Pasco County, FL"
25,2015,Feb,213160,199903,13257,6.2,"Pasco County, FL"
26,2015,Mar,213494,200821,12673,5.9,"Pasco County, FL"
27,2015,Apr,214053,201743,12310,5.8,"Pasco County, FL"
28,2015,May,217032,203878,13154,6.1,"Pasco County, FL"
29,2015,Jun,217842,204375,13467,6.2,"Pasco County, FL"
30,2015,Jul,218000,204419,13581,6.2,"Pasco County, FL"
31,2015,Aug,217436,204480,12956,6.0,"Pasco County, FL"
32,2015,Sep,217769,205441,12328,5.7,"Pasco County, FL"
33,2015,Oct,218211,205930,12281,5.6,"Pasco County, FL"
34,2015,Nov,217283,205158,12125,5.6,"Pasco County, FL"
35,2015,Dec,217125,205518,11607,5.3,"Pasco County, FL"
36,2016,Jan,219585,207328,12257,5.6,"Pasco County, FL"
37,2016,Feb,220627,209247,11380,5.2,"Pasco County, FL"
38,2016,Mar,221276,209943,11333,5.1,"Pasco County, FL"
39,2016,Apr,221454,210569,10885,4.9,"Pasco County, FL"
40,2016,May,223251,212399,10852,4.9,"Pasco County, FL"
41,2016,Jun,224559,212519,12040,5.4,"Pasco County, FL"
42,2016,Jul,225236,213040,12196,5.4,"Pasco County, FL"
43,2016,Aug,224744,212648,12096,5.4,"Pasco County, FL"
44,2016,Sep,226093,214147,11946,5.3,"Pasco County, FL"
45,2016,Oct,225721,214069,11652,5.2,"Pasco County, FL"
46,2016,Nov,223406,212224,11182,5.0,"Pasco County, FL"
47,2016,Dec,223046,212180,10866,4.9,"Pasco County, FL"
48,2017,Jan,223753,211811,11942,5.3,"Pasco County, FL"
49,2017,Feb,224473,213515,10958,4.9,"Pasco County, FL"
50,2017,Mar,225115,214828,10287,4.6,"Pasco County, FL"
51,2017,Apr,225515,215808,9707,4.3,"Pasco County, FL"
52,2017,May,226358,216408,9950,4.4,"Pasco County, FL"
53,2017,Jun,228554,217872,10682,4.7,"Pasco County, FL"
54,2017,Jul,228346,217569,10777,4.7,"Pasco County, FL"
55,2017,Aug,227530,216779,10751,4.7,"Pasco County, FL"
56,2017,Sep,228999,219076,9923,4.3,"Pasco County, FL"
57,2017,Oct,227548,217955,9593,4.2,"Pasco County, FL"
58,2017,Nov,226367,216675,9692,4.3,"Pasco County, FL"
59,2017,Dec,225546,216368,9178,4.1,"Pasco County, FL"
60,2018,Jan,228454,218276,10178,4.5,"Pasco County, FL"
61,2018,Feb,229823,220343,9480,4.1,"Pasco County, FL"
62,2018,Mar,230034,220811,9223,4.0,"Pasco County, FL"
63,2018,Apr,230277,221622,8655,3.8,"Pasco County, FL"
64,2018,May,231442,222823,8619,3.7,"Pasco County, FL"
65,2018,Jun,233917,223841,10076,4.3,"Pasco County, FL"
66,2018,Jul,234187,224341,9846,4.2,"Pasco County, FL"
67,2018,Aug,233097,223547,9550,4.1,"Pasco County, FL"
68,2018,Sep,234498,225719,8779,3.7,"Pasco County, FL"
69,2018,Oct,234434,225624,8810,3.8,"Pasco County, FL"
70,2018,Nov,232333,223874,8459,3.6,"Pasco County, FL"
71,2018,Dec,232121,223637,8484,3.7,"Pasco County, FL"
72,2019,Jan,234753,224869,9884,4.2,"Pasco County, FL"
73,2019,Feb,235341,226655,8686,3.7,"Pasco County, FL"
74,2019,Mar,235375,226844,8531,3.6,"Pasco County, FL"
75,2019,Apr,235225,227560,7665,3.3,"Pasco County, FL"
76,2019,May,237454,229361,8093,3.4,"Pasco County, FL"
77,2019,Jun,239869,230592,9277,3.9,"Pasco County, FL"
78,2019,Jul,240704,231290,9414,3.9,"Pasco County, FL"
79,2019,Aug,240620,231373,9247,3.8,"Pasco County, FL"
80,2019,Sep,242543,234161,8382,3.5,"Pasco County, FL"
81,2019,Oct,242010,233728,8282,3.4,"Pasco County, FL"
82,2019,Nov,240613,232612,8001,3.3,"Pasco County, FL"
83,2019,Dec,240596,233219,7377,3.1,"Pasco County, FL"
84,2020,Jan,244247,235521,8726,3.6,"Pasco County, FL"
85,2020,Feb,245040,237545,7495,3.1,"Pasco County, FL"
86,2020,Mar,241470,230315,11155,4.6,"Pasco County, FL"
87,2020,Apr,225288,196789,28499,12.7,"Pasco County, FL"
88,2020,May,239922,209059,30863,12.9,"Pasco County, FL"
89,2020,Jun,240796,215835,24961,10.4,"Pasco County, FL"
90,2020,Jul,244776,217972,26804,11.0,"Pasco County, FL"
91,2020,Aug,241855,223197,18658,7.7,"Pasco County, FL"
92,2020,Sep,242380,224973,17407,7.2,"Pasco County, FL"
93,2020,Oct,243623,228656,14967,6.1,"Pasco County, FL"
94,2020,Nov,241470,227445,14025,5.8,"Pasco County, FL"
95,2020,Dec,241477,228063,13414,5.6,"Pasco County, FL"
96,2021,Jan,241527,228042,13485,5.6,"Pasco County, FL"
97,2021,Feb,242243,230089,12154,5.0,"Pasco County, FL"
98,2021,Mar,243714,231857,11857,4.9,"Pasco County, FL"
99,2021,Apr,244165,232896,11269,4.6,"Pasco County, FL"
100,2021,May,245507,234624,10883,4.4,"Pasco County, FL"
101,2021,Jun,248900,236326,12574,5.1,"Pasco County, FL"
102,2021,Jul,249169,237261,11908,4.8,"Pasco County, FL"
103,2021,Aug,249505,238034,11471,4.6,"Pasco County, FL"
104,2021,Sep,251337,241063,10274,4.1,"Pasco County, FL"
105,2021,Oct,251967,242124,9843,3.9,"Pasco County, FL"
106,2021,Nov,251503,242237,9266,3.7,"Pasco County, FL"
107,2021,Dec,251708,243635,8073,3.2,"Pasco County, FL"
108,2022,Jan,253509,243618,9891,3.9,"Pasco County, FL"
109,2022,Feb,253472,244795,8677,3.4,"Pasco County, FL"
110,2022,Mar,254855,247043,7812,3.1,"Pasco County, FL"
111,2022,Apr,255662,248557,7105,2.8,"Pasco County, FL"
112,2022,May,257396,250005,7391,2.9,"Pasco County, FL"
113,2022,Jun,259900,251389,8511,3.3,"Pasco County, FL"
114,2022,Jul,259204,251115,8089,3.1,"Pasco County, FL"
115,2022,Aug,260146,251970,8176,3.1,"Pasco County, FL"
116,2022,Sep,261115,253559,7556,2.9,"Pasco County, FL"
117,2022,Oct,261415,253872,7543,2.9,"Pasco County, FL"
118,2022,Nov,260490,253159,7331,2.8,"Pasco County, FL"
119,2022,Dec,260632,254247,6385,2.4,"Pasco County, FL"
120,2023,Jan,261567,254155,7412,2.8,"Pasco County, FL"
121,2023,Feb,263891,256497,7394,2.8,"Pasco County, FL"
122,2023,Mar,266549,258913,7636,2.9,"Pasco County, FL"
123,2023,Apr,266404,259558,6846,2.6,"Pasco County, FL"
124,2023,May,267575,259531,8044,3.0,"Pasco County, FL"
125,2023,Jun,271666,262591,9075,3.3,"Pasco County, FL"
126,2023,Jul,271320,261947,9373,3.5,"Pasco County, FL"
127,2023,Aug,272706,263003,9703,3.6,"Pasco County, FL"
128,2023,Sep,273112,263489,9623,3.5,"Pasco County, FL"
129,2023,Oct,272234,262571,9663,3.5,"Pasco County, FL"
0,2013,Jan,104820,97909,6911,6.6,"St. Johns County, FL"
1,2013,Feb,104859,98591,6268,6.0,"St. Johns County, FL"
2,2013,Mar,105176,99239,5937,5.6,"St. Johns County, FL"
3,2013,Apr,105586,99931,5655,5.4,"St. Johns County, FL"
4,2013,May,107603,101566,6037,5.6,"St. Johns County, FL"
5,2013,Jun,108594,102058,6536,6.0,"St. Johns County, FL"
6,2013,Jul,109023,102525,6498,6.0,"St. Johns County, FL"
7,2013,Aug,108315,102164,6151,5.7,"St. Johns County, FL"
8,2013,Sep,108782,102782,6000,5.5,"St. Johns County, FL"
9,2013,Oct,107688,101926,5762,5.4,"St. Johns County, FL"
10,2013,Nov,106785,101144,5641,5.3,"St. Johns County, FL"
11,2013,Dec,106828,101447,5381,5.0,"St. Johns County, FL"
12,2014,Jan,108331,102495,5836,5.4,"St. Johns County, FL"
13,2014,Feb,108920,103182,5738,5.3,"St. Johns County, FL"
14,2014,Mar,109509,103885,5624,5.1,"St. Johns County, FL"
15,2014,Apr,109100,104178,4922,4.5,"St. Johns County, FL"
16,2014,May,110824,105493,5331,4.8,"St. Johns County, FL"
17,2014,Jun,111399,105822,5577,5.0,"St. Johns County, FL"
18,2014,Jul,111721,105862,5859,5.2,"St. Johns County, FL"
19,2014,Aug,111272,105722,5550,5.0,"St. Johns County, FL"
20,2014,Sep,111333,106201,5132,4.6,"St. Johns County, FL"
21,2014,Oct,111779,106817,4962,4.4,"St. Johns County, FL"
22,2014,Nov,110478,105532,4946,4.5,"St. Johns County, FL"
23,2014,Dec,110484,105902,4582,4.1,"St. Johns County, FL"
24,2015,Jan,111935,106789,5146,4.6,"St. Johns County, FL"
25,2015,Feb,111850,107226,4624,4.1,"St. Johns County, FL"
26,2015,Mar,112369,107963,4406,3.9,"St. Johns County, FL"
27,2015,Apr,112638,108400,4238,3.8,"St. Johns County, FL"
28,2015,May,114421,109823,4598,4.0,"St. Johns County, FL"
29,2015,Jun,114951,110209,4742,4.1,"St. Johns County, FL"
30,2015,Jul,114954,110194,4760,4.1,"St. Johns County, FL"
31,2015,Aug,114628,110044,4584,4.0,"St. Johns County, FL"
32,2015,Sep,114820,110400,4420,3.8,"St. Johns County, FL"
33,2015,Oct,114868,110560,4308,3.8,"St. Johns County, FL"
34,2015,Nov,113968,109650,4318,3.8,"St. Johns County, FL"
35,2015,Dec,114178,109993,4185,3.7,"St. Johns County, FL"
36,2016,Jan,115865,111260,4605,4.0,"St. Johns County, FL"
37,2016,Feb,116445,112205,4240,3.6,"St. Johns County, FL"
38,2016,Mar,117083,112796,4287,3.7,"St. Johns County, FL"
39,2016,Apr,117395,113233,4162,3.5,"St. Johns County, FL"
40,2016,May,118951,114825,4126,3.5,"St. Johns County, FL"
41,2016,Jun,120009,115209,4800,4.0,"St. Johns County, FL"
42,2016,Jul,120644,115728,4916,4.1,"St. Johns County, FL"
43,2016,Aug,120430,115614,4816,4.0,"St. Johns County, FL"
44,2016,Sep,121163,116317,4846,4.0,"St. Johns County, FL"
45,2016,Oct,120483,115769,4714,3.9,"St. Johns County, FL"
46,2016,Nov,119693,115096,4597,3.8,"St. Johns County, FL"
47,2016,Dec,119426,115012,4414,3.7,"St. Johns County, FL"
48,2017,Jan,121059,116060,4999,4.1,"St. Johns County, FL"
49,2017,Feb,121536,117075,4461,3.7,"St. Johns County, FL"
50,2017,Mar,122061,117852,4209,3.4,"St. Johns County, FL"
51,2017,Apr,122647,118675,3972,3.2,"St. Johns County, FL"
52,2017,May,123829,119801,4028,3.3,"St. Johns County, FL"
53,2017,Jun,125045,120608,4437,3.5,"St. Johns County, FL"
54,2017,Jul,125431,120877,4554,3.6,"St. Johns County, FL"
55,2017,Aug,124799,120253,4546,3.6,"St. Johns County, FL"
56,2017,Sep,125755,121582,4173,3.3,"St. Johns County, FL"
57,2017,Oct,125175,121118,4057,3.2,"St. Johns County, FL"
58,2017,Nov,124957,120847,4110,3.3,"St. Johns County, FL"
59,2017,Dec,124628,120869,3759,3.0,"St. Johns County, FL"
60,2018,Jan,127234,122884,4350,3.4,"St. Johns County, FL"
61,2018,Feb,127745,123761,3984,3.1,"St. Johns County, FL"
62,2018,Mar,127933,124084,3849,3.0,"St. Johns County, FL"
63,2018,Apr,127923,124322,3601,2.8,"St. Johns County, FL"
64,2018,May,129266,125782,3484,2.7,"St. Johns County, FL"
65,2018,Jun,130549,126346,4203,3.2,"St. Johns County, FL"
66,2018,Jul,130569,126571,3998,3.1,"St. Johns County, FL"
67,2018,Aug,129863,125928,3935,3.0,"St. Johns County, FL"
68,2018,Sep,130732,127084,3648,2.8,"St. Johns County, FL"
69,2018,Oct,130322,126553,3769,2.9,"St. Johns County, FL"
70,2018,Nov,129699,126099,3600,2.8,"St. Johns County, FL"
71,2018,Dec,129838,126250,3588,2.8,"St. Johns County, FL"
72,2019,Jan,132378,128015,4363,3.3,"St. Johns County, FL"
73,2019,Feb,132399,128693,3706,2.8,"St. Johns County, FL"
74,2019,Mar,132513,128859,3654,2.8,"St. Johns County, FL"
75,2019,Apr,132638,129408,3230,2.4,"St. Johns County, FL"
76,2019,May,134372,131003,3369,2.5,"St. Johns County, FL"
77,2019,Jun,136069,132094,3975,2.9,"St. Johns County, FL"
78,2019,Jul,136419,132342,4077,3.0,"St. Johns County, FL"
79,2019,Aug,136352,132442,3910,2.9,"St. Johns County, FL"
80,2019,Sep,136976,133474,3502,2.6,"St. Johns County, FL"
81,2019,Oct,136821,133343,3478,2.5,"St. Johns County, FL"
82,2019,Nov,136084,132751,3333,2.4,"St. Johns County, FL"
83,2019,Dec,136351,133218,3133,2.3,"St. Johns County, FL"
84,2020,Jan,140768,136935,3833,2.7,"St. Johns County, FL"
85,2020,Feb,140779,137546,3233,2.3,"St. Johns County, FL"
86,2020,Mar,138168,133419,4749,3.4,"St. Johns County, FL"
87,2020,Apr,127760,114821,12939,10.1,"St. Johns County, FL"
88,2020,May,135605,122721,12884,9.5,"St. Johns County, FL"
89,2020,Jun,136662,126341,10321,7.6,"St. Johns County, FL"
90,2020,Jul,138906,127943,10963,7.9,"St. Johns County, FL"
91,2020,Aug,138102,130792,7310,5.3,"St. Johns County, FL"
92,2020,Sep,139424,132696,6728,4.8,"St. Johns County, FL"
93,2020,Oct,139862,134089,5773,4.1,"St. Johns County, FL"
94,2020,Nov,139401,133854,5547,4.0,"St. Johns County, FL"
95,2020,Dec,139673,134359,5314,3.8,"St. Johns County, FL"
96,2021,Jan,139426,134025,5401,3.9,"St. Johns County, FL"
97,2021,Feb,139682,134875,4807,3.4,"St. Johns County, FL"
98,2021,Mar,140236,135555,4681,3.3,"St. Johns County, FL"
99,2021,Apr,140200,135937,4263,3.0,"St. Johns County, FL"
100,2021,May,142049,137992,4057,2.9,"St. Johns County, FL"
101,2021,Jun,143491,138448,5043,3.5,"St. Johns County, FL"
102,2021,Jul,143919,139011,4908,3.4,"St. Johns County, FL"
103,2021,Aug,144053,139362,4691,3.3,"St. Johns County, FL"
104,2021,Sep,144874,140690,4184,2.9,"St. Johns County, FL"
105,2021,Oct,145239,141179,4060,2.8,"St. Johns County, FL"
106,2021,Nov,145125,141348,3777,2.6,"St. Johns County, FL"
107,2021,Dec,145751,142395,3356,2.3,"St. Johns County, FL"
108,2022,Jan,146253,141978,4275,2.9,"St. Johns County, FL"
109,2022,Feb,146287,142548,3739,2.6,"St. Johns County, FL"
110,2022,Mar,147100,143656,3444,2.3,"St. Johns County, FL"
111,2022,Apr,147114,144053,3061,2.1,"St. Johns County, FL"
112,2022,May,149354,146069,3285,2.2,"St. Johns County, FL"
113,2022,Jun,150069,146225,3844,2.6,"St. Johns County, FL"
114,2022,Jul,150429,146779,3650,2.4,"St. Johns County, FL"
115,2022,Aug,150550,146968,3582,2.4,"St. Johns County, FL"
116,2022,Sep,151151,147809,3342,2.2,"St. Johns County, FL"
117,2022,Oct,151430,148054,3376,2.2,"St. Johns County, FL"
118,2022,Nov,150322,146958,3364,2.2,"St. Johns County, FL"
119,2022,Dec,151932,149088,2844,1.9,"St. Johns County, FL"
120,2023,Jan,152243,148830,3413,2.2,"St. Johns County, FL"
121,2023,Feb,153818,150382,3436,2.2,"St. Johns County, FL"
122,2023,Mar,154630,151127,3503,2.3,"St. Johns County, FL"
123,2023,Apr,154153,150999,3154,2.0,"St. Johns County, FL"
124,2023,May,155486,151842,3644,2.3,"St. Johns County, FL"
125,2023,Jun,158073,153933,4140,2.6,"St. Johns County, FL"
126,2023,Jul,158071,153789,4282,2.7,"St. Johns County, FL"
127,2023,Aug,159231,154855,4376,2.7,"St. Johns County, FL"
128,2023,Sep,159485,155115,4370,2.7,"St. Johns County, FL"
129,2023,Oct,159763,155276,4487,2.8,"St. Johns County, FL"
0,2013,Jan,257844,233167,24677,9.6,"Brevard County, FL"
1,2013,Feb,256357,233385,22972,9.0,"Brevard County, FL"
2,2013,Mar,256094,234033,22061,8.6,"Brevard County, FL"
3,2013,Apr,255980,234405,21575,8.4,"Brevard County, FL"
4,2013,May,259528,237179,22349,8.6,"Brevard County, FL"
5,2013,Jun,261558,237863,23695,9.1,"Brevard County, FL"
6,2013,Jul,262218,238916,23302,8.9,"Brevard County, FL"
7,2013,Aug,260742,237848,22894,8.8,"Brevard County, FL"
8,2013,Sep,260772,238752,22020,8.4,"Brevard County, FL"
9,2013,Oct,257623,235606,22017,8.5,"Brevard County, FL"
10,2013,Nov,255025,234236,20789,8.2,"Brevard County, FL"
11,2013,Dec,254147,234456,19691,7.7,"Brevard County, FL"
12,2014,Jan,254948,234411,20537,8.1,"Brevard County, FL"
13,2014,Feb,255971,236098,19873,7.8,"Brevard County, FL"
14,2014,Mar,256975,237498,19477,7.6,"Brevard County, FL"
15,2014,Apr,255521,237831,17690,6.9,"Brevard County, FL"
16,2014,May,258506,239932,18574,7.2,"Brevard County, FL"
17,2014,Jun,259666,240787,18879,7.3,"Brevard County, FL"
18,2014,Jul,261020,241475,19545,7.5,"Brevard County, FL"
19,2014,Aug,259571,240495,19076,7.3,"Brevard County, FL"
20,2014,Sep,260177,242526,17651,6.8,"Brevard County, FL"
21,2014,Oct,258014,240721,17293,6.7,"Brevard County, FL"
22,2014,Nov,255427,238207,17220,6.7,"Brevard County, FL"
23,2014,Dec,255037,238897,16140,6.3,"Brevard County, FL"
24,2015,Jan,256244,238842,17402,6.8,"Brevard County, FL"
25,2015,Feb,255925,239729,16196,6.3,"Brevard County, FL"
26,2015,Mar,255950,240538,15412,6.0,"Brevard County, FL"
27,2015,Apr,255628,240650,14978,5.9,"Brevard County, FL"
28,2015,May,259309,243361,15948,6.2,"Brevard County, FL"
29,2015,Jun,260045,243852,16193,6.2,"Brevard County, FL"
30,2015,Jul,260704,244194,16510,6.3,"Brevard County, FL"
31,2015,Aug,259537,243754,15783,6.1,"Brevard County, FL"
32,2015,Sep,258598,243582,15016,5.8,"Brevard County, FL"
33,2015,Oct,257273,242432,14841,5.8,"Brevard County, FL"
34,2015,Nov,255253,240583,14670,5.7,"Brevard County, FL"
35,2015,Dec,255016,241065,13951,5.5,"Brevard County, FL"
36,2016,Jan,258012,243544,14468,5.6,"Brevard County, FL"
37,2016,Feb,258775,245021,13754,5.3,"Brevard County, FL"
38,2016,Mar,258992,245368,13624,5.3,"Brevard County, FL"
39,2016,Apr,259604,246487,13117,5.1,"Brevard County, FL"
40,2016,May,262911,250029,12882,4.9,"Brevard County, FL"
41,2016,Jun,265551,251441,14110,5.3,"Brevard County, FL"
42,2016,Jul,267601,253297,14304,5.3,"Brevard County, FL"
43,2016,Aug,267124,252921,14203,5.3,"Brevard County, FL"
44,2016,Sep,268963,255048,13915,5.2,"Brevard County, FL"
45,2016,Oct,265723,252266,13457,5.1,"Brevard County, FL"
46,2016,Nov,263800,250866,12934,4.9,"Brevard County, FL"
47,2016,Dec,263967,251518,12449,4.7,"Brevard County, FL"
48,2017,Jan,263787,250254,13533,5.1,"Brevard County, FL"
49,2017,Feb,265061,252574,12487,4.7,"Brevard County, FL"
50,2017,Mar,264679,252954,11725,4.4,"Brevard County, FL"
51,2017,Apr,264406,253295,11111,4.2,"Brevard County, FL"
52,2017,May,266349,254990,11359,4.3,"Brevard County, FL"
53,2017,Jun,269275,257062,12213,4.5,"Brevard County, FL"
54,2017,Jul,270145,257697,12448,4.6,"Brevard County, FL"
55,2017,Aug,268352,255898,12454,4.6,"Brevard County, FL"
56,2017,Sep,267788,256346,11442,4.3,"Brevard County, FL"
57,2017,Oct,267852,256867,10985,4.1,"Brevard County, FL"
58,2017,Nov,266717,255851,10866,4.1,"Brevard County, FL"
59,2017,Dec,266859,256701,10158,3.8,"Brevard County, FL"
60,2018,Jan,268822,257606,11216,4.2,"Brevard County, FL"
61,2018,Feb,270289,259972,10317,3.8,"Brevard County, FL"
62,2018,Mar,271755,261736,10019,3.7,"Brevard County, FL"
63,2018,Apr,270947,261571,9376,3.5,"Brevard County, FL"
64,2018,May,273954,264632,9322,3.4,"Brevard County, FL"
65,2018,Jun,277670,266889,10781,3.9,"Brevard County, FL"
66,2018,Jul,279097,268526,10571,3.8,"Brevard County, FL"
67,2018,Aug,276901,266631,10270,3.7,"Brevard County, FL"
68,2018,Sep,278230,268773,9457,3.4,"Brevard County, FL"
69,2018,Oct,278489,268965,9524,3.4,"Brevard County, FL"
70,2018,Nov,276180,267014,9166,3.3,"Brevard County, FL"
71,2018,Dec,276586,267452,9134,3.3,"Brevard County, FL"
72,2019,Jan,276554,265840,10714,3.9,"Brevard County, FL"
73,2019,Feb,276941,267514,9427,3.4,"Brevard County, FL"
74,2019,Mar,277190,268007,9183,3.3,"Brevard County, FL"
75,2019,Apr,277976,269654,8322,3.0,"Brevard County, FL"
76,2019,May,280659,271972,8687,3.1,"Brevard County, FL"
77,2019,Jun,284067,274155,9912,3.5,"Brevard County, FL"
78,2019,Jul,286015,275928,10087,3.5,"Brevard County, FL"
79,2019,Aug,286011,276056,9955,3.5,"Brevard County, FL"
80,2019,Sep,286149,277211,8938,3.1,"Brevard County, FL"
81,2019,Oct,285727,276784,8943,3.1,"Brevard County, FL"
82,2019,Nov,284181,275609,8572,3.0,"Brevard County, FL"
83,2019,Dec,283943,275964,7979,2.8,"Brevard County, FL"
84,2020,Jan,284188,274892,9296,3.3,"Brevard County, FL"
85,2020,Feb,283628,275674,7954,2.8,"Brevard County, FL"
86,2020,Mar,279458,267767,11691,4.2,"Brevard County, FL"
87,2020,Apr,261597,230149,31448,12.0,"Brevard County, FL"
88,2020,May,280316,246781,33535,12.0,"Brevard County, FL"
89,2020,Jun,282574,255615,26959,9.5,"Brevard County, FL"
90,2020,Jul,287972,258690,29282,10.2,"Brevard County, FL"
91,2020,Aug,285557,265032,20525,7.2,"Brevard County, FL"
92,2020,Sep,286218,266933,19285,6.7,"Brevard County, FL"
93,2020,Oct,285486,269030,16456,5.8,"Brevard County, FL"
94,2020,Nov,283246,267771,15475,5.5,"Brevard County, FL"
95,2020,Dec,282591,268106,14485,5.1,"Brevard County, FL"
96,2021,Jan,284932,269876,15056,5.3,"Brevard County, FL"
97,2021,Feb,286365,272339,14026,4.9,"Brevard County, FL"
98,2021,Mar,287260,274619,12641,4.4,"Brevard County, FL"
99,2021,Apr,287353,275452,11901,4.1,"Brevard County, FL"
100,2021,May,288553,276971,11582,4.0,"Brevard County, FL"
101,2021,Jun,292833,279470,13363,4.6,"Brevard County, FL"
102,2021,Jul,293360,280871,12489,4.3,"Brevard County, FL"
103,2021,Aug,292611,280479,12132,4.1,"Brevard County, FL"
104,2021,Sep,293905,282822,11083,3.8,"Brevard County, FL"
105,2021,Oct,291071,280576,10495,3.6,"Brevard County, FL"
106,2021,Nov,290039,280147,9892,3.4,"Brevard County, FL"
107,2021,Dec,289531,280865,8666,3.0,"Brevard County, FL"
108,2022,Jan,292461,281806,10655,3.6,"Brevard County, FL"
109,2022,Feb,292824,283501,9323,3.2,"Brevard County, FL"
110,2022,Mar,294168,285730,8438,2.9,"Brevard County, FL"
111,2022,Apr,292727,285085,7642,2.6,"Brevard County, FL"
112,2022,May,295209,287269,7940,2.7,"Brevard County, FL"
113,2022,Jun,297788,288626,9162,3.1,"Brevard County, FL"
114,2022,Jul,298037,289352,8685,2.9,"Brevard County, FL"
115,2022,Aug,298450,289715,8735,2.9,"Brevard County, FL"
116,2022,Sep,300191,292200,7991,2.7,"Brevard County, FL"
117,2022,Oct,298815,290785,8030,2.7,"Brevard County, FL"
118,2022,Nov,298189,290374,7815,2.6,"Brevard County, FL"
119,2022,Dec,299634,292704,6930,2.3,"Brevard County, FL"
120,2023,Jan,298829,290916,7913,2.6,"Brevard County, FL"
121,2023,Feb,300358,292565,7793,2.6,"Brevard County, FL"
122,2023,Mar,301917,293939,7978,2.6,"Brevard County, FL"
123,2023,Apr,301611,294518,7093,2.4,"Brevard County, FL"
124,2023,May,302684,294370,8314,2.7,"Brevard County, FL"
125,2023,Jun,307170,298013,9157,3.0,"Brevard County, FL"
126,2023,Jul,307947,298330,9617,3.1,"Brevard County, FL"
127,2023,Aug,309210,299278,9932,3.2,"Brevard County, FL"
128,2023,Sep,310192,300266,9926,3.2,"Brevard County, FL"
129,2023,Oct,308120,298144,9976,3.2,"Brevard County, FL"
0,2013,Jan,28674,24131,4543,15.8,"Yuba County, CA"
1,2013,Feb,28573,24245,4328,15.1,"Yuba County, CA"
2,2013,Mar,28583,24412,4171,14.6,"Yuba County, CA"
3,2013,Apr,28133,24329,3804,13.5,"Yuba County, CA"
4,2013,May,27980,24368,3612,12.9,"Yuba County, CA"
5,2013,Jun,28346,24478,3868,13.6,"Yuba County, CA"
6,2013,Jul,28029,24288,3741,13.3,"Yuba County, CA"
7,2013,Aug,28123,24628,3495,12.4,"Yuba County, CA"
8,2013,Sep,27970,24601,3369,12.0,"Yuba County, CA"
9,2013,Oct,27975,24644,3331,11.9,"Yuba County, CA"
10,2013,Nov,27887,24499,3388,12.1,"Yuba County, CA"
11,2013,Dec,27724,24346,3378,12.2,"Yuba County, CA"
12,2014,Jan,28001,24276,3725,13.3,"Yuba County, CA"
13,2014,Feb,28218,24416,3802,13.5,"Yuba County, CA"
14,2014,Mar,28391,24555,3836,13.5,"Yuba County, CA"
15,2014,Apr,27872,24564,3308,11.9,"Yuba County, CA"
16,2014,May,27909,24908,3001,10.8,"Yuba County, CA"
17,2014,Jun,28014,24889,3125,11.2,"Yuba County, CA"
18,2014,Jul,27679,24511,3168,11.4,"Yuba County, CA"
19,2014,Aug,28016,25057,2959,10.6,"Yuba County, CA"
20,2014,Sep,27684,24999,2685,9.7,"Yuba County, CA"
21,2014,Oct,27619,24968,2651,9.6,"Yuba County, CA"
22,2014,Nov,27521,24741,2780,10.1,"Yuba County, CA"
23,2014,Dec,27316,24471,2845,10.4,"Yuba County, CA"
24,2015,Jan,27454,24310,3144,11.5,"Yuba County, CA"
25,2015,Feb,27460,24424,3036,11.1,"Yuba County, CA"
26,2015,Mar,27729,24773,2956,10.7,"Yuba County, CA"
27,2015,Apr,27515,24873,2642,9.6,"Yuba County, CA"
28,2015,May,27761,25231,2530,9.1,"Yuba County, CA"
29,2015,Jun,27823,25210,2613,9.4,"Yuba County, CA"
30,2015,Jul,27870,25316,2554,9.2,"Yuba County, CA"
31,2015,Aug,28136,25795,2341,8.3,"Yuba County, CA"
32,2015,Sep,27761,25605,2156,7.8,"Yuba County, CA"
33,2015,Oct,27775,25574,2201,7.9,"Yuba County, CA"
34,2015,Nov,27677,25267,2410,8.7,"Yuba County, CA"
35,2015,Dec,27747,25242,2505,9.0,"Yuba County, CA"
36,2016,Jan,27871,25052,2819,10.1,"Yuba County, CA"
37,2016,Feb,28097,25347,2750,9.8,"Yuba County, CA"
38,2016,Mar,28324,25460,2864,10.1,"Yuba County, CA"
39,2016,Apr,27823,25371,2452,8.8,"Yuba County, CA"
40,2016,May,27882,25716,2166,7.8,"Yuba County, CA"
41,2016,Jun,28362,25937,2425,8.6,"Yuba County, CA"
42,2016,Jul,28285,25882,2403,8.5,"Yuba County, CA"
43,2016,Aug,28444,26193,2251,7.9,"Yuba County, CA"
44,2016,Sep,28503,26325,2178,7.6,"Yuba County, CA"
45,2016,Oct,28176,26013,2163,7.7,"Yuba County, CA"
46,2016,Nov,28037,25825,2212,7.9,"Yuba County, CA"
47,2016,Dec,28031,25547,2484,8.9,"Yuba County, CA"
48,2017,Jan,28735,26025,2710,9.4,"Yuba County, CA"
49,2017,Feb,28724,25974,2750,9.6,"Yuba County, CA"
50,2017,Mar,28928,26396,2532,8.8,"Yuba County, CA"
51,2017,Apr,28691,26413,2278,7.9,"Yuba County, CA"
52,2017,May,28685,26697,1988,6.9,"Yuba County, CA"
53,2017,Jun,28862,26764,2098,7.3,"Yuba County, CA"
54,2017,Jul,28642,26515,2127,7.4,"Yuba County, CA"
55,2017,Aug,28817,26788,2029,7.0,"Yuba County, CA"
56,2017,Sep,28884,27092,1792,6.2,"Yuba County, CA"
57,2017,Oct,28639,26914,1725,6.0,"Yuba County, CA"
58,2017,Nov,28550,26741,1809,6.3,"Yuba County, CA"
59,2017,Dec,28459,26521,1938,6.8,"Yuba County, CA"
60,2018,Jan,28860,26647,2213,7.7,"Yuba County, CA"
61,2018,Feb,29131,26931,2200,7.6,"Yuba County, CA"
62,2018,Mar,29282,27074,2208,7.5,"Yuba County, CA"
63,2018,Apr,28999,27108,1891,6.5,"Yuba County, CA"
64,2018,May,29189,27552,1637,5.6,"Yuba County, CA"
65,2018,Jun,29494,27591,1903,6.5,"Yuba County, CA"
66,2018,Jul,29295,27409,1886,6.4,"Yuba County, CA"
67,2018,Aug,29597,27834,1763,6.0,"Yuba County, CA"
68,2018,Sep,29429,27813,1616,5.5,"Yuba County, CA"
69,2018,Oct,29416,27777,1639,5.6,"Yuba County, CA"
70,2018,Nov,29138,27417,1721,5.9,"Yuba County, CA"
71,2018,Dec,29045,27111,1934,6.7,"Yuba County, CA"
72,2019,Jan,29565,27187,2378,8.0,"Yuba County, CA"
73,2019,Feb,29650,27422,2228,7.5,"Yuba County, CA"
74,2019,Mar,29799,27607,2192,7.4,"Yuba County, CA"
75,2019,Apr,29332,27519,1813,6.2,"Yuba County, CA"
76,2019,May,29408,27814,1594,5.4,"Yuba County, CA"
77,2019,Jun,29643,27881,1762,5.9,"Yuba County, CA"
78,2019,Jul,29674,27854,1820,6.1,"Yuba County, CA"
79,2019,Aug,30003,28286,1717,5.7,"Yuba County, CA"
80,2019,Sep,29856,28356,1500,5.0,"Yuba County, CA"
81,2019,Oct,30322,28766,1556,5.1,"Yuba County, CA"
82,2019,Nov,30122,28484,1638,5.4,"Yuba County, CA"
83,2019,Dec,30197,28405,1792,5.9,"Yuba County, CA"
84,2020,Jan,30813,28586,2227,7.2,"Yuba County, CA"
85,2020,Feb,31157,29010,2147,6.9,"Yuba County, CA"
86,2020,Mar,31501,28457,3044,9.7,"Yuba County, CA"
87,2020,Apr,30820,25766,5054,16.4,"Yuba County, CA"
88,2020,May,30270,25830,4440,14.7,"Yuba County, CA"
89,2020,Jun,31128,27271,3857,12.4,"Yuba County, CA"
90,2020,Jul,30986,27212,3774,12.2,"Yuba County, CA"
91,2020,Aug,30718,27585,3133,10.2,"Yuba County, CA"
92,2020,Sep,30677,27617,3060,10.0,"Yuba County, CA"
93,2020,Oct,30406,27632,2774,9.1,"Yuba County, CA"
94,2020,Nov,30398,27524,2874,9.5,"Yuba County, CA"
95,2020,Dec,30401,27433,2968,9.8,"Yuba County, CA"
96,2021,Jan,30453,27320,3133,10.3,"Yuba County, CA"
97,2021,Feb,30741,27567,3174,10.3,"Yuba County, CA"
98,2021,Mar,30736,27622,3114,10.1,"Yuba County, CA"
99,2021,Apr,30743,27879,2864,9.3,"Yuba County, CA"
100,2021,May,30853,28218,2635,8.5,"Yuba County, CA"
101,2021,Jun,31386,28501,2885,9.2,"Yuba County, CA"
102,2021,Jul,31169,28416,2753,8.8,"Yuba County, CA"
103,2021,Aug,31056,28505,2551,8.2,"Yuba County, CA"
104,2021,Sep,31297,29104,2193,7.0,"Yuba County, CA"
105,2021,Oct,31199,29077,2122,6.8,"Yuba County, CA"
106,2021,Nov,31104,29100,2004,6.4,"Yuba County, CA"
107,2021,Dec,31018,29113,1905,6.1,"Yuba County, CA"
108,2022,Jan,31020,28739,2281,7.4,"Yuba County, CA"
109,2022,Feb,31367,29268,2099,6.7,"Yuba County, CA"
110,2022,Mar,31505,29622,1883,6.0,"Yuba County, CA"
111,2022,Apr,31139,29531,1608,5.2,"Yuba County, CA"
112,2022,May,31515,30056,1459,4.6,"Yuba County, CA"
113,2022,Jun,31572,29927,1645,5.2,"Yuba County, CA"
114,2022,Jul,31439,29805,1634,5.2,"Yuba County, CA"
115,2022,Aug,31869,30232,1637,5.1,"Yuba County, CA"
116,2022,Sep,32027,30533,1494,4.7,"Yuba County, CA"
117,2022,Oct,31829,30245,1584,5.0,"Yuba County, CA"
118,2022,Nov,31830,30087,1743,5.5,"Yuba County, CA"
119,2022,Dec,32034,30226,1808,5.6,"Yuba County, CA"
120,2023,Jan,31906,29621,2285,7.2,"Yuba County, CA"
121,2023,Feb,32362,29967,2395,7.4,"Yuba County, CA"
122,2023,Mar,32743,30201,2542,7.8,"Yuba County, CA"
123,2023,Apr,32174,30099,2075,6.4,"Yuba County, CA"
124,2023,May,32264,30240,2024,6.3,"Yuba County, CA"
125,2023,Jun,32180,30056,2124,6.6,"Yuba County, CA"
126,2023,Jul,32135,30156,1979,6.2,"Yuba County, CA"
127,2023,Aug,32213,30176,2037,6.3,"Yuba County, CA"
128,2023,Sep,32200,30327,1873,5.8,"Yuba County, CA"
129,2023,Oct,32169,30196,1973,6.1,"Yuba County, CA"
0,2013,Jan,27323,24873,2450,9.0,"Columbia County, FL"
1,2013,Feb,27563,25309,2254,8.2,"Columbia County, FL"
2,2013,Mar,27517,25350,2167,7.9,"Columbia County, FL"
3,2013,Apr,27462,25383,2079,7.6,"Columbia County, FL"
4,2013,May,27833,25668,2165,7.8,"Columbia County, FL"
5,2013,Jun,27764,25450,2314,8.3,"Columbia County, FL"
6,2013,Jul,27901,25630,2271,8.1,"Columbia County, FL"
7,2013,Aug,27985,25738,2247,8.0,"Columbia County, FL"
8,2013,Sep,28285,26103,2182,7.7,"Columbia County, FL"
9,2013,Oct,28132,25983,2149,7.6,"Columbia County, FL"
10,2013,Nov,28096,25992,2104,7.5,"Columbia County, FL"
11,2013,Dec,27797,25801,1996,7.2,"Columbia County, FL"
12,2014,Jan,27640,25517,2123,7.7,"Columbia County, FL"
13,2014,Feb,27811,25761,2050,7.4,"Columbia County, FL"
14,2014,Mar,27799,25770,2029,7.3,"Columbia County, FL"
15,2014,Apr,27913,26085,1828,6.5,"Columbia County, FL"
16,2014,May,28419,26471,1948,6.9,"Columbia County, FL"
17,2014,Jun,28314,26307,2007,7.1,"Columbia County, FL"
18,2014,Jul,28561,26489,2072,7.3,"Columbia County, FL"
19,2014,Aug,28572,26544,2028,7.1,"Columbia County, FL"
20,2014,Sep,29012,27134,1878,6.5,"Columbia County, FL"
21,2014,Oct,28830,27024,1806,6.3,"Columbia County, FL"
22,2014,Nov,28517,26725,1792,6.3,"Columbia County, FL"
23,2014,Dec,28464,26782,1682,5.9,"Columbia County, FL"
24,2015,Jan,28439,26608,1831,6.4,"Columbia County, FL"
25,2015,Feb,28395,26701,1694,6.0,"Columbia County, FL"
26,2015,Mar,28577,26966,1611,5.6,"Columbia County, FL"
27,2015,Apr,28651,27083,1568,5.5,"Columbia County, FL"
28,2015,May,29250,27566,1684,5.8,"Columbia County, FL"
29,2015,Jun,29065,27371,1694,5.8,"Columbia County, FL"
30,2015,Jul,28934,27244,1690,5.8,"Columbia County, FL"
31,2015,Aug,29374,27769,1605,5.5,"Columbia County, FL"
32,2015,Sep,29645,28113,1532,5.2,"Columbia County, FL"
33,2015,Oct,29700,28187,1513,5.1,"Columbia County, FL"
34,2015,Nov,29429,27917,1512,5.1,"Columbia County, FL"
35,2015,Dec,29614,28167,1447,4.9,"Columbia County, FL"
36,2016,Jan,29489,27935,1554,5.3,"Columbia County, FL"
37,2016,Feb,29620,28164,1456,4.9,"Columbia County, FL"
38,2016,Mar,29780,28342,1438,4.8,"Columbia County, FL"
39,2016,Apr,29835,28454,1381,4.6,"Columbia County, FL"
40,2016,May,29923,28524,1399,4.7,"Columbia County, FL"
41,2016,Jun,29677,28152,1525,5.1,"Columbia County, FL"
42,2016,Jul,29816,28285,1531,5.1,"Columbia County, FL"
43,2016,Aug,29977,28456,1521,5.1,"Columbia County, FL"
44,2016,Sep,30403,28880,1523,5.0,"Columbia County, FL"
45,2016,Oct,30229,28744,1485,4.9,"Columbia County, FL"
46,2016,Nov,29848,28426,1422,4.8,"Columbia County, FL"
47,2016,Dec,29675,28278,1397,4.7,"Columbia County, FL"
48,2017,Jan,29389,27883,1506,5.1,"Columbia County, FL"
49,2017,Feb,29502,28123,1379,4.7,"Columbia County, FL"
50,2017,Mar,29059,27785,1274,4.4,"Columbia County, FL"
51,2017,Apr,28826,27623,1203,4.2,"Columbia County, FL"
52,2017,May,28956,27716,1240,4.3,"Columbia County, FL"
53,2017,Jun,29351,28027,1324,4.5,"Columbia County, FL"
54,2017,Jul,28391,27037,1354,4.8,"Columbia County, FL"
55,2017,Aug,29117,27731,1386,4.8,"Columbia County, FL"
56,2017,Sep,29311,28081,1230,4.2,"Columbia County, FL"
57,2017,Oct,29273,28061,1212,4.1,"Columbia County, FL"
58,2017,Nov,28998,27766,1232,4.2,"Columbia County, FL"
59,2017,Dec,28998,27834,1164,4.0,"Columbia County, FL"
60,2018,Jan,29105,27845,1260,4.3,"Columbia County, FL"
61,2018,Feb,29193,28013,1180,4.0,"Columbia County, FL"
62,2018,Mar,29140,28015,1125,3.9,"Columbia County, FL"
63,2018,Apr,29070,28028,1042,3.6,"Columbia County, FL"
64,2018,May,29047,28007,1040,3.6,"Columbia County, FL"
65,2018,Jun,29375,28142,1233,4.2,"Columbia County, FL"
66,2018,Jul,28515,27250,1265,4.4,"Columbia County, FL"
67,2018,Aug,29246,28040,1206,4.1,"Columbia County, FL"
68,2018,Sep,29575,28504,1071,3.6,"Columbia County, FL"
69,2018,Oct,29928,28839,1089,3.6,"Columbia County, FL"
70,2018,Nov,29304,28263,1041,3.6,"Columbia County, FL"
71,2018,Dec,29283,28262,1021,3.5,"Columbia County, FL"
72,2019,Jan,29277,28107,1170,4.0,"Columbia County, FL"
73,2019,Feb,29222,28204,1018,3.5,"Columbia County, FL"
74,2019,Mar,29125,28157,968,3.3,"Columbia County, FL"
75,2019,Apr,29131,28258,873,3.0,"Columbia County, FL"
76,2019,May,29289,28335,954,3.3,"Columbia County, FL"
77,2019,Jun,29733,28645,1088,3.7,"Columbia County, FL"
78,2019,Jul,29238,28114,1124,3.8,"Columbia County, FL"
79,2019,Aug,29996,28926,1070,3.6,"Columbia County, FL"
80,2019,Sep,30307,29337,970,3.2,"Columbia County, FL"
81,2019,Oct,30255,29320,935,3.1,"Columbia County, FL"
82,2019,Nov,30144,29260,884,2.9,"Columbia County, FL"
83,2019,Dec,29978,29146,832,2.8,"Columbia County, FL"
84,2020,Jan,29680,28702,978,3.3,"Columbia County, FL"
85,2020,Feb,29705,28854,851,2.9,"Columbia County, FL"
86,2020,Mar,29285,28045,1240,4.2,"Columbia County, FL"
87,2020,Apr,26955,24613,2342,8.7,"Columbia County, FL"
88,2020,May,28816,26344,2472,8.6,"Columbia County, FL"
89,2020,Jun,29567,27318,2249,7.6,"Columbia County, FL"
90,2020,Jul,29432,26681,2751,9.3,"Columbia County, FL"
91,2020,Aug,29898,27889,2009,6.7,"Columbia County, FL"
92,2020,Sep,30055,28076,1979,6.6,"Columbia County, FL"
93,2020,Oct,30370,28530,1840,6.1,"Columbia County, FL"
94,2020,Nov,30187,28410,1777,5.9,"Columbia County, FL"
95,2020,Dec,29802,28124,1678,5.6,"Columbia County, FL"
96,2021,Jan,29448,27830,1618,5.5,"Columbia County, FL"
97,2021,Feb,29224,27741,1483,5.1,"Columbia County, FL"
98,2021,Mar,29178,27746,1432,4.9,"Columbia County, FL"
99,2021,Apr,29373,28017,1356,4.6,"Columbia County, FL"
100,2021,May,29570,28257,1313,4.4,"Columbia County, FL"
101,2021,Jun,29391,27861,1530,5.2,"Columbia County, FL"
102,2021,Jul,29241,27796,1445,4.9,"Columbia County, FL"
103,2021,Aug,29273,27880,1393,4.8,"Columbia County, FL"
104,2021,Sep,29420,28155,1265,4.3,"Columbia County, FL"
105,2021,Oct,29531,28315,1216,4.1,"Columbia County, FL"
106,2021,Nov,29451,28294,1157,3.9,"Columbia County, FL"
107,2021,Dec,29348,28323,1025,3.5,"Columbia County, FL"
108,2022,Jan,29711,28487,1224,4.1,"Columbia County, FL"
109,2022,Feb,29667,28579,1088,3.7,"Columbia County, FL"
110,2022,Mar,29702,28736,966,3.3,"Columbia County, FL"
111,2022,Apr,29546,28668,878,3.0,"Columbia County, FL"
112,2022,May,29632,28720,912,3.1,"Columbia County, FL"
113,2022,Jun,29427,28376,1051,3.6,"Columbia County, FL"
114,2022,Jul,29183,28201,982,3.4,"Columbia County, FL"
115,2022,Aug,29389,28407,982,3.3,"Columbia County, FL"
116,2022,Sep,29678,28801,877,3.0,"Columbia County, FL"
117,2022,Oct,29774,28894,880,3.0,"Columbia County, FL"
118,2022,Nov,29518,28688,830,2.8,"Columbia County, FL"
119,2022,Dec,29548,28824,724,2.5,"Columbia County, FL"
120,2023,Jan,29474,28654,820,2.8,"Columbia County, FL"
121,2023,Feb,29706,28861,845,2.8,"Columbia County, FL"
122,2023,Mar,29834,29008,826,2.8,"Columbia County, FL"
123,2023,Apr,29749,28970,779,2.6,"Columbia County, FL"
124,2023,May,29912,29035,877,2.9,"Columbia County, FL"
125,2023,Jun,30452,29426,1026,3.4,"Columbia County, FL"
126,2023,Jul,30321,29249,1072,3.5,"Columbia County, FL"
127,2023,Aug,30635,29540,1095,3.6,"Columbia County, FL"
128,2023,Sep,30805,29725,1080,3.5,"Columbia County, FL"
129,2023,Oct,30955,29855,1100,3.6,"Columbia County, FL"
0,2013,Jan,22032,19102,2930,13.3,"Tuolumne County, CA"
1,2013,Feb,21889,19146,2743,12.5,"Tuolumne County, CA"
2,2013,Mar,21694,19057,2637,12.2,"Tuolumne County, CA"
3,2013,Apr,21542,19141,2401,11.1,"Tuolumne County, CA"
4,2013,May,21792,19522,2270,10.4,"Tuolumne County, CA"
5,2013,Jun,22014,19634,2380,10.8,"Tuolumne County, CA"
6,2013,Jul,21902,19583,2319,10.6,"Tuolumne County, CA"
7,2013,Aug,21668,19460,2208,10.2,"Tuolumne County, CA"
8,2013,Sep,21633,19498,2135,9.9,"Tuolumne County, CA"
9,2013,Oct,21406,19254,2152,10.1,"Tuolumne County, CA"
10,2013,Nov,21347,19213,2134,10.0,"Tuolumne County, CA"
11,2013,Dec,21215,19152,2063,9.7,"Tuolumne County, CA"
12,2014,Jan,21208,18964,2244,10.6,"Tuolumne County, CA"
13,2014,Feb,21698,19422,2276,10.5,"Tuolumne County, CA"
14,2014,Mar,21615,19358,2257,10.4,"Tuolumne County, CA"
15,2014,Apr,21239,19325,1914,9.0,"Tuolumne County, CA"
16,2014,May,21563,19753,1810,8.4,"Tuolumne County, CA"
17,2014,Jun,21731,19872,1859,8.6,"Tuolumne County, CA"
18,2014,Jul,21791,19871,1920,8.8,"Tuolumne County, CA"
19,2014,Aug,21428,19635,1793,8.4,"Tuolumne County, CA"
20,2014,Sep,21773,20128,1645,7.6,"Tuolumne County, CA"
21,2014,Oct,21603,19963,1640,7.6,"Tuolumne County, CA"
22,2014,Nov,21464,19820,1644,7.7,"Tuolumne County, CA"
23,2014,Dec,21325,19703,1622,7.6,"Tuolumne County, CA"
24,2015,Jan,21450,19620,1830,8.5,"Tuolumne County, CA"
25,2015,Feb,21382,19616,1766,8.3,"Tuolumne County, CA"
26,2015,Mar,21419,19701,1718,8.0,"Tuolumne County, CA"
27,2015,Apr,21406,19858,1548,7.2,"Tuolumne County, CA"
28,2015,May,21755,20272,1483,6.8,"Tuolumne County, CA"
29,2015,Jun,21727,20196,1531,7.0,"Tuolumne County, CA"
30,2015,Jul,21771,20219,1552,7.1,"Tuolumne County, CA"
31,2015,Aug,21636,20210,1426,6.6,"Tuolumne County, CA"
32,2015,Sep,21578,20246,1332,6.2,"Tuolumne County, CA"
33,2015,Oct,21424,20067,1357,6.3,"Tuolumne County, CA"
34,2015,Nov,21456,20075,1381,6.4,"Tuolumne County, CA"
35,2015,Dec,21376,19979,1397,6.5,"Tuolumne County, CA"
36,2016,Jan,21498,19896,1602,7.5,"Tuolumne County, CA"
37,2016,Feb,21807,20272,1535,7.0,"Tuolumne County, CA"
38,2016,Mar,21875,20333,1542,7.0,"Tuolumne County, CA"
39,2016,Apr,21368,20003,1365,6.4,"Tuolumne County, CA"
40,2016,May,21462,20261,1201,5.6,"Tuolumne County, CA"
41,2016,Jun,21730,20392,1338,6.2,"Tuolumne County, CA"
42,2016,Jul,21854,20502,1352,6.2,"Tuolumne County, CA"
43,2016,Aug,21649,20355,1294,6.0,"Tuolumne County, CA"
44,2016,Sep,21623,20404,1219,5.6,"Tuolumne County, CA"
45,2016,Oct,21480,20272,1208,5.6,"Tuolumne County, CA"
46,2016,Nov,21348,20143,1205,5.6,"Tuolumne County, CA"
47,2016,Dec,21111,19822,1289,6.1,"Tuolumne County, CA"
48,2017,Jan,21153,19709,1444,6.8,"Tuolumne County, CA"
49,2017,Feb,21448,20022,1426,6.6,"Tuolumne County, CA"
50,2017,Mar,21406,20070,1336,6.2,"Tuolumne County, CA"
51,2017,Apr,21230,20041,1189,5.6,"Tuolumne County, CA"
52,2017,May,21151,20092,1059,5.0,"Tuolumne County, CA"
53,2017,Jun,21547,20413,1134,5.3,"Tuolumne County, CA"
54,2017,Jul,21746,20568,1178,5.4,"Tuolumne County, CA"
55,2017,Aug,21542,20404,1138,5.3,"Tuolumne County, CA"
56,2017,Sep,21515,20503,1012,4.7,"Tuolumne County, CA"
57,2017,Oct,21381,20389,992,4.6,"Tuolumne County, CA"
58,2017,Nov,21220,20229,991,4.7,"Tuolumne County, CA"
59,2017,Dec,21083,20058,1025,4.9,"Tuolumne County, CA"
60,2018,Jan,20873,19707,1166,5.6,"Tuolumne County, CA"
61,2018,Feb,21333,20132,1201,5.6,"Tuolumne County, CA"
62,2018,Mar,21208,20071,1137,5.4,"Tuolumne County, CA"
63,2018,Apr,21008,20011,997,4.7,"Tuolumne County, CA"
64,2018,May,20962,20095,867,4.1,"Tuolumne County, CA"
65,2018,Jun,21320,20327,993,4.7,"Tuolumne County, CA"
66,2018,Jul,21455,20485,970,4.5,"Tuolumne County, CA"
67,2018,Aug,21078,20146,932,4.4,"Tuolumne County, CA"
68,2018,Sep,21299,20439,860,4.0,"Tuolumne County, CA"
69,2018,Oct,21297,20419,878,4.1,"Tuolumne County, CA"
70,2018,Nov,21174,20277,897,4.2,"Tuolumne County, CA"
71,2018,Dec,21245,20264,981,4.6,"Tuolumne County, CA"
72,2019,Jan,21053,19831,1222,5.8,"Tuolumne County, CA"
73,2019,Feb,21241,20068,1173,5.5,"Tuolumne County, CA"
74,2019,Mar,21298,20116,1182,5.5,"Tuolumne County, CA"
75,2019,Apr,20846,19891,955,4.6,"Tuolumne County, CA"
76,2019,May,20853,20023,830,4.0,"Tuolumne County, CA"
77,2019,Jun,21008,20072,936,4.5,"Tuolumne County, CA"
78,2019,Jul,21269,20297,972,4.6,"Tuolumne County, CA"
79,2019,Aug,21061,20163,898,4.3,"Tuolumne County, CA"
80,2019,Sep,21022,20242,780,3.7,"Tuolumne County, CA"
81,2019,Oct,20723,19902,821,4.0,"Tuolumne County, CA"
82,2019,Nov,20719,19880,839,4.0,"Tuolumne County, CA"
83,2019,Dec,20600,19730,870,4.2,"Tuolumne County, CA"
84,2020,Jan,20574,19507,1067,5.2,"Tuolumne County, CA"
85,2020,Feb,20815,19755,1060,5.1,"Tuolumne County, CA"
86,2020,Mar,20679,19161,1518,7.3,"Tuolumne County, CA"
87,2020,Apr,19949,15935,4014,20.1,"Tuolumne County, CA"
88,2020,May,19596,16067,3529,18.0,"Tuolumne County, CA"
89,2020,Jun,20389,17582,2807,13.8,"Tuolumne County, CA"
90,2020,Jul,20532,18023,2509,12.2,"Tuolumne County, CA"
91,2020,Aug,20332,18260,2072,10.2,"Tuolumne County, CA"
92,2020,Sep,20213,18291,1922,9.5,"Tuolumne County, CA"
93,2020,Oct,20019,18312,1707,8.5,"Tuolumne County, CA"
94,2020,Nov,19918,18229,1689,8.5,"Tuolumne County, CA"
95,2020,Dec,19661,17815,1846,9.4,"Tuolumne County, CA"
96,2021,Jan,19710,17783,1927,9.8,"Tuolumne County, CA"
97,2021,Feb,19792,17943,1849,9.3,"Tuolumne County, CA"
98,2021,Mar,20056,18303,1753,8.7,"Tuolumne County, CA"
99,2021,Apr,19983,18384,1599,8.0,"Tuolumne County, CA"
100,2021,May,20281,18859,1422,7.0,"Tuolumne County, CA"
101,2021,Jun,20561,18983,1578,7.7,"Tuolumne County, CA"
102,2021,Jul,20478,18977,1501,7.3,"Tuolumne County, CA"
103,2021,Aug,20548,19127,1421,6.9,"Tuolumne County, CA"
104,2021,Sep,20267,19060,1207,6.0,"Tuolumne County, CA"
105,2021,Oct,20021,18849,1172,5.9,"Tuolumne County, CA"
106,2021,Nov,19875,18795,1080,5.4,"Tuolumne County, CA"
107,2021,Dec,19649,18637,1012,5.2,"Tuolumne County, CA"
108,2022,Jan,19738,18531,1207,6.1,"Tuolumne County, CA"
109,2022,Feb,19792,18682,1110,5.6,"Tuolumne County, CA"
110,2022,Mar,19818,18831,987,5.0,"Tuolumne County, CA"
111,2022,Apr,19628,18801,827,4.2,"Tuolumne County, CA"
112,2022,May,19883,19137,746,3.8,"Tuolumne County, CA"
113,2022,Jun,19945,19103,842,4.2,"Tuolumne County, CA"
114,2022,Jul,19958,19109,849,4.3,"Tuolumne County, CA"
115,2022,Aug,20248,19394,854,4.2,"Tuolumne County, CA"
116,2022,Sep,19946,19194,752,3.8,"Tuolumne County, CA"
117,2022,Oct,20019,19212,807,4.0,"Tuolumne County, CA"
118,2022,Nov,19822,18976,846,4.3,"Tuolumne County, CA"
119,2022,Dec,19720,18905,815,4.1,"Tuolumne County, CA"
120,2023,Jan,19634,18573,1061,5.4,"Tuolumne County, CA"
121,2023,Feb,19961,18838,1123,5.6,"Tuolumne County, CA"
122,2023,Mar,20049,18914,1135,5.7,"Tuolumne County, CA"
123,2023,Apr,19297,18356,941,4.9,"Tuolumne County, CA"
124,2023,May,19627,18696,931,4.7,"Tuolumne County, CA"
125,2023,Jun,20091,19110,981,4.9,"Tuolumne County, CA"
126,2023,Jul,20281,19311,970,4.8,"Tuolumne County, CA"
127,2023,Aug,20301,19262,1039,5.1,"Tuolumne County, CA"
128,2023,Sep,20246,19300,946,4.7,"Tuolumne County, CA"
129,2023,Oct,20032,19079,953,4.8,"Tuolumne County, CA"
0,2013,Jan,16306,14730,1576,9.7,"Levy County, FL"
1,2013,Feb,16168,14725,1443,8.9,"Levy County, FL"
2,2013,Mar,16132,14775,1357,8.4,"Levy County, FL"
3,2013,Apr,16237,14894,1343,8.3,"Levy County, FL"
4,2013,May,16404,15032,1372,8.4,"Levy County, FL"
5,2013,Jun,16460,14986,1474,9.0,"Levy County, FL"
6,2013,Jul,16435,14927,1508,9.2,"Levy County, FL"
7,2013,Aug,16352,14945,1407,8.6,"Levy County, FL"
8,2013,Sep,16556,15205,1351,8.2,"Levy County, FL"
9,2013,Oct,16359,15023,1336,8.2,"Levy County, FL"
10,2013,Nov,16160,14881,1279,7.9,"Levy County, FL"
11,2013,Dec,16019,14812,1207,7.5,"Levy County, FL"
12,2014,Jan,16096,14803,1293,8.0,"Levy County, FL"
13,2014,Feb,16158,14929,1229,7.6,"Levy County, FL"
14,2014,Mar,16149,14957,1192,7.4,"Levy County, FL"
15,2014,Apr,16047,14972,1075,6.7,"Levy County, FL"
16,2014,May,16208,15052,1156,7.1,"Levy County, FL"
17,2014,Jun,16141,14970,1171,7.3,"Levy County, FL"
18,2014,Jul,16233,15013,1220,7.5,"Levy County, FL"
19,2014,Aug,16234,15039,1195,7.4,"Levy County, FL"
20,2014,Sep,16536,15430,1106,6.7,"Levy County, FL"
21,2014,Oct,16693,15628,1065,6.4,"Levy County, FL"
22,2014,Nov,16489,15426,1063,6.4,"Levy County, FL"
23,2014,Dec,16333,15333,1000,6.1,"Levy County, FL"
24,2015,Jan,16581,15476,1105,6.7,"Levy County, FL"
25,2015,Feb,16495,15489,1006,6.1,"Levy County, FL"
26,2015,Mar,16512,15548,964,5.8,"Levy County, FL"
27,2015,Apr,16479,15565,914,5.5,"Levy County, FL"
28,2015,May,16633,15652,981,5.9,"Levy County, FL"
29,2015,Jun,16400,15392,1008,6.1,"Levy County, FL"
30,2015,Jul,16416,15379,1037,6.3,"Levy County, FL"
31,2015,Aug,16442,15479,963,5.9,"Levy County, FL"
32,2015,Sep,16683,15777,906,5.4,"Levy County, FL"
33,2015,Oct,16666,15766,900,5.4,"Levy County, FL"
34,2015,Nov,16455,15552,903,5.5,"Levy County, FL"
35,2015,Dec,16365,15494,871,5.3,"Levy County, FL"
36,2016,Jan,16530,15590,940,5.7,"Levy County, FL"
37,2016,Feb,16664,15779,885,5.3,"Levy County, FL"
38,2016,Mar,16737,15876,861,5.1,"Levy County, FL"
39,2016,Apr,16625,15807,818,4.9,"Levy County, FL"
40,2016,May,16583,15797,786,4.7,"Levy County, FL"
41,2016,Jun,16459,15579,880,5.3,"Levy County, FL"
42,2016,Jul,16533,15598,935,5.7,"Levy County, FL"
43,2016,Aug,16685,15775,910,5.5,"Levy County, FL"
44,2016,Sep,16977,16087,890,5.2,"Levy County, FL"
45,2016,Oct,17061,16193,868,5.1,"Levy County, FL"
46,2016,Nov,16813,15967,846,5.0,"Levy County, FL"
47,2016,Dec,16754,15921,833,5.0,"Levy County, FL"
48,2017,Jan,16563,15672,891,5.4,"Levy County, FL"
49,2017,Feb,16657,15848,809,4.9,"Levy County, FL"
50,2017,Mar,16669,15913,756,4.5,"Levy County, FL"
51,2017,Apr,16767,16058,709,4.2,"Levy County, FL"
52,2017,May,16711,15971,740,4.4,"Levy County, FL"
53,2017,Jun,16585,15807,778,4.7,"Levy County, FL"
54,2017,Jul,16364,15564,800,4.9,"Levy County, FL"
55,2017,Aug,16518,15724,794,4.8,"Levy County, FL"
56,2017,Sep,16940,16220,720,4.3,"Levy County, FL"
57,2017,Oct,16859,16160,699,4.1,"Levy County, FL"
58,2017,Nov,16611,15913,698,4.2,"Levy County, FL"
59,2017,Dec,16530,15853,677,4.1,"Levy County, FL"
60,2018,Jan,16703,15952,751,4.5,"Levy County, FL"
61,2018,Feb,16857,16180,677,4.0,"Levy County, FL"
62,2018,Mar,16824,16167,657,3.9,"Levy County, FL"
63,2018,Apr,16827,16216,611,3.6,"Levy County, FL"
64,2018,May,16785,16175,610,3.6,"Levy County, FL"
65,2018,Jun,16649,15929,720,4.3,"Levy County, FL"
66,2018,Jul,16375,15669,706,4.3,"Levy County, FL"
67,2018,Aug,16514,15821,693,4.2,"Levy County, FL"
68,2018,Sep,16801,16156,645,3.8,"Levy County, FL"
69,2018,Oct,16910,16256,654,3.9,"Levy County, FL"
70,2018,Nov,16676,16050,626,3.8,"Levy County, FL"
71,2018,Dec,16543,15921,622,3.8,"Levy County, FL"
72,2019,Jan,16645,15894,751,4.5,"Levy County, FL"
73,2019,Feb,16677,16011,666,4.0,"Levy County, FL"
74,2019,Mar,16692,16033,659,3.9,"Levy County, FL"
75,2019,Apr,16588,16003,585,3.5,"Levy County, FL"
76,2019,May,16646,16035,611,3.7,"Levy County, FL"
77,2019,Jun,16480,15776,704,4.3,"Levy County, FL"
78,2019,Jul,16276,15581,695,4.3,"Levy County, FL"
79,2019,Aug,16657,15976,681,4.1,"Levy County, FL"
80,2019,Sep,16922,16319,603,3.6,"Levy County, FL"
81,2019,Oct,16752,16161,591,3.5,"Levy County, FL"
82,2019,Nov,16587,16019,568,3.4,"Levy County, FL"
83,2019,Dec,16491,15975,516,3.1,"Levy County, FL"
84,2020,Jan,16754,16131,623,3.7,"Levy County, FL"
85,2020,Feb,16746,16213,533,3.2,"Levy County, FL"
86,2020,Mar,16448,15676,772,4.7,"Levy County, FL"
87,2020,Apr,15348,13842,1506,9.8,"Levy County, FL"
88,2020,May,16260,14752,1508,9.3,"Levy County, FL"
89,2020,Jun,16113,14784,1329,8.2,"Levy County, FL"
90,2020,Jul,16289,14814,1475,9.1,"Levy County, FL"
91,2020,Aug,16604,15551,1053,6.3,"Levy County, FL"
92,2020,Sep,16946,15896,1050,6.2,"Levy County, FL"
93,2020,Oct,17006,16071,935,5.5,"Levy County, FL"
94,2020,Nov,16752,15826,926,5.5,"Levy County, FL"
95,2020,Dec,16769,15852,917,5.5,"Levy County, FL"
96,2021,Jan,16557,15633,924,5.6,"Levy County, FL"
97,2021,Feb,16624,15772,852,5.1,"Levy County, FL"
98,2021,Mar,16691,15874,817,4.9,"Levy County, FL"
99,2021,Apr,16947,16203,744,4.4,"Levy County, FL"
100,2021,May,17047,16310,737,4.3,"Levy County, FL"
101,2021,Jun,17017,16148,869,5.1,"Levy County, FL"
102,2021,Jul,16910,16081,829,4.9,"Levy County, FL"
103,2021,Aug,16936,16108,828,4.9,"Levy County, FL"
104,2021,Sep,17216,16482,734,4.3,"Levy County, FL"
105,2021,Oct,16857,16177,680,4.0,"Levy County, FL"
106,2021,Nov,16779,16113,666,4.0,"Levy County, FL"
107,2021,Dec,16758,16172,586,3.5,"Levy County, FL"
108,2022,Jan,17008,16269,739,4.3,"Levy County, FL"
109,2022,Feb,16967,16296,671,4.0,"Levy County, FL"
110,2022,Mar,17051,16445,606,3.6,"Levy County, FL"
111,2022,Apr,17070,16527,543,3.2,"Levy County, FL"
112,2022,May,17143,16579,564,3.3,"Levy County, FL"
113,2022,Jun,17053,16391,662,3.9,"Levy County, FL"
114,2022,Jul,16988,16361,627,3.7,"Levy County, FL"
115,2022,Aug,17060,16423,637,3.7,"Levy County, FL"
116,2022,Sep,17372,16812,560,3.2,"Levy County, FL"
117,2022,Oct,17281,16738,543,3.1,"Levy County, FL"
118,2022,Nov,17068,16543,525,3.1,"Levy County, FL"
119,2022,Dec,17052,16592,460,2.7,"Levy County, FL"
120,2023,Jan,17178,16651,527,3.1,"Levy County, FL"
121,2023,Feb,17262,16736,526,3.0,"Levy County, FL"
122,2023,Mar,17348,16818,530,3.1,"Levy County, FL"
123,2023,Apr,17308,16849,459,2.7,"Levy County, FL"
124,2023,May,17331,16802,529,3.1,"Levy County, FL"
125,2023,Jun,17333,16727,606,3.5,"Levy County, FL"
126,2023,Jul,17396,16725,671,3.9,"Levy County, FL"
127,2023,Aug,17715,17022,693,3.9,"Levy County, FL"
128,2023,Sep,17996,17292,704,3.9,"Levy County, FL"
129,2023,Oct,17860,17192,668,3.7,"Levy County, FL"
0,2013,Jan,44678,36777,7901,17.7,"Sutter County, CA"
1,2013,Feb,44808,36978,7830,17.5,"Sutter County, CA"
2,2013,Mar,45141,37565,7576,16.8,"Sutter County, CA"
3,2013,Apr,44710,37670,7040,15.7,"Sutter County, CA"
4,2013,May,45078,38416,6662,14.8,"Sutter County, CA"
5,2013,Jun,45338,38534,6804,15.0,"Sutter County, CA"
6,2013,Jul,45801,39563,6238,13.6,"Sutter County, CA"
7,2013,Aug,45954,40187,5767,12.5,"Sutter County, CA"
8,2013,Sep,44344,38816,5528,12.5,"Sutter County, CA"
9,2013,Oct,43509,37863,5646,13.0,"Sutter County, CA"
10,2013,Nov,43326,37240,6086,14.0,"Sutter County, CA"
11,2013,Dec,43337,37122,6215,14.3,"Sutter County, CA"
12,2014,Jan,43593,36913,6680,15.3,"Sutter County, CA"
13,2014,Feb,43983,37053,6930,15.8,"Sutter County, CA"
14,2014,Mar,44493,37417,7076,15.9,"Sutter County, CA"
15,2014,Apr,43899,37710,6189,14.1,"Sutter County, CA"
16,2014,May,44886,39125,5761,12.8,"Sutter County, CA"
17,2014,Jun,44942,39264,5678,12.6,"Sutter County, CA"
18,2014,Jul,44930,39545,5385,12.0,"Sutter County, CA"
19,2014,Aug,45482,40588,4894,10.8,"Sutter County, CA"
20,2014,Sep,44118,39654,4464,10.1,"Sutter County, CA"
21,2014,Oct,43718,39236,4482,10.3,"Sutter County, CA"
22,2014,Nov,43669,38560,5109,11.7,"Sutter County, CA"
23,2014,Dec,43042,37821,5221,12.1,"Sutter County, CA"
24,2015,Jan,43611,37817,5794,13.3,"Sutter County, CA"
25,2015,Feb,44123,38166,5957,13.5,"Sutter County, CA"
26,2015,Mar,44761,38876,5885,13.1,"Sutter County, CA"
27,2015,Apr,44604,39396,5208,11.7,"Sutter County, CA"
28,2015,May,45134,40265,4869,10.8,"Sutter County, CA"
29,2015,Jun,45324,40478,4846,10.7,"Sutter County, CA"
30,2015,Jul,46010,41627,4383,9.5,"Sutter County, CA"
31,2015,Aug,46147,42204,3943,8.5,"Sutter County, CA"
32,2015,Sep,44557,40855,3702,8.3,"Sutter County, CA"
33,2015,Oct,44539,40626,3913,8.8,"Sutter County, CA"
34,2015,Nov,43975,39538,4437,10.1,"Sutter County, CA"
35,2015,Dec,44024,39249,4775,10.8,"Sutter County, CA"
36,2016,Jan,43706,38499,5207,11.9,"Sutter County, CA"
37,2016,Feb,44466,39103,5363,12.1,"Sutter County, CA"
38,2016,Mar,44853,39298,5555,12.4,"Sutter County, CA"
39,2016,Apr,44833,40157,4676,10.4,"Sutter County, CA"
40,2016,May,45088,40992,4096,9.1,"Sutter County, CA"
41,2016,Jun,45918,41661,4257,9.3,"Sutter County, CA"
42,2016,Jul,46355,42411,3944,8.5,"Sutter County, CA"
43,2016,Aug,46341,42773,3568,7.7,"Sutter County, CA"
44,2016,Sep,45346,41905,3441,7.6,"Sutter County, CA"
45,2016,Oct,44700,41063,3637,8.1,"Sutter County, CA"
46,2016,Nov,44307,40208,4099,9.3,"Sutter County, CA"
47,2016,Dec,43884,39274,4610,10.5,"Sutter County, CA"
48,2017,Jan,43300,38376,4924,11.4,"Sutter County, CA"
49,2017,Feb,43580,38278,5302,12.2,"Sutter County, CA"
50,2017,Mar,44346,39254,5092,11.5,"Sutter County, CA"
51,2017,Apr,44495,39960,4535,10.2,"Sutter County, CA"
52,2017,May,45358,41492,3866,8.5,"Sutter County, CA"
53,2017,Jun,46416,42586,3830,8.3,"Sutter County, CA"
54,2017,Jul,46532,42939,3593,7.7,"Sutter County, CA"
55,2017,Aug,46744,43488,3256,7.0,"Sutter County, CA"
56,2017,Sep,45527,42683,2844,6.2,"Sutter County, CA"
57,2017,Oct,44735,41872,2863,6.4,"Sutter County, CA"
58,2017,Nov,44299,40984,3315,7.5,"Sutter County, CA"
59,2017,Dec,44252,40427,3825,8.6,"Sutter County, CA"
60,2018,Jan,43614,39373,4241,9.7,"Sutter County, CA"
61,2018,Feb,44451,40042,4409,9.9,"Sutter County, CA"
62,2018,Mar,44703,40240,4463,10.0,"Sutter County, CA"
63,2018,Apr,44454,40706,3748,8.4,"Sutter County, CA"
64,2018,May,45133,41990,3143,7.0,"Sutter County, CA"
65,2018,Jun,46161,42822,3339,7.2,"Sutter County, CA"
66,2018,Jul,45999,42875,3124,6.8,"Sutter County, CA"
67,2018,Aug,45893,43161,2732,6.0,"Sutter County, CA"
68,2018,Sep,44940,42453,2487,5.5,"Sutter County, CA"
69,2018,Oct,44736,42086,2650,5.9,"Sutter County, CA"
70,2018,Nov,44065,41012,3053,6.9,"Sutter County, CA"
71,2018,Dec,43856,40157,3699,8.4,"Sutter County, CA"
72,2019,Jan,44550,40095,4455,10.0,"Sutter County, CA"
73,2019,Feb,44933,40566,4367,9.7,"Sutter County, CA"
74,2019,Mar,45307,40803,4504,9.9,"Sutter County, CA"
75,2019,Apr,44885,41135,3750,8.4,"Sutter County, CA"
76,2019,May,45432,42350,3082,6.8,"Sutter County, CA"
77,2019,Jun,46169,42942,3227,7.0,"Sutter County, CA"
78,2019,Jul,46496,43347,3149,6.8,"Sutter County, CA"
79,2019,Aug,46733,44011,2722,5.8,"Sutter County, CA"
80,2019,Sep,45404,43053,2351,5.2,"Sutter County, CA"
81,2019,Oct,46252,43733,2519,5.4,"Sutter County, CA"
82,2019,Nov,45275,42397,2878,6.4,"Sutter County, CA"
83,2019,Dec,45128,41670,3458,7.7,"Sutter County, CA"
84,2020,Jan,45096,40962,4134,9.2,"Sutter County, CA"
85,2020,Feb,45870,41738,4132,9.0,"Sutter County, CA"
86,2020,Mar,47237,41226,6011,12.7,"Sutter County, CA"
87,2020,Apr,46351,37948,8403,18.1,"Sutter County, CA"
88,2020,May,45251,38395,6856,15.2,"Sutter County, CA"
89,2020,Jun,46631,40686,5945,12.7,"Sutter County, CA"
90,2020,Jul,46482,40972,5510,11.9,"Sutter County, CA"
91,2020,Aug,45861,41428,4433,9.7,"Sutter County, CA"
92,2020,Sep,45273,41028,4245,9.4,"Sutter County, CA"
93,2020,Oct,44854,40991,3863,8.6,"Sutter County, CA"
94,2020,Nov,44214,40088,4126,9.3,"Sutter County, CA"
95,2020,Dec,44094,39580,4514,10.2,"Sutter County, CA"
96,2021,Jan,44000,39142,4858,11.0,"Sutter County, CA"
97,2021,Feb,44635,39534,5101,11.4,"Sutter County, CA"
98,2021,Mar,44688,39692,4996,11.2,"Sutter County, CA"
99,2021,Apr,45246,40591,4655,10.3,"Sutter County, CA"
100,2021,May,45510,41303,4207,9.2,"Sutter County, CA"
101,2021,Jun,46418,41871,4547,9.8,"Sutter County, CA"
102,2021,Jul,46201,42134,4067,8.8,"Sutter County, CA"
103,2021,Aug,45991,42322,3669,8.0,"Sutter County, CA"
104,2021,Sep,46124,42982,3142,6.8,"Sutter County, CA"
105,2021,Oct,45683,42633,3050,6.7,"Sutter County, CA"
106,2021,Nov,45072,41932,3140,7.0,"Sutter County, CA"
107,2021,Dec,44931,41658,3273,7.3,"Sutter County, CA"
108,2022,Jan,45000,41020,3980,8.8,"Sutter County, CA"
109,2022,Feb,45673,41853,3820,8.4,"Sutter County, CA"
110,2022,Mar,46147,42617,3530,7.6,"Sutter County, CA"
111,2022,Apr,45903,42796,3107,6.8,"Sutter County, CA"
112,2022,May,46543,43775,2768,5.9,"Sutter County, CA"
113,2022,Jun,46684,43811,2873,6.2,"Sutter County, CA"
114,2022,Jul,46609,43947,2662,5.7,"Sutter County, CA"
115,2022,Aug,47086,44537,2549,5.4,"Sutter County, CA"
116,2022,Sep,47088,44748,2340,5.0,"Sutter County, CA"
117,2022,Oct,46745,44197,2548,5.5,"Sutter County, CA"
118,2022,Nov,46209,43208,3001,6.5,"Sutter County, CA"
119,2022,Dec,46259,43005,3254,7.0,"Sutter County, CA"
120,2023,Jan,46127,42053,4074,8.8,"Sutter County, CA"
121,2023,Feb,47008,42667,4341,9.2,"Sutter County, CA"
122,2023,Mar,47710,43111,4599,9.6,"Sutter County, CA"
123,2023,Apr,47220,43354,3866,8.2,"Sutter County, CA"
124,2023,May,47812,43984,3828,8.0,"Sutter County, CA"
125,2023,Jun,47721,44069,3652,7.7,"Sutter County, CA"
126,2023,Jul,47772,44469,3303,6.9,"Sutter County, CA"
127,2023,Aug,47556,44456,3100,6.5,"Sutter County, CA"
128,2023,Sep,47019,44225,2794,5.9,"Sutter County, CA"
129,2023,Oct,46938,43951,2987,6.4,"Sutter County, CA"
0,2013,Jan,8623,7838,785,9.1,"Mono County, CA"
1,2013,Feb,8569,7827,742,8.7,"Mono County, CA"
2,2013,Mar,8313,7596,717,8.6,"Mono County, CA"
3,2013,Apr,8307,7655,652,7.8,"Mono County, CA"
4,2013,May,8172,7382,790,9.7,"Mono County, CA"
5,2013,Jun,8587,7804,783,9.1,"Mono County, CA"
6,2013,Jul,8686,7963,723,8.3,"Mono County, CA"
7,2013,Aug,8593,7917,676,7.9,"Mono County, CA"
8,2013,Sep,8405,7729,676,8.0,"Mono County, CA"
9,2013,Oct,7830,7097,733,9.4,"Mono County, CA"
10,2013,Nov,7641,6930,711,9.3,"Mono County, CA"
11,2013,Dec,8328,7686,642,7.7,"Mono County, CA"
12,2014,Jan,8504,7865,639,7.5,"Mono County, CA"
13,2014,Feb,8279,7620,659,8.0,"Mono County, CA"
14,2014,Mar,8279,7641,638,7.7,"Mono County, CA"
15,2014,Apr,8059,7534,525,6.5,"Mono County, CA"
16,2014,May,7791,7168,623,8.0,"Mono County, CA"
17,2014,Jun,8212,7596,616,7.5,"Mono County, CA"
18,2014,Jul,8562,7963,599,7.0,"Mono County, CA"
19,2014,Aug,8565,8004,561,6.5,"Mono County, CA"
20,2014,Sep,8264,7736,528,6.4,"Mono County, CA"
21,2014,Oct,7983,7402,581,7.3,"Mono County, CA"
22,2014,Nov,7840,7269,571,7.3,"Mono County, CA"
23,2014,Dec,8340,7841,499,6.0,"Mono County, CA"
24,2015,Jan,8767,8258,509,5.8,"Mono County, CA"
25,2015,Feb,8662,8171,491,5.7,"Mono County, CA"
26,2015,Mar,8509,8010,499,5.9,"Mono County, CA"
27,2015,Apr,7961,7410,551,6.9,"Mono County, CA"
28,2015,May,7775,7139,636,8.2,"Mono County, CA"
29,2015,Jun,8120,7559,561,6.9,"Mono County, CA"
30,2015,Jul,8515,8029,486,5.7,"Mono County, CA"
31,2015,Aug,8468,8021,447,5.3,"Mono County, CA"
32,2015,Sep,7910,7477,433,5.5,"Mono County, CA"
33,2015,Oct,7720,7210,510,6.6,"Mono County, CA"
34,2015,Nov,7807,7295,512,6.6,"Mono County, CA"
35,2015,Dec,8653,8197,456,5.3,"Mono County, CA"
36,2016,Jan,8946,8491,455,5.1,"Mono County, CA"
37,2016,Feb,8878,8423,455,5.1,"Mono County, CA"
38,2016,Mar,8768,8314,454,5.2,"Mono County, CA"
39,2016,Apr,8292,7896,396,4.8,"Mono County, CA"
40,2016,May,7787,7292,495,6.4,"Mono County, CA"
41,2016,Jun,8210,7742,468,5.7,"Mono County, CA"
42,2016,Jul,8531,8073,458,5.4,"Mono County, CA"
43,2016,Aug,8488,8059,429,5.1,"Mono County, CA"
44,2016,Sep,8106,7681,425,5.2,"Mono County, CA"
45,2016,Oct,7784,7304,480,6.2,"Mono County, CA"
46,2016,Nov,7961,7482,479,6.0,"Mono County, CA"
47,2016,Dec,8627,8227,400,4.6,"Mono County, CA"
48,2017,Jan,8961,8548,413,4.6,"Mono County, CA"
49,2017,Feb,9023,8628,395,4.4,"Mono County, CA"
50,2017,Mar,8815,8450,365,4.1,"Mono County, CA"
51,2017,Apr,8659,8348,311,3.6,"Mono County, CA"
52,2017,May,7995,7627,368,4.6,"Mono County, CA"
53,2017,Jun,8390,7983,407,4.9,"Mono County, CA"
54,2017,Jul,8709,8297,412,4.7,"Mono County, CA"
55,2017,Aug,8614,8206,408,4.7,"Mono County, CA"
56,2017,Sep,8359,7990,369,4.4,"Mono County, CA"
57,2017,Oct,7852,7466,386,4.9,"Mono County, CA"
58,2017,Nov,7817,7448,369,4.7,"Mono County, CA"
59,2017,Dec,8629,8281,348,4.0,"Mono County, CA"
60,2018,Jan,8944,8583,361,4.0,"Mono County, CA"
61,2018,Feb,8938,8575,363,4.1,"Mono County, CA"
62,2018,Mar,8736,8393,343,3.9,"Mono County, CA"
63,2018,Apr,8386,8094,292,3.5,"Mono County, CA"
64,2018,May,7892,7582,310,3.9,"Mono County, CA"
65,2018,Jun,8345,7995,350,4.2,"Mono County, CA"
66,2018,Jul,8681,8338,343,4.0,"Mono County, CA"
67,2018,Aug,8538,8200,338,4.0,"Mono County, CA"
68,2018,Sep,8180,7856,324,4.0,"Mono County, CA"
69,2018,Oct,7912,7541,371,4.7,"Mono County, CA"
70,2018,Nov,7900,7534,366,4.6,"Mono County, CA"
71,2018,Dec,8655,8318,337,3.9,"Mono County, CA"
72,2019,Jan,9134,8759,375,4.1,"Mono County, CA"
73,2019,Feb,9006,8660,346,3.8,"Mono County, CA"
74,2019,Mar,8940,8596,344,3.8,"Mono County, CA"
75,2019,Apr,8611,8344,267,3.1,"Mono County, CA"
76,2019,May,8023,7745,278,3.5,"Mono County, CA"
77,2019,Jun,8250,7920,330,4.0,"Mono County, CA"
78,2019,Jul,8698,8373,325,3.7,"Mono County, CA"
79,2019,Aug,8594,8282,312,3.6,"Mono County, CA"
80,2019,Sep,8344,8059,285,3.4,"Mono County, CA"
81,2019,Oct,8003,7677,326,4.1,"Mono County, CA"
82,2019,Nov,7886,7560,326,4.1,"Mono County, CA"
83,2019,Dec,8772,8474,298,3.4,"Mono County, CA"
84,2020,Jan,9181,8849,332,3.6,"Mono County, CA"
85,2020,Feb,9109,8773,336,3.7,"Mono County, CA"
86,2020,Mar,8796,8306,490,5.6,"Mono County, CA"
87,2020,Apr,6771,4838,1933,28.5,"Mono County, CA"
88,2020,May,6911,5049,1862,26.9,"Mono County, CA"
89,2020,Jun,7579,6003,1576,20.8,"Mono County, CA"
90,2020,Jul,8144,7020,1124,13.8,"Mono County, CA"
91,2020,Aug,8060,7220,840,10.4,"Mono County, CA"
92,2020,Sep,7858,7084,774,9.8,"Mono County, CA"
93,2020,Oct,7323,6577,746,10.2,"Mono County, CA"
94,2020,Nov,7447,6756,691,9.3,"Mono County, CA"
95,2020,Dec,7611,6876,735,9.7,"Mono County, CA"
96,2021,Jan,7568,6747,821,10.8,"Mono County, CA"
97,2021,Feb,8123,7407,716,8.8,"Mono County, CA"
98,2021,Mar,8283,7597,686,8.3,"Mono County, CA"
99,2021,Apr,8425,7825,600,7.1,"Mono County, CA"
100,2021,May,8015,7447,568,7.1,"Mono County, CA"
101,2021,Jun,8363,7738,625,7.5,"Mono County, CA"
102,2021,Jul,8599,8047,552,6.4,"Mono County, CA"
103,2021,Aug,8507,7981,526,6.2,"Mono County, CA"
104,2021,Sep,8702,8239,463,5.3,"Mono County, CA"
105,2021,Oct,8535,8075,460,5.4,"Mono County, CA"
106,2021,Nov,7984,7572,412,5.2,"Mono County, CA"
107,2021,Dec,8540,8153,387,4.5,"Mono County, CA"
108,2022,Jan,8688,8263,425,4.9,"Mono County, CA"
109,2022,Feb,8723,8334,389,4.5,"Mono County, CA"
110,2022,Mar,8672,8311,361,4.2,"Mono County, CA"
111,2022,Apr,9058,8788,270,3.0,"Mono County, CA"
112,2022,May,8675,8417,258,3.0,"Mono County, CA"
113,2022,Jun,8749,8449,300,3.4,"Mono County, CA"
114,2022,Jul,8968,8670,298,3.3,"Mono County, CA"
115,2022,Aug,8944,8629,315,3.5,"Mono County, CA"
116,2022,Sep,8543,8247,296,3.5,"Mono County, CA"
117,2022,Oct,8190,7842,348,4.2,"Mono County, CA"
118,2022,Nov,8151,7829,322,4.0,"Mono County, CA"
119,2022,Dec,8668,8365,303,3.5,"Mono County, CA"
120,2023,Jan,8766,8411,355,4.0,"Mono County, CA"
121,2023,Feb,8936,8589,347,3.9,"Mono County, CA"
122,2023,Mar,8899,8551,348,3.9,"Mono County, CA"
123,2023,Apr,8443,8134,309,3.7,"Mono County, CA"
124,2023,May,8082,7766,316,3.9,"Mono County, CA"
125,2023,Jun,8691,8350,341,3.9,"Mono County, CA"
126,2023,Jul,9244,8916,328,3.5,"Mono County, CA"
127,2023,Aug,9173,8819,354,3.9,"Mono County, CA"
128,2023,Sep,8959,8612,347,3.9,"Mono County, CA"
129,2023,Oct,8578,8196,382,4.5,"Mono County, CA"
0,2013,Jan,1560959,1443794,117165,7.5,"Orange County, CA"
1,2013,Feb,1563644,1452527,111117,7.1,"Orange County, CA"
2,2013,Mar,1558593,1451300,107293,6.9,"Orange County, CA"
3,2013,Apr,1552616,1454045,98571,6.3,"Orange County, CA"
4,2013,May,1556993,1458048,98945,6.4,"Orange County, CA"
5,2013,Jun,1562681,1452571,110110,7.0,"Orange County, CA"
6,2013,Jul,1571336,1459437,111899,7.1,"Orange County, CA"
7,2013,Aug,1559266,1452659,106607,6.8,"Orange County, CA"
8,2013,Sep,1561870,1460552,101318,6.5,"Orange County, CA"
9,2013,Oct,1552071,1450745,101326,6.5,"Orange County, CA"
10,2013,Nov,1559328,1463199,96129,6.2,"Orange County, CA"
11,2013,Dec,1554398,1464856,89542,5.8,"Orange County, CA"
12,2014,Jan,1550157,1455997,94160,6.1,"Orange County, CA"
13,2014,Feb,1561287,1466066,95221,6.1,"Orange County, CA"
14,2014,Mar,1564808,1469704,95104,6.1,"Orange County, CA"
15,2014,Apr,1546221,1465583,80638,5.2,"Orange County, CA"
16,2014,May,1558802,1476393,82409,5.3,"Orange County, CA"
17,2014,Jun,1558025,1469430,88595,5.7,"Orange County, CA"
18,2014,Jul,1571554,1475902,95652,6.1,"Orange County, CA"
19,2014,Aug,1564090,1472135,91955,5.9,"Orange County, CA"
20,2014,Sep,1569425,1485526,83899,5.3,"Orange County, CA"
21,2014,Oct,1580868,1498257,82611,5.2,"Orange County, CA"
22,2014,Nov,1583655,1502864,80791,5.1,"Orange County, CA"
23,2014,Dec,1576460,1503855,72605,4.6,"Orange County, CA"
24,2015,Jan,1577238,1497429,79809,5.1,"Orange County, CA"
25,2015,Feb,1582706,1506932,75774,4.8,"Orange County, CA"
26,2015,Mar,1581515,1507074,74441,4.7,"Orange County, CA"
27,2015,Apr,1573854,1505361,68493,4.4,"Orange County, CA"
28,2015,May,1578644,1509918,68726,4.4,"Orange County, CA"
29,2015,Jun,1580219,1506682,73537,4.7,"Orange County, CA"
30,2015,Jul,1588715,1511894,76821,4.8,"Orange County, CA"
31,2015,Aug,1581270,1508976,72294,4.6,"Orange County, CA"
32,2015,Sep,1584663,1517882,66781,4.2,"Orange County, CA"
33,2015,Oct,1593482,1525156,68326,4.3,"Orange County, CA"
34,2015,Nov,1595083,1528318,66765,4.2,"Orange County, CA"
35,2015,Dec,1594160,1531096,63064,4.0,"Orange County, CA"
36,2016,Jan,1589746,1524038,65708,4.1,"Orange County, CA"
37,2016,Feb,1600406,1534322,66084,4.1,"Orange County, CA"
38,2016,Mar,1602720,1535291,67429,4.2,"Orange County, CA"
39,2016,Apr,1584940,1522008,62932,4.0,"Orange County, CA"
40,2016,May,1587628,1529450,58178,3.7,"Orange County, CA"
41,2016,Jun,1588177,1519223,68954,4.3,"Orange County, CA"
42,2016,Jul,1600188,1529239,70949,4.4,"Orange County, CA"
43,2016,Aug,1591109,1522224,68885,4.3,"Orange County, CA"
44,2016,Sep,1602544,1537590,64954,4.1,"Orange County, CA"
45,2016,Oct,1608945,1543938,65007,4.0,"Orange County, CA"
46,2016,Nov,1608643,1548641,60002,3.7,"Orange County, CA"
47,2016,Dec,1604326,1546739,57587,3.6,"Orange County, CA"
48,2017,Jan,1598680,1534205,64475,4.0,"Orange County, CA"
49,2017,Feb,1606808,1545115,61693,3.8,"Orange County, CA"
50,2017,Mar,1605801,1546910,58891,3.7,"Orange County, CA"
51,2017,Apr,1593389,1539542,53847,3.4,"Orange County, CA"
52,2017,May,1597254,1545435,51819,3.2,"Orange County, CA"
53,2017,Jun,1597793,1537307,60486,3.8,"Orange County, CA"
54,2017,Jul,1612037,1548164,63873,4.0,"Orange County, CA"
55,2017,Aug,1603385,1541385,62000,3.9,"Orange County, CA"
56,2017,Sep,1617426,1563355,54071,3.3,"Orange County, CA"
57,2017,Oct,1613407,1561167,52240,3.2,"Orange County, CA"
58,2017,Nov,1613913,1563661,50252,3.1,"Orange County, CA"
59,2017,Dec,1609550,1561784,47766,3.0,"Orange County, CA"
60,2018,Jan,1606696,1554551,52145,3.2,"Orange County, CA"
61,2018,Feb,1622002,1571574,50428,3.1,"Orange County, CA"
62,2018,Mar,1620463,1572830,47633,2.9,"Orange County, CA"
63,2018,Apr,1605126,1561305,43821,2.7,"Orange County, CA"
64,2018,May,1608999,1567844,41155,2.6,"Orange County, CA"
65,2018,Jun,1605808,1554050,51758,3.2,"Orange County, CA"
66,2018,Jul,1622875,1571152,51723,3.2,"Orange County, CA"
67,2018,Aug,1607853,1557089,50764,3.2,"Orange County, CA"
68,2018,Sep,1619205,1573047,46158,2.9,"Orange County, CA"
69,2018,Oct,1626714,1579605,47109,2.9,"Orange County, CA"
70,2018,Nov,1626190,1580520,45670,2.8,"Orange County, CA"
71,2018,Dec,1621797,1575709,46088,2.8,"Orange County, CA"
72,2019,Jan,1617478,1563407,54071,3.3,"Orange County, CA"
73,2019,Feb,1628765,1580800,47965,2.9,"Orange County, CA"
74,2019,Mar,1624952,1576107,48845,3.0,"Orange County, CA"
75,2019,Apr,1604927,1564603,40324,2.5,"Orange County, CA"
76,2019,May,1607472,1568074,39398,2.5,"Orange County, CA"
77,2019,Jun,1604004,1556677,47327,3.0,"Orange County, CA"
78,2019,Jul,1620896,1570469,50427,3.1,"Orange County, CA"
79,2019,Aug,1608290,1560029,48261,3.0,"Orange County, CA"
80,2019,Sep,1620086,1578500,41586,2.6,"Orange County, CA"
81,2019,Oct,1623778,1580245,43533,2.7,"Orange County, CA"
82,2019,Nov,1621779,1578470,43309,2.7,"Orange County, CA"
83,2019,Dec,1618763,1577750,41013,2.5,"Orange County, CA"
84,2020,Jan,1619007,1571690,47317,2.9,"Orange County, CA"
85,2020,Feb,1633720,1588517,45203,2.8,"Orange County, CA"
86,2020,Mar,1602205,1536072,66133,4.1,"Orange County, CA"
87,2020,Apr,1542304,1317251,225053,14.6,"Orange County, CA"
88,2020,May,1518130,1288235,229895,15.1,"Orange County, CA"
89,2020,Jun,1568359,1363023,205336,13.1,"Orange County, CA"
90,2020,Jul,1568553,1375413,193140,12.3,"Orange County, CA"
91,2020,Aug,1550112,1392378,157734,10.2,"Orange County, CA"
92,2020,Sep,1550749,1403998,146751,9.5,"Orange County, CA"
93,2020,Oct,1555027,1429030,125997,8.1,"Orange County, CA"
94,2020,Nov,1550454,1432159,118295,7.6,"Orange County, CA"
95,2020,Dec,1543770,1425890,117880,7.6,"Orange County, CA"
96,2021,Jan,1531227,1413550,117677,7.7,"Orange County, CA"
97,2021,Feb,1547956,1435705,112251,7.3,"Orange County, CA"
98,2021,Mar,1550017,1443424,106593,6.9,"Orange County, CA"
99,2021,Apr,1542675,1438990,103685,6.7,"Orange County, CA"
100,2021,May,1547784,1451889,95895,6.2,"Orange County, CA"
101,2021,Jun,1552910,1445936,106974,6.9,"Orange County, CA"
102,2021,Jul,1572385,1471381,101004,6.4,"Orange County, CA"
103,2021,Aug,1567779,1473184,94595,6.0,"Orange County, CA"
104,2021,Sep,1570067,1491027,79040,5.0,"Orange County, CA"
105,2021,Oct,1580496,1505235,75261,4.8,"Orange County, CA"
106,2021,Nov,1583870,1516838,67032,4.2,"Orange County, CA"
107,2021,Dec,1581206,1520950,60256,3.8,"Orange County, CA"
108,2022,Jan,1577298,1510733,66565,4.2,"Orange County, CA"
109,2022,Feb,1589672,1530512,59160,3.7,"Orange County, CA"
110,2022,Mar,1590900,1538040,52860,3.3,"Orange County, CA"
111,2022,Apr,1575310,1529447,45863,2.9,"Orange County, CA"
112,2022,May,1583335,1540960,42375,2.7,"Orange County, CA"
113,2022,Jun,1582054,1531620,50434,3.2,"Orange County, CA"
114,2022,Jul,1584783,1534830,49953,3.2,"Orange County, CA"
115,2022,Aug,1588191,1536953,51238,3.2,"Orange County, CA"
116,2022,Sep,1598729,1553276,45453,2.8,"Orange County, CA"
117,2022,Oct,1606752,1559064,47688,3.0,"Orange County, CA"
118,2022,Nov,1604830,1556434,48396,3.0,"Orange County, CA"
119,2022,Dec,1608725,1564859,43866,2.7,"Orange County, CA"
120,2023,Jan,1593371,1539657,53714,3.4,"Orange County, CA"
121,2023,Feb,1607657,1552537,55120,3.4,"Orange County, CA"
122,2023,Mar,1610312,1555717,54595,3.4,"Orange County, CA"
123,2023,Apr,1596707,1548074,48633,3.0,"Orange County, CA"
124,2023,May,1594170,1542962,51208,3.2,"Orange County, CA"
125,2023,Jun,1584065,1525607,58458,3.7,"Orange County, CA"
126,2023,Jul,1596727,1539199,57528,3.6,"Orange County, CA"
127,2023,Aug,1593841,1531114,62727,3.9,"Orange County, CA"
128,2023,Sep,1611900,1552511,59389,3.7,"Orange County, CA"
129,2023,Oct,1611653,1551316,60337,3.7,"Orange County, CA"
0,2013,Jan,114912,94211,20701,18.0,"Merced County, CA"
1,2013,Feb,115147,95022,20125,17.5,"Merced County, CA"
2,2013,Mar,113829,94419,19410,17.1,"Merced County, CA"
3,2013,Apr,113574,95987,17587,15.5,"Merced County, CA"
4,2013,May,114192,97947,16245,14.2,"Merced County, CA"
5,2013,Jun,115657,98879,16778,14.5,"Merced County, CA"
6,2013,Jul,112575,96447,16128,14.3,"Merced County, CA"
7,2013,Aug,114836,99817,15019,13.1,"Merced County, CA"
8,2013,Sep,116539,102580,13959,12.0,"Merced County, CA"
9,2013,Oct,115787,101740,14047,12.1,"Merced County, CA"
10,2013,Nov,112524,97207,15317,13.6,"Merced County, CA"
11,2013,Dec,112162,96257,15905,14.2,"Merced County, CA"
12,2014,Jan,113150,95343,17807,15.7,"Merced County, CA"
13,2014,Feb,114851,96726,18125,15.8,"Merced County, CA"
14,2014,Mar,114743,96345,18398,16.0,"Merced County, CA"
15,2014,Apr,113499,97891,15608,13.8,"Merced County, CA"
16,2014,May,114249,99892,14357,12.6,"Merced County, CA"
17,2014,Jun,115434,101074,14360,12.4,"Merced County, CA"
18,2014,Jul,112247,98065,14182,12.6,"Merced County, CA"
19,2014,Aug,113544,100490,13054,11.5,"Merced County, CA"
20,2014,Sep,116569,104686,11883,10.2,"Merced County, CA"
21,2014,Oct,115820,103936,11884,10.3,"Merced County, CA"
22,2014,Nov,112916,99349,13567,12.0,"Merced County, CA"
23,2014,Dec,113003,98457,14546,12.9,"Merced County, CA"
24,2015,Jan,113199,96958,16241,14.3,"Merced County, CA"
25,2015,Feb,114251,98216,16035,14.0,"Merced County, CA"
26,2015,Mar,114233,98561,15672,13.7,"Merced County, CA"
27,2015,Apr,113255,99543,13712,12.1,"Merced County, CA"
28,2015,May,114006,101142,12864,11.3,"Merced County, CA"
29,2015,Jun,114764,101851,12913,11.3,"Merced County, CA"
30,2015,Jul,111987,99790,12197,10.9,"Merced County, CA"
31,2015,Aug,114720,103750,10970,9.6,"Merced County, CA"
32,2015,Sep,116574,106741,9833,8.4,"Merced County, CA"
33,2015,Oct,115828,105410,10418,9.0,"Merced County, CA"
34,2015,Nov,113453,100984,12469,11.0,"Merced County, CA"
35,2015,Dec,112461,99425,13036,11.6,"Merced County, CA"
36,2016,Jan,113791,98854,14937,13.1,"Merced County, CA"
37,2016,Feb,114739,99789,14950,13.0,"Merced County, CA"
38,2016,Mar,115195,100100,15095,13.1,"Merced County, CA"
39,2016,Apr,113933,100982,12951,11.4,"Merced County, CA"
40,2016,May,114424,103130,11294,9.9,"Merced County, CA"
41,2016,Jun,114950,103150,11800,10.3,"Merced County, CA"
42,2016,Jul,111769,100425,11344,10.1,"Merced County, CA"
43,2016,Aug,114244,103806,10438,9.1,"Merced County, CA"
44,2016,Sep,116498,106937,9561,8.2,"Merced County, CA"
45,2016,Oct,115198,105355,9843,8.5,"Merced County, CA"
46,2016,Nov,114322,103547,10775,9.4,"Merced County, CA"
47,2016,Dec,113006,100456,12550,11.1,"Merced County, CA"
48,2017,Jan,113090,99390,13700,12.1,"Merced County, CA"
49,2017,Feb,115945,101402,14543,12.5,"Merced County, CA"
50,2017,Mar,117072,103041,14031,12.0,"Merced County, CA"
51,2017,Apr,115413,103475,11938,10.3,"Merced County, CA"
52,2017,May,115993,105695,10298,8.9,"Merced County, CA"
53,2017,Jun,115994,105232,10762,9.3,"Merced County, CA"
54,2017,Jul,112465,102110,10355,9.2,"Merced County, CA"
55,2017,Aug,114695,105140,9555,8.3,"Merced County, CA"
56,2017,Sep,117334,109172,8162,7.0,"Merced County, CA"
57,2017,Oct,116218,108205,8013,6.9,"Merced County, CA"
58,2017,Nov,114147,105231,8916,7.8,"Merced County, CA"
59,2017,Dec,114154,103867,10287,9.0,"Merced County, CA"
60,2018,Jan,113050,101477,11573,10.2,"Merced County, CA"
61,2018,Feb,115955,103535,12420,10.7,"Merced County, CA"
62,2018,Mar,116136,103788,12348,10.6,"Merced County, CA"
63,2018,Apr,114730,104166,10564,9.2,"Merced County, CA"
64,2018,May,116165,107086,9079,7.8,"Merced County, CA"
65,2018,Jun,115632,105754,9878,8.5,"Merced County, CA"
66,2018,Jul,112947,103515,9432,8.4,"Merced County, CA"
67,2018,Aug,114225,105830,8395,7.3,"Merced County, CA"
68,2018,Sep,117062,109795,7267,6.2,"Merced County, CA"
69,2018,Oct,117155,109761,7394,6.3,"Merced County, CA"
70,2018,Nov,114874,106794,8080,7.0,"Merced County, CA"
71,2018,Dec,114822,104962,9860,8.6,"Merced County, CA"
72,2019,Jan,116013,104045,11968,10.3,"Merced County, CA"
73,2019,Feb,117316,105119,12197,10.4,"Merced County, CA"
74,2019,Mar,117545,105473,12072,10.3,"Merced County, CA"
75,2019,Apr,115305,105278,10027,8.7,"Merced County, CA"
76,2019,May,116858,108347,8511,7.3,"Merced County, CA"
77,2019,Jun,114814,105477,9337,8.1,"Merced County, CA"
78,2019,Jul,113059,103682,9377,8.3,"Merced County, CA"
79,2019,Aug,114972,106662,8310,7.2,"Merced County, CA"
80,2019,Sep,117495,110575,6920,5.9,"Merced County, CA"
81,2019,Oct,117582,110356,7226,6.1,"Merced County, CA"
82,2019,Nov,115652,107619,8033,6.9,"Merced County, CA"
83,2019,Dec,114932,105420,9512,8.3,"Merced County, CA"
84,2020,Jan,116516,104997,11519,9.9,"Merced County, CA"
85,2020,Feb,118004,106011,11993,10.2,"Merced County, CA"
86,2020,Mar,121686,104383,17303,14.2,"Merced County, CA"
87,2020,Apr,119014,96874,22140,18.6,"Merced County, CA"
88,2020,May,115467,97109,18358,15.9,"Merced County, CA"
89,2020,Jun,115832,99375,16457,14.2,"Merced County, CA"
90,2020,Jul,113076,97421,15655,13.8,"Merced County, CA"
91,2020,Aug,115001,102169,12832,11.2,"Merced County, CA"
92,2020,Sep,116350,104207,12143,10.4,"Merced County, CA"
93,2020,Oct,113763,102744,11019,9.7,"Merced County, CA"
94,2020,Nov,111903,100149,11754,10.5,"Merced County, CA"
95,2020,Dec,112060,99141,12919,11.5,"Merced County, CA"
96,2021,Jan,113759,99603,14156,12.4,"Merced County, CA"
97,2021,Feb,114739,99980,14759,12.9,"Merced County, CA"
98,2021,Mar,114832,100272,14560,12.7,"Merced County, CA"
99,2021,Apr,114505,100875,13630,11.9,"Merced County, CA"
100,2021,May,115984,103770,12214,10.5,"Merced County, CA"
101,2021,Jun,115940,102602,13338,11.5,"Merced County, CA"
102,2021,Jul,114799,102588,12211,10.6,"Merced County, CA"
103,2021,Aug,116135,105092,11043,9.5,"Merced County, CA"
104,2021,Sep,117384,107993,9391,8.0,"Merced County, CA"
105,2021,Oct,117012,107923,9089,7.8,"Merced County, CA"
106,2021,Nov,114310,105444,8866,7.8,"Merced County, CA"
107,2021,Dec,113083,103586,9497,8.4,"Merced County, CA"
108,2022,Jan,114453,103002,11451,10.0,"Merced County, CA"
109,2022,Feb,115568,104352,11216,9.7,"Merced County, CA"
110,2022,Mar,115533,105003,10530,9.1,"Merced County, CA"
111,2022,Apr,113794,104664,9130,8.0,"Merced County, CA"
112,2022,May,115487,107448,8039,7.0,"Merced County, CA"
113,2022,Jun,116144,107554,8590,7.4,"Merced County, CA"
114,2022,Jul,116219,107945,8274,7.1,"Merced County, CA"
115,2022,Aug,115533,107658,7875,6.8,"Merced County, CA"
116,2022,Sep,117801,110913,6888,5.8,"Merced County, CA"
117,2022,Oct,117225,109917,7308,6.2,"Merced County, CA"
118,2022,Nov,115314,107113,8201,7.1,"Merced County, CA"
119,2022,Dec,114181,105188,8993,7.9,"Merced County, CA"
120,2023,Jan,115289,104060,11229,9.7,"Merced County, CA"
121,2023,Feb,117383,104662,12721,10.8,"Merced County, CA"
122,2023,Mar,118160,104821,13339,11.3,"Merced County, CA"
123,2023,Apr,116729,105340,11389,9.8,"Merced County, CA"
124,2023,May,117452,106616,10836,9.2,"Merced County, CA"
125,2023,Jun,116933,105912,11021,9.4,"Merced County, CA"
126,2023,Jul,114727,104543,10184,8.9,"Merced County, CA"
127,2023,Aug,112370,102409,9961,8.9,"Merced County, CA"
128,2023,Sep,114652,106099,8553,7.5,"Merced County, CA"
129,2023,Oct,114822,105815,9007,7.8,"Merced County, CA"
0,2013,Jan,310192,264312,45880,14.8,"San Joaquin County, CA"
1,2013,Feb,310181,266569,43612,14.1,"San Joaquin County, CA"
2,2013,Mar,310438,268463,41975,13.5,"San Joaquin County, CA"
3,2013,Apr,309326,270294,39032,12.6,"San Joaquin County, CA"
4,2013,May,318993,282050,36943,11.6,"San Joaquin County, CA"
5,2013,Jun,314961,275171,39790,12.6,"San Joaquin County, CA"
6,2013,Jul,314324,275419,38905,12.4,"San Joaquin County, CA"
7,2013,Aug,314656,277406,37250,11.8,"San Joaquin County, CA"
8,2013,Sep,313879,278554,35325,11.3,"San Joaquin County, CA"
9,2013,Oct,311685,275964,35721,11.5,"San Joaquin County, CA"
10,2013,Nov,309055,272880,36175,11.7,"San Joaquin County, CA"
11,2013,Dec,307985,271991,35994,11.7,"San Joaquin County, CA"
12,2014,Jan,309663,271112,38551,12.4,"San Joaquin County, CA"
13,2014,Feb,311659,273119,38540,12.4,"San Joaquin County, CA"
14,2014,Mar,313079,274422,38657,12.3,"San Joaquin County, CA"
15,2014,Apr,308936,275421,33515,10.8,"San Joaquin County, CA"
16,2014,May,313175,281146,32029,10.2,"San Joaquin County, CA"
17,2014,Jun,311426,278354,33072,10.6,"San Joaquin County, CA"
18,2014,Jul,312660,279130,33530,10.7,"San Joaquin County, CA"
19,2014,Aug,313569,282078,31491,10.0,"San Joaquin County, CA"
20,2014,Sep,312978,283899,29079,9.3,"San Joaquin County, CA"
21,2014,Oct,312844,283753,29091,9.3,"San Joaquin County, CA"
22,2014,Nov,310102,279497,30605,9.9,"San Joaquin County, CA"
23,2014,Dec,308425,278177,30248,9.8,"San Joaquin County, CA"
24,2015,Jan,311214,278260,32954,10.6,"San Joaquin County, CA"
25,2015,Feb,312628,280634,31994,10.2,"San Joaquin County, CA"
26,2015,Mar,312756,281387,31369,10.0,"San Joaquin County, CA"
27,2015,Apr,312342,284008,28334,9.1,"San Joaquin County, CA"
28,2015,May,318722,291503,27219,8.5,"San Joaquin County, CA"
29,2015,Jun,315052,286516,28536,9.1,"San Joaquin County, CA"
30,2015,Jul,315428,287198,28230,8.9,"San Joaquin County, CA"
31,2015,Aug,315543,289547,25996,8.2,"San Joaquin County, CA"
32,2015,Sep,316522,292147,24375,7.7,"San Joaquin County, CA"
33,2015,Oct,315035,289812,25223,8.0,"San Joaquin County, CA"
34,2015,Nov,313934,287341,26593,8.5,"San Joaquin County, CA"
35,2015,Dec,313637,287015,26622,8.5,"San Joaquin County, CA"
36,2016,Jan,314634,285537,29097,9.2,"San Joaquin County, CA"
37,2016,Feb,317320,288574,28746,9.1,"San Joaquin County, CA"
38,2016,Mar,319483,289987,29496,9.2,"San Joaquin County, CA"
39,2016,Apr,314842,288569,26273,8.3,"San Joaquin County, CA"
40,2016,May,319270,295939,23331,7.3,"San Joaquin County, CA"
41,2016,Jun,315936,289627,26309,8.3,"San Joaquin County, CA"
42,2016,Jul,318370,292392,25978,8.2,"San Joaquin County, CA"
43,2016,Aug,319029,294499,24530,7.7,"San Joaquin County, CA"
44,2016,Sep,320849,297050,23799,7.4,"San Joaquin County, CA"
45,2016,Oct,321000,297121,23879,7.4,"San Joaquin County, CA"
46,2016,Nov,319242,294713,24529,7.7,"San Joaquin County, CA"
47,2016,Dec,319816,294397,25419,7.9,"San Joaquin County, CA"
48,2017,Jan,319421,291687,27734,8.7,"San Joaquin County, CA"
49,2017,Feb,321838,294418,27420,8.5,"San Joaquin County, CA"
50,2017,Mar,322245,295803,26442,8.2,"San Joaquin County, CA"
51,2017,Apr,320935,297634,23301,7.3,"San Joaquin County, CA"
52,2017,May,326552,305707,20845,6.4,"San Joaquin County, CA"
53,2017,Jun,321540,298989,22551,7.0,"San Joaquin County, CA"
54,2017,Jul,324104,301129,22975,7.1,"San Joaquin County, CA"
55,2017,Aug,325688,303874,21814,6.7,"San Joaquin County, CA"
56,2017,Sep,326122,306629,19493,6.0,"San Joaquin County, CA"
57,2017,Oct,322666,303477,19189,5.9,"San Joaquin County, CA"
58,2017,Nov,322144,302014,20130,6.2,"San Joaquin County, CA"
59,2017,Dec,322155,301100,21055,6.5,"San Joaquin County, CA"
60,2018,Jan,321131,297914,23217,7.2,"San Joaquin County, CA"
61,2018,Feb,325215,302132,23083,7.1,"San Joaquin County, CA"
62,2018,Mar,324199,301748,22451,6.9,"San Joaquin County, CA"
63,2018,Apr,320769,301087,19682,6.1,"San Joaquin County, CA"
64,2018,May,325454,308001,17453,5.4,"San Joaquin County, CA"
65,2018,Jun,323117,303089,20028,6.2,"San Joaquin County, CA"
66,2018,Jul,324460,304644,19816,6.1,"San Joaquin County, CA"
67,2018,Aug,324508,305904,18604,5.7,"San Joaquin County, CA"
68,2018,Sep,326542,309564,16978,5.2,"San Joaquin County, CA"
69,2018,Oct,325662,308228,17434,5.4,"San Joaquin County, CA"
70,2018,Nov,324104,305632,18472,5.7,"San Joaquin County, CA"
71,2018,Dec,324490,304050,20440,6.3,"San Joaquin County, CA"
72,2019,Jan,326881,302935,23946,7.3,"San Joaquin County, CA"
73,2019,Feb,327774,305298,22476,6.9,"San Joaquin County, CA"
74,2019,Mar,327159,304825,22334,6.8,"San Joaquin County, CA"
75,2019,Apr,322287,303458,18829,5.8,"San Joaquin County, CA"
76,2019,May,327471,310524,16947,5.2,"San Joaquin County, CA"
77,2019,Jun,325897,306843,19054,5.8,"San Joaquin County, CA"
78,2019,Jul,326697,306614,20083,6.1,"San Joaquin County, CA"
79,2019,Aug,327606,308873,18733,5.7,"San Joaquin County, CA"
80,2019,Sep,327222,310926,16296,5.0,"San Joaquin County, CA"
81,2019,Oct,329483,312240,17243,5.2,"San Joaquin County, CA"
82,2019,Nov,328582,310342,18240,5.6,"San Joaquin County, CA"
83,2019,Dec,328727,309454,19273,5.9,"San Joaquin County, CA"
84,2020,Jan,331696,309356,22340,6.7,"San Joaquin County, CA"
85,2020,Feb,334643,313034,21609,6.5,"San Joaquin County, CA"
86,2020,Mar,335188,304052,31136,9.3,"San Joaquin County, CA"
87,2020,Apr,332153,271817,60336,18.2,"San Joaquin County, CA"
88,2020,May,335086,281186,53900,16.1,"San Joaquin County, CA"
89,2020,Jun,338051,289424,48627,14.4,"San Joaquin County, CA"
90,2020,Jul,336040,289392,46648,13.9,"San Joaquin County, CA"
91,2020,Aug,336542,297662,38880,11.6,"San Joaquin County, CA"
92,2020,Sep,337566,300047,37519,11.1,"San Joaquin County, CA"
93,2020,Oct,337081,303519,33562,10.0,"San Joaquin County, CA"
94,2020,Nov,335905,302343,33562,10.0,"San Joaquin County, CA"
95,2020,Dec,335118,300844,34274,10.2,"San Joaquin County, CA"
96,2021,Jan,334780,299729,35051,10.5,"San Joaquin County, CA"
97,2021,Feb,336699,302150,34549,10.3,"San Joaquin County, CA"
98,2021,Mar,335591,302143,33448,10.0,"San Joaquin County, CA"
99,2021,Apr,332798,300664,32134,9.7,"San Joaquin County, CA"
100,2021,May,338448,308896,29552,8.7,"San Joaquin County, CA"
101,2021,Jun,337021,304589,32432,9.6,"San Joaquin County, CA"
102,2021,Jul,336886,306271,30615,9.1,"San Joaquin County, CA"
103,2021,Aug,336895,308624,28271,8.4,"San Joaquin County, CA"
104,2021,Sep,337104,312560,24544,7.3,"San Joaquin County, CA"
105,2021,Oct,338323,314649,23674,7.0,"San Joaquin County, CA"
106,2021,Nov,339126,317195,21931,6.5,"San Joaquin County, CA"
107,2021,Dec,338923,317971,20952,6.2,"San Joaquin County, CA"
108,2022,Jan,341131,317319,23812,7.0,"San Joaquin County, CA"
109,2022,Feb,345517,323952,21565,6.2,"San Joaquin County, CA"
110,2022,Mar,345094,325612,19482,5.6,"San Joaquin County, CA"
111,2022,Apr,340274,323345,16929,5.0,"San Joaquin County, CA"
112,2022,May,346015,330800,15215,4.4,"San Joaquin County, CA"
113,2022,Jun,337780,320649,17131,5.1,"San Joaquin County, CA"
114,2022,Jul,344347,327228,17119,5.0,"San Joaquin County, CA"
115,2022,Aug,345358,328261,17097,5.0,"San Joaquin County, CA"
116,2022,Sep,346054,330333,15721,4.5,"San Joaquin County, CA"
117,2022,Oct,347814,330997,16817,4.8,"San Joaquin County, CA"
118,2022,Nov,346744,328767,17977,5.2,"San Joaquin County, CA"
119,2022,Dec,346891,328952,17939,5.2,"San Joaquin County, CA"
120,2023,Jan,344698,322961,21737,6.3,"San Joaquin County, CA"
121,2023,Feb,350156,327544,22612,6.5,"San Joaquin County, CA"
122,2023,Mar,350420,326981,23439,6.7,"San Joaquin County, CA"
123,2023,Apr,346468,326294,20174,5.8,"San Joaquin County, CA"
124,2023,May,349927,329087,20840,6.0,"San Joaquin County, CA"
125,2023,Jun,344721,322868,21853,6.3,"San Joaquin County, CA"
126,2023,Jul,343971,322895,21076,6.1,"San Joaquin County, CA"
127,2023,Aug,347042,325433,21609,6.2,"San Joaquin County, CA"
128,2023,Sep,349533,329265,20268,5.8,"San Joaquin County, CA"
129,2023,Oct,349602,328064,21538,6.2,"San Joaquin County, CA"
0,2013,Jan,536324,489630,46694,8.7,"Contra Costa County, CA"
1,2013,Feb,535717,491599,44118,8.2,"Contra Costa County, CA"
2,2013,Mar,535170,492578,42592,8.0,"Contra Costa County, CA"
3,2013,Apr,533164,493997,39167,7.3,"Contra Costa County, CA"
4,2013,May,534911,495911,39000,7.3,"Contra Costa County, CA"
5,2013,Jun,536265,493335,42930,8.0,"Contra Costa County, CA"
6,2013,Jul,541305,498198,43107,8.0,"Contra Costa County, CA"
7,2013,Aug,537219,496174,41045,7.6,"Contra Costa County, CA"
8,2013,Sep,538006,498906,39100,7.3,"Contra Costa County, CA"
9,2013,Oct,534930,495906,39024,7.3,"Contra Costa County, CA"
10,2013,Nov,536105,498961,37144,6.9,"Contra Costa County, CA"
11,2013,Dec,533276,498326,34950,6.6,"Contra Costa County, CA"
12,2014,Jan,532376,495254,37122,7.0,"Contra Costa County, CA"
13,2014,Feb,535686,498282,37404,7.0,"Contra Costa County, CA"
14,2014,Mar,537450,500107,37343,6.9,"Contra Costa County, CA"
15,2014,Apr,532460,500558,31902,6.0,"Contra Costa County, CA"
16,2014,May,535900,503751,32149,6.0,"Contra Costa County, CA"
17,2014,Jun,538392,504097,34295,6.4,"Contra Costa County, CA"
18,2014,Jul,543123,506793,36330,6.7,"Contra Costa County, CA"
19,2014,Aug,539969,505113,34856,6.5,"Contra Costa County, CA"
20,2014,Sep,540291,508373,31918,5.9,"Contra Costa County, CA"
21,2014,Oct,542394,511026,31368,5.8,"Contra Costa County, CA"
22,2014,Nov,543344,512643,30701,5.7,"Contra Costa County, CA"
23,2014,Dec,540109,511854,28255,5.2,"Contra Costa County, CA"
24,2015,Jan,540406,509192,31214,5.8,"Contra Costa County, CA"
25,2015,Feb,541411,511471,29940,5.5,"Contra Costa County, CA"
26,2015,Mar,542772,513567,29205,5.4,"Contra Costa County, CA"
27,2015,Apr,541226,514364,26862,5.0,"Contra Costa County, CA"
28,2015,May,544683,517735,26948,4.9,"Contra Costa County, CA"
29,2015,Jun,544664,515970,28694,5.3,"Contra Costa County, CA"
30,2015,Jul,548455,518866,29589,5.4,"Contra Costa County, CA"
31,2015,Aug,546431,518762,27669,5.1,"Contra Costa County, CA"
32,2015,Sep,544956,519552,25404,4.7,"Contra Costa County, CA"
33,2015,Oct,546220,520369,25851,4.7,"Contra Costa County, CA"
34,2015,Nov,547062,521809,25253,4.6,"Contra Costa County, CA"
35,2015,Dec,547123,522923,24200,4.4,"Contra Costa County, CA"
36,2016,Jan,547713,521838,25875,4.7,"Contra Costa County, CA"
37,2016,Feb,551063,525518,25545,4.6,"Contra Costa County, CA"
38,2016,Mar,553349,527062,26287,4.8,"Contra Costa County, CA"
39,2016,Apr,549154,524928,24226,4.4,"Contra Costa County, CA"
40,2016,May,549852,527555,22297,4.1,"Contra Costa County, CA"
41,2016,Jun,552287,525952,26335,4.8,"Contra Costa County, CA"
42,2016,Jul,557107,530264,26843,4.8,"Contra Costa County, CA"
43,2016,Aug,554832,528711,26121,4.7,"Contra Costa County, CA"
44,2016,Sep,556610,531997,24613,4.4,"Contra Costa County, CA"
45,2016,Oct,556721,532300,24421,4.4,"Contra Costa County, CA"
46,2016,Nov,555859,532903,22956,4.1,"Contra Costa County, CA"
47,2016,Dec,554098,531779,22319,4.0,"Contra Costa County, CA"
48,2017,Jan,555334,530354,24980,4.5,"Contra Costa County, CA"
49,2017,Feb,558186,534249,23937,4.3,"Contra Costa County, CA"
50,2017,Mar,559708,536911,22797,4.1,"Contra Costa County, CA"
51,2017,Apr,553716,532978,20738,3.7,"Contra Costa County, CA"
52,2017,May,555002,535160,19842,3.6,"Contra Costa County, CA"
53,2017,Jun,556762,533875,22887,4.1,"Contra Costa County, CA"
54,2017,Jul,562150,538279,23871,4.2,"Contra Costa County, CA"
55,2017,Aug,558525,535345,23180,4.2,"Contra Costa County, CA"
56,2017,Sep,560988,540799,20189,3.6,"Contra Costa County, CA"
57,2017,Oct,559002,539574,19428,3.5,"Contra Costa County, CA"
58,2017,Nov,558362,539530,18832,3.4,"Contra Costa County, CA"
59,2017,Dec,556692,538595,18097,3.3,"Contra Costa County, CA"
60,2018,Jan,555154,534988,20166,3.6,"Contra Costa County, CA"
61,2018,Feb,560321,541056,19265,3.4,"Contra Costa County, CA"
62,2018,Mar,561173,542779,18394,3.3,"Contra Costa County, CA"
63,2018,Apr,556341,539593,16748,3.0,"Contra Costa County, CA"
64,2018,May,558602,543066,15536,2.8,"Contra Costa County, CA"
65,2018,Jun,559184,539989,19195,3.4,"Contra Costa County, CA"
66,2018,Jul,564486,545436,19050,3.4,"Contra Costa County, CA"
67,2018,Aug,559521,540861,18660,3.3,"Contra Costa County, CA"
68,2018,Sep,561910,544827,17083,3.0,"Contra Costa County, CA"
69,2018,Oct,562535,545050,17485,3.1,"Contra Costa County, CA"
70,2018,Nov,562452,545318,17134,3.0,"Contra Costa County, CA"
71,2018,Dec,562184,544642,17542,3.1,"Contra Costa County, CA"
72,2019,Jan,560252,539196,21056,3.8,"Contra Costa County, CA"
73,2019,Feb,563998,545176,18822,3.3,"Contra Costa County, CA"
74,2019,Mar,563798,544881,18917,3.4,"Contra Costa County, CA"
75,2019,Apr,555517,539863,15654,2.8,"Contra Costa County, CA"
76,2019,May,556720,541636,15084,2.7,"Contra Costa County, CA"
77,2019,Jun,557350,539314,18036,3.2,"Contra Costa County, CA"
78,2019,Jul,564405,545193,19212,3.4,"Contra Costa County, CA"
79,2019,Aug,561248,542957,18291,3.3,"Contra Costa County, CA"
80,2019,Sep,562589,546883,15706,2.8,"Contra Costa County, CA"
81,2019,Oct,561715,545239,16476,2.9,"Contra Costa County, CA"
82,2019,Nov,561781,545382,16399,2.9,"Contra Costa County, CA"
83,2019,Dec,562218,546460,15758,2.8,"Contra Costa County, CA"
84,2020,Jan,562849,544445,18404,3.3,"Contra Costa County, CA"
85,2020,Feb,567743,550283,17460,3.1,"Contra Costa County, CA"
86,2020,Mar,560078,534551,25527,4.6,"Contra Costa County, CA"
87,2020,Apr,540579,458033,82546,15.3,"Contra Costa County, CA"
88,2020,May,533626,457777,75849,14.2,"Contra Costa County, CA"
89,2020,Jun,548092,478249,69843,12.7,"Contra Costa County, CA"
90,2020,Jul,549151,483760,65391,11.9,"Contra Costa County, CA"
91,2020,Aug,543965,489916,54049,9.9,"Contra Costa County, CA"
92,2020,Sep,543066,491587,51479,9.5,"Contra Costa County, CA"
93,2020,Oct,542781,497703,45078,8.3,"Contra Costa County, CA"
94,2020,Nov,539128,495905,43223,8.0,"Contra Costa County, CA"
95,2020,Dec,537461,494886,42575,7.9,"Contra Costa County, CA"
96,2021,Jan,537190,494779,42411,7.9,"Contra Costa County, CA"
97,2021,Feb,540840,499753,41087,7.6,"Contra Costa County, CA"
98,2021,Mar,542286,502880,39406,7.3,"Contra Costa County, CA"
99,2021,Apr,538665,500165,38500,7.1,"Contra Costa County, CA"
100,2021,May,540312,504836,35476,6.6,"Contra Costa County, CA"
101,2021,Jun,544296,504717,39579,7.3,"Contra Costa County, CA"
102,2021,Jul,549301,511909,37392,6.8,"Contra Costa County, CA"
103,2021,Aug,546479,511285,35194,6.4,"Contra Costa County, CA"
104,2021,Sep,546442,516619,29823,5.5,"Contra Costa County, CA"
105,2021,Oct,547504,518829,28675,5.2,"Contra Costa County, CA"
106,2021,Nov,547983,522335,25648,4.7,"Contra Costa County, CA"
107,2021,Dec,546645,523415,23230,4.2,"Contra Costa County, CA"
108,2022,Jan,548663,522694,25969,4.7,"Contra Costa County, CA"
109,2022,Feb,552012,528938,23074,4.2,"Contra Costa County, CA"
110,2022,Mar,553715,533251,20464,3.7,"Contra Costa County, CA"
111,2022,Apr,544812,527091,17721,3.3,"Contra Costa County, CA"
112,2022,May,548152,531859,16293,3.0,"Contra Costa County, CA"
113,2022,Jun,549443,530277,19166,3.5,"Contra Costa County, CA"
114,2022,Jul,551995,533029,18966,3.4,"Contra Costa County, CA"
115,2022,Aug,552709,533292,19417,3.5,"Contra Costa County, CA"
116,2022,Sep,553623,536233,17390,3.1,"Contra Costa County, CA"
117,2022,Oct,555005,536515,18490,3.3,"Contra Costa County, CA"
118,2022,Nov,553801,534960,18841,3.4,"Contra Costa County, CA"
119,2022,Dec,553801,536583,17218,3.1,"Contra Costa County, CA"
120,2023,Jan,549838,528463,21375,3.9,"Contra Costa County, CA"
121,2023,Feb,555880,533816,22064,4.0,"Contra Costa County, CA"
122,2023,Mar,556556,534360,22196,4.0,"Contra Costa County, CA"
123,2023,Apr,550293,530646,19647,3.6,"Contra Costa County, CA"
124,2023,May,551223,530491,20732,3.8,"Contra Costa County, CA"
125,2023,Jun,550280,526938,23342,4.2,"Contra Costa County, CA"
126,2023,Jul,555552,532493,23059,4.2,"Contra Costa County, CA"
127,2023,Aug,553445,528450,24995,4.5,"Contra Costa County, CA"
128,2023,Sep,555211,531669,23542,4.2,"Contra Costa County, CA"
129,2023,Oct,554356,530115,24241,4.4,"Contra Costa County, CA"
0,2013,Jan,4908,4444,464,9.5,"Calhoun County, FL"
1,2013,Feb,4871,4447,424,8.7,"Calhoun County, FL"
2,2013,Mar,4881,4480,401,8.2,"Calhoun County, FL"
3,2013,Apr,4860,4477,383,7.9,"Calhoun County, FL"
4,2013,May,4970,4573,397,8.0,"Calhoun County, FL"
5,2013,Jun,4966,4541,425,8.6,"Calhoun County, FL"
6,2013,Jul,4967,4542,425,8.6,"Calhoun County, FL"
7,2013,Aug,4910,4507,403,8.2,"Calhoun County, FL"
8,2013,Sep,5000,4596,404,8.1,"Calhoun County, FL"
9,2013,Oct,4923,4540,383,7.8,"Calhoun County, FL"
10,2013,Nov,4842,4469,373,7.7,"Calhoun County, FL"
11,2013,Dec,4771,4416,355,7.4,"Calhoun County, FL"
12,2014,Jan,4847,4469,378,7.8,"Calhoun County, FL"
13,2014,Feb,4857,4495,362,7.5,"Calhoun County, FL"
14,2014,Mar,4909,4549,360,7.3,"Calhoun County, FL"
15,2014,Apr,4890,4572,318,6.5,"Calhoun County, FL"
16,2014,May,4977,4621,356,7.2,"Calhoun County, FL"
17,2014,Jun,4996,4611,385,7.7,"Calhoun County, FL"
18,2014,Jul,4983,4589,394,7.9,"Calhoun County, FL"
19,2014,Aug,4979,4604,375,7.5,"Calhoun County, FL"
20,2014,Sep,4998,4660,338,6.8,"Calhoun County, FL"
21,2014,Oct,5011,4684,327,6.5,"Calhoun County, FL"
22,2014,Nov,4906,4579,327,6.7,"Calhoun County, FL"
23,2014,Dec,4919,4602,317,6.4,"Calhoun County, FL"
24,2015,Jan,4961,4626,335,6.8,"Calhoun County, FL"
25,2015,Feb,4931,4625,306,6.2,"Calhoun County, FL"
26,2015,Mar,4992,4689,303,6.1,"Calhoun County, FL"
27,2015,Apr,4968,4679,289,5.8,"Calhoun County, FL"
28,2015,May,5042,4741,301,6.0,"Calhoun County, FL"
29,2015,Jun,4975,4648,327,6.6,"Calhoun County, FL"
30,2015,Jul,4854,4520,334,6.9,"Calhoun County, FL"
31,2015,Aug,4854,4541,313,6.4,"Calhoun County, FL"
32,2015,Sep,5009,4702,307,6.1,"Calhoun County, FL"
33,2015,Oct,5031,4739,292,5.8,"Calhoun County, FL"
34,2015,Nov,4959,4671,288,5.8,"Calhoun County, FL"
35,2015,Dec,4953,4671,282,5.7,"Calhoun County, FL"
36,2016,Jan,5003,4701,302,6.0,"Calhoun County, FL"
37,2016,Feb,5029,4749,280,5.6,"Calhoun County, FL"
38,2016,Mar,5060,4780,280,5.5,"Calhoun County, FL"
39,2016,Apr,5045,4769,276,5.5,"Calhoun County, FL"
40,2016,May,5121,4840,281,5.5,"Calhoun County, FL"
41,2016,Jun,5063,4751,312,6.2,"Calhoun County, FL"
42,2016,Jul,5026,4709,317,6.3,"Calhoun County, FL"
43,2016,Aug,5012,4702,310,6.2,"Calhoun County, FL"
44,2016,Sep,5022,4722,300,6.0,"Calhoun County, FL"
45,2016,Oct,4949,4663,286,5.8,"Calhoun County, FL"
46,2016,Nov,4873,4607,266,5.5,"Calhoun County, FL"
47,2016,Dec,4823,4558,265,5.5,"Calhoun County, FL"
48,2017,Jan,4909,4635,274,5.6,"Calhoun County, FL"
49,2017,Feb,4898,4650,248,5.1,"Calhoun County, FL"
50,2017,Mar,4914,4675,239,4.9,"Calhoun County, FL"
51,2017,Apr,4920,4691,229,4.7,"Calhoun County, FL"
52,2017,May,4967,4733,234,4.7,"Calhoun County, FL"
53,2017,Jun,5034,4763,271,5.4,"Calhoun County, FL"
54,2017,Jul,4814,4546,268,5.6,"Calhoun County, FL"
55,2017,Aug,4882,4612,270,5.5,"Calhoun County, FL"
56,2017,Sep,5050,4809,241,4.8,"Calhoun County, FL"
57,2017,Oct,5000,4779,221,4.4,"Calhoun County, FL"
58,2017,Nov,4937,4718,219,4.4,"Calhoun County, FL"
59,2017,Dec,4884,4670,214,4.4,"Calhoun County, FL"
60,2018,Jan,4923,4684,239,4.9,"Calhoun County, FL"
61,2018,Feb,4937,4723,214,4.3,"Calhoun County, FL"
62,2018,Mar,4942,4731,211,4.3,"Calhoun County, FL"
63,2018,Apr,4985,4789,196,3.9,"Calhoun County, FL"
64,2018,May,5020,4824,196,3.9,"Calhoun County, FL"
65,2018,Jun,5082,4856,226,4.4,"Calhoun County, FL"
66,2018,Jul,4887,4671,216,4.4,"Calhoun County, FL"
67,2018,Aug,4883,4670,213,4.4,"Calhoun County, FL"
68,2018,Sep,5001,4810,191,3.8,"Calhoun County, FL"
69,2018,Oct,4739,4548,191,4.0,"Calhoun County, FL"
70,2018,Nov,4797,4546,251,5.2,"Calhoun County, FL"
71,2018,Dec,4740,4522,218,4.6,"Calhoun County, FL"
72,2019,Jan,4728,4474,254,5.4,"Calhoun County, FL"
73,2019,Feb,4720,4505,215,4.6,"Calhoun County, FL"
74,2019,Mar,4713,4512,201,4.3,"Calhoun County, FL"
75,2019,Apr,4745,4570,175,3.7,"Calhoun County, FL"
76,2019,May,4809,4638,171,3.6,"Calhoun County, FL"
77,2019,Jun,4876,4678,198,4.1,"Calhoun County, FL"
78,2019,Jul,4672,4462,210,4.5,"Calhoun County, FL"
79,2019,Aug,4758,4549,209,4.4,"Calhoun County, FL"
80,2019,Sep,4871,4690,181,3.7,"Calhoun County, FL"
81,2019,Oct,4852,4672,180,3.7,"Calhoun County, FL"
82,2019,Nov,4789,4619,170,3.5,"Calhoun County, FL"
83,2019,Dec,4746,4591,155,3.3,"Calhoun County, FL"
84,2020,Jan,4775,4600,175,3.7,"Calhoun County, FL"
85,2020,Feb,4768,4630,138,2.9,"Calhoun County, FL"
86,2020,Mar,4743,4532,211,4.4,"Calhoun County, FL"
87,2020,Apr,4469,4177,292,6.5,"Calhoun County, FL"
88,2020,May,4658,4334,324,7.0,"Calhoun County, FL"
89,2020,Jun,4711,4398,313,6.6,"Calhoun County, FL"
90,2020,Jul,4640,4280,360,7.8,"Calhoun County, FL"
91,2020,Aug,4732,4459,273,5.8,"Calhoun County, FL"
92,2020,Sep,4879,4613,266,5.5,"Calhoun County, FL"
93,2020,Oct,4909,4654,255,5.2,"Calhoun County, FL"
94,2020,Nov,4875,4625,250,5.1,"Calhoun County, FL"
95,2020,Dec,4859,4627,232,4.8,"Calhoun County, FL"
96,2021,Jan,4826,4576,250,5.2,"Calhoun County, FL"
97,2021,Feb,4816,4579,237,4.9,"Calhoun County, FL"
98,2021,Mar,4851,4625,226,4.7,"Calhoun County, FL"
99,2021,Apr,4865,4649,216,4.4,"Calhoun County, FL"
100,2021,May,4928,4703,225,4.6,"Calhoun County, FL"
101,2021,Jun,4909,4649,260,5.3,"Calhoun County, FL"
102,2021,Jul,4875,4621,254,5.2,"Calhoun County, FL"
103,2021,Aug,4797,4568,229,4.8,"Calhoun County, FL"
104,2021,Sep,4861,4647,214,4.4,"Calhoun County, FL"
105,2021,Oct,4824,4611,213,4.4,"Calhoun County, FL"
106,2021,Nov,4741,4550,191,4.0,"Calhoun County, FL"
107,2021,Dec,4734,4565,169,3.6,"Calhoun County, FL"
108,2022,Jan,4809,4603,206,4.3,"Calhoun County, FL"
109,2022,Feb,4772,4592,180,3.8,"Calhoun County, FL"
110,2022,Mar,4799,4640,159,3.3,"Calhoun County, FL"
111,2022,Apr,4817,4675,142,2.9,"Calhoun County, FL"
112,2022,May,4887,4740,147,3.0,"Calhoun County, FL"
113,2022,Jun,4857,4674,183,3.8,"Calhoun County, FL"
114,2022,Jul,4808,4649,159,3.3,"Calhoun County, FL"
115,2022,Aug,4855,4693,162,3.3,"Calhoun County, FL"
116,2022,Sep,4916,4763,153,3.1,"Calhoun County, FL"
117,2022,Oct,4856,4711,145,3.0,"Calhoun County, FL"
118,2022,Nov,4839,4694,145,3.0,"Calhoun County, FL"
119,2022,Dec,4835,4715,120,2.5,"Calhoun County, FL"
120,2023,Jan,4868,4719,149,3.1,"Calhoun County, FL"
121,2023,Feb,4904,4755,149,3.0,"Calhoun County, FL"
122,2023,Mar,4970,4825,145,2.9,"Calhoun County, FL"
123,2023,Apr,4957,4830,127,2.6,"Calhoun County, FL"
124,2023,May,4987,4847,140,2.8,"Calhoun County, FL"
125,2023,Jun,5033,4868,165,3.3,"Calhoun County, FL"
126,2023,Jul,4875,4697,178,3.7,"Calhoun County, FL"
127,2023,Aug,4907,4732,175,3.6,"Calhoun County, FL"
128,2023,Sep,5035,4861,174,3.5,"Calhoun County, FL"
129,2023,Oct,5029,4847,182,3.6,"Calhoun County, FL"
0,2013,Jan,1294697,1194749,99948,7.7,"Miami-Dade County, FL"
1,2013,Feb,1279724,1184609,95115,7.4,"Miami-Dade County, FL"
2,2013,Mar,1255728,1158257,97471,7.8,"Miami-Dade County, FL"
3,2013,Apr,1277107,1182250,94857,7.4,"Miami-Dade County, FL"
4,2013,May,1277483,1181022,96461,7.6,"Miami-Dade County, FL"
5,2013,Jun,1263309,1162945,100364,7.9,"Miami-Dade County, FL"
6,2013,Jul,1271597,1170997,100600,7.9,"Miami-Dade County, FL"
7,2013,Aug,1263298,1162715,100583,8.0,"Miami-Dade County, FL"
8,2013,Sep,1266394,1166332,100062,7.9,"Miami-Dade County, FL"
9,2013,Oct,1269456,1171405,98051,7.7,"Miami-Dade County, FL"
10,2013,Nov,1271423,1181461,89962,7.1,"Miami-Dade County, FL"
11,2013,Dec,1283593,1196795,86798,6.8,"Miami-Dade County, FL"
12,2014,Jan,1293522,1205832,87690,6.8,"Miami-Dade County, FL"
13,2014,Feb,1289391,1201593,87798,6.8,"Miami-Dade County, FL"
14,2014,Mar,1266037,1173058,92979,7.3,"Miami-Dade County, FL"
15,2014,Apr,1288846,1204062,84784,6.6,"Miami-Dade County, FL"
16,2014,May,1295043,1206746,88297,6.8,"Miami-Dade County, FL"
17,2014,Jun,1299533,1211002,88531,6.8,"Miami-Dade County, FL"
18,2014,Jul,1318520,1224681,93839,7.1,"Miami-Dade County, FL"
19,2014,Aug,1305015,1211209,93806,7.2,"Miami-Dade County, FL"
20,2014,Sep,1301797,1211833,89964,6.9,"Miami-Dade County, FL"
21,2014,Oct,1311186,1225121,86065,6.6,"Miami-Dade County, FL"
22,2014,Nov,1307651,1225652,81999,6.3,"Miami-Dade County, FL"
23,2014,Dec,1301808,1223367,78441,6.0,"Miami-Dade County, FL"
24,2015,Jan,1313820,1232716,81104,6.2,"Miami-Dade County, FL"
25,2015,Feb,1304656,1226764,77892,6.0,"Miami-Dade County, FL"
26,2015,Mar,1274222,1193000,81222,6.4,"Miami-Dade County, FL"
27,2015,Apr,1300002,1220470,79532,6.1,"Miami-Dade County, FL"
28,2015,May,1303039,1220468,82571,6.3,"Miami-Dade County, FL"
29,2015,Jun,1278659,1197678,80981,6.3,"Miami-Dade County, FL"
30,2015,Jul,1298443,1215079,83364,6.4,"Miami-Dade County, FL"
31,2015,Aug,1290867,1209011,81856,6.3,"Miami-Dade County, FL"
32,2015,Sep,1287740,1207247,80493,6.3,"Miami-Dade County, FL"
33,2015,Oct,1296408,1217785,78623,6.1,"Miami-Dade County, FL"
34,2015,Nov,1294048,1220511,73537,5.7,"Miami-Dade County, FL"
35,2015,Dec,1301368,1229552,71816,5.5,"Miami-Dade County, FL"
36,2016,Jan,1307525,1236441,71084,5.4,"Miami-Dade County, FL"
37,2016,Feb,1296691,1227811,68880,5.3,"Miami-Dade County, FL"
38,2016,Mar,1280886,1206032,74854,5.8,"Miami-Dade County, FL"
39,2016,Apr,1298337,1225677,72660,5.6,"Miami-Dade County, FL"
40,2016,May,1289757,1220472,69285,5.4,"Miami-Dade County, FL"
41,2016,Jun,1287118,1214132,72986,5.7,"Miami-Dade County, FL"
42,2016,Jul,1307628,1232392,75236,5.8,"Miami-Dade County, FL"
43,2016,Aug,1301479,1225191,76288,5.9,"Miami-Dade County, FL"
44,2016,Sep,1309799,1231607,78192,6.0,"Miami-Dade County, FL"
45,2016,Oct,1327805,1253788,74017,5.6,"Miami-Dade County, FL"
46,2016,Nov,1321561,1254495,67066,5.1,"Miami-Dade County, FL"
47,2016,Dec,1334511,1268305,66206,5.0,"Miami-Dade County, FL"
48,2017,Jan,1337510,1268136,69374,5.2,"Miami-Dade County, FL"
49,2017,Feb,1337215,1270608,66607,5.0,"Miami-Dade County, FL"
50,2017,Mar,1321989,1253682,68307,5.2,"Miami-Dade County, FL"
51,2017,Apr,1364975,1300603,64372,4.7,"Miami-Dade County, FL"
52,2017,May,1358101,1294180,63921,4.7,"Miami-Dade County, FL"
53,2017,Jun,1342069,1277541,64528,4.8,"Miami-Dade County, FL"
54,2017,Jul,1369401,1302839,66562,4.9,"Miami-Dade County, FL"
55,2017,Aug,1347183,1278657,68526,5.1,"Miami-Dade County, FL"
56,2017,Sep,1354248,1289406,64842,4.8,"Miami-Dade County, FL"
57,2017,Oct,1348942,1289688,59254,4.4,"Miami-Dade County, FL"
58,2017,Nov,1347800,1289569,58231,4.3,"Miami-Dade County, FL"
59,2017,Dec,1357598,1299602,57996,4.3,"Miami-Dade County, FL"
60,2018,Jan,1353731,1297150,56581,4.2,"Miami-Dade County, FL"
61,2018,Feb,1363728,1309065,54663,4.0,"Miami-Dade County, FL"
62,2018,Mar,1340823,1283522,57301,4.3,"Miami-Dade County, FL"
63,2018,Apr,1359648,1309004,50644,3.7,"Miami-Dade County, FL"
64,2018,May,1357593,1310095,47498,3.5,"Miami-Dade County, FL"
65,2018,Jun,1350964,1300610,50354,3.7,"Miami-Dade County, FL"
66,2018,Jul,1353623,1301116,52507,3.9,"Miami-Dade County, FL"
67,2018,Aug,1341413,1291261,50152,3.7,"Miami-Dade County, FL"
68,2018,Sep,1342450,1296065,46385,3.5,"Miami-Dade County, FL"
69,2018,Oct,1351541,1306683,44858,3.3,"Miami-Dade County, FL"
70,2018,Nov,1355597,1313584,42013,3.1,"Miami-Dade County, FL"
71,2018,Dec,1377027,1331231,45796,3.3,"Miami-Dade County, FL"
72,2019,Jan,1389975,1344578,45397,3.3,"Miami-Dade County, FL"
73,2019,Feb,1388645,1348363,40282,2.9,"Miami-Dade County, FL"
74,2019,Mar,1361518,1317162,44356,3.3,"Miami-Dade County, FL"
75,2019,Apr,1375984,1337388,38596,2.8,"Miami-Dade County, FL"
76,2019,May,1370993,1332063,38930,2.8,"Miami-Dade County, FL"
77,2019,Jun,1370454,1329431,41023,3.0,"Miami-Dade County, FL"
78,2019,Jul,1381109,1336206,44903,3.3,"Miami-Dade County, FL"
79,2019,Aug,1379975,1335418,44557,3.2,"Miami-Dade County, FL"
80,2019,Sep,1377789,1337758,40031,2.9,"Miami-Dade County, FL"
81,2019,Oct,1400604,1363939,36665,2.6,"Miami-Dade County, FL"
82,2019,Nov,1380837,1347824,33013,2.4,"Miami-Dade County, FL"
83,2019,Dec,1393720,1360804,32916,2.4,"Miami-Dade County, FL"
84,2020,Jan,1399104,1367454,31650,2.3,"Miami-Dade County, FL"
85,2020,Feb,1405363,1375740,29623,2.1,"Miami-Dade County, FL"
86,2020,Mar,1285173,1245652,39521,3.1,"Miami-Dade County, FL"
87,2020,Apr,1194706,1062869,131837,11.0,"Miami-Dade County, FL"
88,2020,May,1211842,1066995,144847,12.0,"Miami-Dade County, FL"
89,2020,Jun,1223167,1083772,139395,11.4,"Miami-Dade County, FL"
90,2020,Jul,1242074,1102438,139636,11.2,"Miami-Dade County, FL"
91,2020,Aug,1262882,1135061,127821,10.1,"Miami-Dade County, FL"
92,2020,Sep,1269190,1137912,131278,10.3,"Miami-Dade County, FL"
93,2020,Oct,1287072,1169287,117785,9.2,"Miami-Dade County, FL"
94,2020,Nov,1284667,1171412,113255,8.8,"Miami-Dade County, FL"
95,2020,Dec,1301973,1185186,116787,9.0,"Miami-Dade County, FL"
96,2021,Jan,1296968,1192087,104881,8.1,"Miami-Dade County, FL"
97,2021,Feb,1309755,1212345,97410,7.4,"Miami-Dade County, FL"
98,2021,Mar,1291858,1195579,96279,7.5,"Miami-Dade County, FL"
99,2021,Apr,1317006,1230627,86379,6.6,"Miami-Dade County, FL"
100,2021,May,1319907,1241414,78493,5.9,"Miami-Dade County, FL"
101,2021,Jun,1316146,1236040,80106,6.1,"Miami-Dade County, FL"
102,2021,Jul,1340708,1265992,74716,5.6,"Miami-Dade County, FL"
103,2021,Aug,1330550,1261437,69113,5.2,"Miami-Dade County, FL"
104,2021,Sep,1332456,1273484,58972,4.4,"Miami-Dade County, FL"
105,2021,Oct,1339308,1289836,49472,3.7,"Miami-Dade County, FL"
106,2021,Nov,1344253,1299496,44757,3.3,"Miami-Dade County, FL"
107,2021,Dec,1345385,1304718,40667,3.0,"Miami-Dade County, FL"
108,2022,Jan,1358707,1314933,43774,3.2,"Miami-Dade County, FL"
109,2022,Feb,1372977,1333320,39657,2.9,"Miami-Dade County, FL"
110,2022,Mar,1353913,1313296,40617,3.0,"Miami-Dade County, FL"
111,2022,Apr,1361251,1325974,35277,2.6,"Miami-Dade County, FL"
112,2022,May,1362628,1328690,33938,2.5,"Miami-Dade County, FL"
113,2022,Jun,1363068,1327233,35835,2.6,"Miami-Dade County, FL"
114,2022,Jul,1368585,1329633,38952,2.8,"Miami-Dade County, FL"
115,2022,Aug,1380890,1340712,40178,2.9,"Miami-Dade County, FL"
116,2022,Sep,1368450,1332910,35540,2.6,"Miami-Dade County, FL"
117,2022,Oct,1386267,1353554,32713,2.4,"Miami-Dade County, FL"
118,2022,Nov,1379414,1350633,28781,2.1,"Miami-Dade County, FL"
119,2022,Dec,1397307,1369536,27771,2.0,"Miami-Dade County, FL"
120,2023,Jan,1374365,1347436,26929,2.0,"Miami-Dade County, FL"
121,2023,Feb,1398892,1375295,23597,1.7,"Miami-Dade County, FL"
122,2023,Mar,1398332,1373339,24993,1.8,"Miami-Dade County, FL"
123,2023,Apr,1387286,1362196,25090,1.8,"Miami-Dade County, FL"
124,2023,May,1364097,1334671,29426,2.2,"Miami-Dade County, FL"
125,2023,Jun,1372094,1342460,29634,2.2,"Miami-Dade County, FL"
126,2023,Jul,1389199,1363100,26099,1.9,"Miami-Dade County, FL"
127,2023,Aug,1382426,1356531,25895,1.9,"Miami-Dade County, FL"
128,2023,Sep,1386511,1365344,21167,1.5,"Miami-Dade County, FL"
129,2023,Oct,1372822,1351471,21351,1.6,"Miami-Dade County, FL"
0,2013,Jan,29162,25256,3906,13.4,"Lake County, CA"
1,2013,Feb,28969,25341,3628,12.5,"Lake County, CA"
2,2013,Mar,28804,25332,3472,12.1,"Lake County, CA"
3,2013,Apr,28613,25404,3209,11.2,"Lake County, CA"
4,2013,May,29385,26307,3078,10.5,"Lake County, CA"
5,2013,Jun,29240,25978,3262,11.2,"Lake County, CA"
6,2013,Jul,29651,26461,3190,10.8,"Lake County, CA"
7,2013,Aug,29909,26882,3027,10.1,"Lake County, CA"
8,2013,Sep,29364,26439,2925,10.0,"Lake County, CA"
9,2013,Oct,29106,26166,2940,10.1,"Lake County, CA"
10,2013,Nov,28952,25948,3004,10.4,"Lake County, CA"
11,2013,Dec,28809,25817,2992,10.4,"Lake County, CA"
12,2014,Jan,29128,25991,3137,10.8,"Lake County, CA"
13,2014,Feb,29370,26331,3039,10.3,"Lake County, CA"
14,2014,Mar,29520,26451,3069,10.4,"Lake County, CA"
15,2014,Apr,29134,26480,2654,9.1,"Lake County, CA"
16,2014,May,29517,27022,2495,8.5,"Lake County, CA"
17,2014,Jun,29394,26845,2549,8.7,"Lake County, CA"
18,2014,Jul,29200,26573,2627,9.0,"Lake County, CA"
19,2014,Aug,29967,27462,2505,8.4,"Lake County, CA"
20,2014,Sep,29328,26980,2348,8.0,"Lake County, CA"
21,2014,Oct,29039,26718,2321,8.0,"Lake County, CA"
22,2014,Nov,28630,26140,2490,8.7,"Lake County, CA"
23,2014,Dec,28525,26024,2501,8.8,"Lake County, CA"
24,2015,Jan,28824,26104,2720,9.4,"Lake County, CA"
25,2015,Feb,29130,26573,2557,8.8,"Lake County, CA"
26,2015,Mar,29152,26683,2469,8.5,"Lake County, CA"
27,2015,Apr,29162,26969,2193,7.5,"Lake County, CA"
28,2015,May,29618,27514,2104,7.1,"Lake County, CA"
29,2015,Jun,29258,27093,2165,7.4,"Lake County, CA"
30,2015,Jul,28710,26561,2149,7.5,"Lake County, CA"
31,2015,Aug,29676,27665,2011,6.8,"Lake County, CA"
32,2015,Sep,28897,27006,1891,6.5,"Lake County, CA"
33,2015,Oct,28505,26442,2063,7.2,"Lake County, CA"
34,2015,Nov,28565,26438,2127,7.4,"Lake County, CA"
35,2015,Dec,28578,26432,2146,7.5,"Lake County, CA"
36,2016,Jan,28700,26411,2289,8.0,"Lake County, CA"
37,2016,Feb,29114,26902,2212,7.6,"Lake County, CA"
38,2016,Mar,29194,26983,2211,7.6,"Lake County, CA"
39,2016,Apr,28910,26965,1945,6.7,"Lake County, CA"
40,2016,May,29242,27518,1724,5.9,"Lake County, CA"
41,2016,Jun,29153,27262,1891,6.5,"Lake County, CA"
42,2016,Jul,28676,26809,1867,6.5,"Lake County, CA"
43,2016,Aug,29564,27723,1841,6.2,"Lake County, CA"
44,2016,Sep,29380,27611,1769,6.0,"Lake County, CA"
45,2016,Oct,29185,27359,1826,6.3,"Lake County, CA"
46,2016,Nov,28871,26947,1924,6.7,"Lake County, CA"
47,2016,Dec,28815,26810,2005,7.0,"Lake County, CA"
48,2017,Jan,29328,27178,2150,7.3,"Lake County, CA"
49,2017,Feb,29484,27442,2042,6.9,"Lake County, CA"
50,2017,Mar,29758,27859,1899,6.4,"Lake County, CA"
51,2017,Apr,29233,27548,1685,5.8,"Lake County, CA"
52,2017,May,29377,27844,1533,5.2,"Lake County, CA"
53,2017,Jun,29314,27661,1653,5.6,"Lake County, CA"
54,2017,Jul,29260,27565,1695,5.8,"Lake County, CA"
55,2017,Aug,29908,28282,1626,5.4,"Lake County, CA"
56,2017,Sep,29585,28135,1450,4.9,"Lake County, CA"
57,2017,Oct,29131,27627,1504,5.2,"Lake County, CA"
58,2017,Nov,28559,27009,1550,5.4,"Lake County, CA"
59,2017,Dec,28685,27023,1662,5.8,"Lake County, CA"
60,2018,Jan,29096,27271,1825,6.3,"Lake County, CA"
61,2018,Feb,29539,27820,1719,5.8,"Lake County, CA"
62,2018,Mar,29485,27788,1697,5.8,"Lake County, CA"
63,2018,Apr,28812,27273,1539,5.3,"Lake County, CA"
64,2018,May,29036,27723,1313,4.5,"Lake County, CA"
65,2018,Jun,29199,27693,1506,5.2,"Lake County, CA"
66,2018,Jul,28863,27391,1472,5.1,"Lake County, CA"
67,2018,Aug,29096,27617,1479,5.1,"Lake County, CA"
68,2018,Sep,29038,27693,1345,4.6,"Lake County, CA"
69,2018,Oct,29089,27673,1416,4.9,"Lake County, CA"
70,2018,Nov,28762,27296,1466,5.1,"Lake County, CA"
71,2018,Dec,28831,27146,1685,5.8,"Lake County, CA"
72,2019,Jan,29125,27171,1954,6.7,"Lake County, CA"
73,2019,Feb,29419,27651,1768,6.0,"Lake County, CA"
74,2019,Mar,29232,27505,1727,5.9,"Lake County, CA"
75,2019,Apr,29111,27662,1449,5.0,"Lake County, CA"
76,2019,May,29190,27952,1238,4.2,"Lake County, CA"
77,2019,Jun,29257,27840,1417,4.8,"Lake County, CA"
78,2019,Jul,28768,27309,1459,5.1,"Lake County, CA"
79,2019,Aug,29260,27914,1346,4.6,"Lake County, CA"
80,2019,Sep,29067,27877,1190,4.1,"Lake County, CA"
81,2019,Oct,29010,27697,1313,4.5,"Lake County, CA"
82,2019,Nov,28597,27163,1434,5.0,"Lake County, CA"
83,2019,Dec,28729,27175,1554,5.4,"Lake County, CA"
84,2020,Jan,28792,27009,1783,6.2,"Lake County, CA"
85,2020,Feb,29226,27548,1678,5.7,"Lake County, CA"
86,2020,Mar,29047,26683,2364,8.1,"Lake County, CA"
87,2020,Apr,28259,23669,4590,16.2,"Lake County, CA"
88,2020,May,27789,23773,4016,14.5,"Lake County, CA"
89,2020,Jun,28518,25058,3460,12.1,"Lake County, CA"
90,2020,Jul,28235,25140,3095,11.0,"Lake County, CA"
91,2020,Aug,28688,26104,2584,9.0,"Lake County, CA"
92,2020,Sep,28856,26311,2545,8.8,"Lake County, CA"
93,2020,Oct,28491,26150,2341,8.2,"Lake County, CA"
94,2020,Nov,28230,25819,2411,8.5,"Lake County, CA"
95,2020,Dec,28024,25487,2537,9.1,"Lake County, CA"
96,2021,Jan,28871,26149,2722,9.4,"Lake County, CA"
97,2021,Feb,28931,26312,2619,9.1,"Lake County, CA"
98,2021,Mar,28944,26391,2553,8.8,"Lake County, CA"
99,2021,Apr,28427,26034,2393,8.4,"Lake County, CA"
100,2021,May,28630,26479,2151,7.5,"Lake County, CA"
101,2021,Jun,28575,26232,2343,8.2,"Lake County, CA"
102,2021,Jul,28412,26194,2218,7.8,"Lake County, CA"
103,2021,Aug,28516,26434,2082,7.3,"Lake County, CA"
104,2021,Sep,28488,26673,1815,6.4,"Lake County, CA"
105,2021,Oct,28091,26322,1769,6.3,"Lake County, CA"
106,2021,Nov,27728,26007,1721,6.2,"Lake County, CA"
107,2021,Dec,27731,26075,1656,6.0,"Lake County, CA"
108,2022,Jan,29065,27149,1916,6.6,"Lake County, CA"
109,2022,Feb,29189,27521,1668,5.7,"Lake County, CA"
110,2022,Mar,29298,27789,1509,5.2,"Lake County, CA"
111,2022,Apr,28291,26979,1312,4.6,"Lake County, CA"
112,2022,May,28520,27368,1152,4.0,"Lake County, CA"
113,2022,Jun,28270,26972,1298,4.6,"Lake County, CA"
114,2022,Jul,28126,26850,1276,4.5,"Lake County, CA"
115,2022,Aug,28598,27308,1290,4.5,"Lake County, CA"
116,2022,Sep,28482,27268,1214,4.3,"Lake County, CA"
117,2022,Oct,28223,26891,1332,4.7,"Lake County, CA"
118,2022,Nov,28078,26588,1490,5.3,"Lake County, CA"
119,2022,Dec,28224,26711,1513,5.4,"Lake County, CA"
120,2023,Jan,28571,26642,1929,6.8,"Lake County, CA"
121,2023,Feb,28714,26889,1825,6.4,"Lake County, CA"
122,2023,Mar,29016,27172,1844,6.4,"Lake County, CA"
123,2023,Apr,27788,26278,1510,5.4,"Lake County, CA"
124,2023,May,28034,26478,1556,5.6,"Lake County, CA"
125,2023,Jun,27824,26282,1542,5.5,"Lake County, CA"
126,2023,Jul,27710,26231,1479,5.3,"Lake County, CA"
127,2023,Aug,28190,26612,1578,5.6,"Lake County, CA"
128,2023,Sep,28046,26582,1464,5.2,"Lake County, CA"
129,2023,Oct,27889,26327,1562,5.6,"Lake County, CA"
0,2013,Jan,58320,48699,9621,16.5,"Kings County, CA"
1,2013,Feb,58415,49271,9144,15.7,"Kings County, CA"
2,2013,Mar,58011,49064,8947,15.4,"Kings County, CA"
3,2013,Apr,57890,49666,8224,14.2,"Kings County, CA"
4,2013,May,59669,51994,7675,12.9,"Kings County, CA"
5,2013,Jun,58601,50632,7969,13.6,"Kings County, CA"
6,2013,Jul,59046,51503,7543,12.8,"Kings County, CA"
7,2013,Aug,57965,50869,7096,12.2,"Kings County, CA"
8,2013,Sep,58007,51353,6654,11.5,"Kings County, CA"
9,2013,Oct,56894,49853,7041,12.4,"Kings County, CA"
10,2013,Nov,56926,49718,7208,12.7,"Kings County, CA"
11,2013,Dec,56594,49150,7444,13.2,"Kings County, CA"
12,2014,Jan,57165,48765,8400,14.7,"Kings County, CA"
13,2014,Feb,57389,48927,8462,14.7,"Kings County, CA"
14,2014,Mar,57277,48887,8390,14.6,"Kings County, CA"
15,2014,Apr,57088,49861,7227,12.7,"Kings County, CA"
16,2014,May,57054,50504,6550,11.5,"Kings County, CA"
17,2014,Jun,57372,50533,6839,11.9,"Kings County, CA"
18,2014,Jul,58031,51368,6663,11.5,"Kings County, CA"
19,2014,Aug,57796,51656,6140,10.6,"Kings County, CA"
20,2014,Sep,57084,51597,5487,9.6,"Kings County, CA"
21,2014,Oct,58043,52121,5922,10.2,"Kings County, CA"
22,2014,Nov,56821,50458,6363,11.2,"Kings County, CA"
23,2014,Dec,57200,50681,6519,11.4,"Kings County, CA"
24,2015,Jan,57757,50317,7440,12.9,"Kings County, CA"
25,2015,Feb,57562,50379,7183,12.5,"Kings County, CA"
26,2015,Mar,57766,50561,7205,12.5,"Kings County, CA"
27,2015,Apr,57825,51472,6353,11.0,"Kings County, CA"
28,2015,May,58919,53017,5902,10.0,"Kings County, CA"
29,2015,Jun,58097,51908,6189,10.7,"Kings County, CA"
30,2015,Jul,58468,52725,5743,9.8,"Kings County, CA"
31,2015,Aug,57873,52624,5249,9.1,"Kings County, CA"
32,2015,Sep,57266,52458,4808,8.4,"Kings County, CA"
33,2015,Oct,57374,51980,5394,9.4,"Kings County, CA"
34,2015,Nov,56843,51051,5792,10.2,"Kings County, CA"
35,2015,Dec,56992,51039,5953,10.4,"Kings County, CA"
36,2016,Jan,57344,50561,6783,11.8,"Kings County, CA"
37,2016,Feb,57112,50293,6819,11.9,"Kings County, CA"
38,2016,Mar,57584,50663,6921,12.0,"Kings County, CA"
39,2016,Apr,57082,51234,5848,10.2,"Kings County, CA"
40,2016,May,57693,52609,5084,8.8,"Kings County, CA"
41,2016,Jun,57459,51712,5747,10.0,"Kings County, CA"
42,2016,Jul,57554,52147,5407,9.4,"Kings County, CA"
43,2016,Aug,57264,52219,5045,8.8,"Kings County, CA"
44,2016,Sep,56793,52059,4734,8.3,"Kings County, CA"
45,2016,Oct,56535,51506,5029,8.9,"Kings County, CA"
46,2016,Nov,56849,51516,5333,9.4,"Kings County, CA"
47,2016,Dec,56659,50830,5829,10.3,"Kings County, CA"
48,2017,Jan,57352,50811,6541,11.4,"Kings County, CA"
49,2017,Feb,57705,50930,6775,11.7,"Kings County, CA"
50,2017,Mar,57196,50790,6406,11.2,"Kings County, CA"
51,2017,Apr,57044,51511,5533,9.7,"Kings County, CA"
52,2017,May,57452,52817,4635,8.1,"Kings County, CA"
53,2017,Jun,57664,52520,5144,8.9,"Kings County, CA"
54,2017,Jul,57981,53129,4852,8.4,"Kings County, CA"
55,2017,Aug,57484,53017,4467,7.8,"Kings County, CA"
56,2017,Sep,57043,53070,3973,7.0,"Kings County, CA"
57,2017,Oct,56847,52839,4008,7.1,"Kings County, CA"
58,2017,Nov,56636,52217,4419,7.8,"Kings County, CA"
59,2017,Dec,56773,51947,4826,8.5,"Kings County, CA"
60,2018,Jan,57881,52434,5447,9.4,"Kings County, CA"
61,2018,Feb,58923,53234,5689,9.7,"Kings County, CA"
62,2018,Mar,57812,52314,5498,9.5,"Kings County, CA"
63,2018,Apr,57329,52536,4793,8.4,"Kings County, CA"
64,2018,May,57695,53693,4002,6.9,"Kings County, CA"
65,2018,Jun,56874,52257,4617,8.1,"Kings County, CA"
66,2018,Jul,57680,53328,4352,7.5,"Kings County, CA"
67,2018,Aug,57333,53438,3895,6.8,"Kings County, CA"
68,2018,Sep,57042,53535,3507,6.1,"Kings County, CA"
69,2018,Oct,56417,52764,3653,6.5,"Kings County, CA"
70,2018,Nov,57180,53103,4077,7.1,"Kings County, CA"
71,2018,Dec,57760,52980,4780,8.3,"Kings County, CA"
72,2019,Jan,58094,52327,5767,9.9,"Kings County, CA"
73,2019,Feb,58785,53012,5773,9.8,"Kings County, CA"
74,2019,Mar,58236,52524,5712,9.8,"Kings County, CA"
75,2019,Apr,57654,52909,4745,8.2,"Kings County, CA"
76,2019,May,58252,54276,3976,6.8,"Kings County, CA"
77,2019,Jun,57414,52888,4526,7.9,"Kings County, CA"
78,2019,Jul,58170,53713,4457,7.7,"Kings County, CA"
79,2019,Aug,57859,53865,3994,6.9,"Kings County, CA"
80,2019,Sep,57826,54338,3488,6.0,"Kings County, CA"
81,2019,Oct,57646,53817,3829,6.6,"Kings County, CA"
82,2019,Nov,57562,53260,4302,7.5,"Kings County, CA"
83,2019,Dec,57580,52929,4651,8.1,"Kings County, CA"
84,2020,Jan,57994,52432,5562,9.6,"Kings County, CA"
85,2020,Feb,58643,52936,5707,9.7,"Kings County, CA"
86,2020,Mar,59509,51257,8252,13.9,"Kings County, CA"
87,2020,Apr,57794,47901,9893,17.1,"Kings County, CA"
88,2020,May,57516,48783,8733,15.2,"Kings County, CA"
89,2020,Jun,57021,49507,7514,13.2,"Kings County, CA"
90,2020,Jul,57195,50109,7086,12.4,"Kings County, CA"
91,2020,Aug,56140,50269,5871,10.5,"Kings County, CA"
92,2020,Sep,55738,50054,5684,10.2,"Kings County, CA"
93,2020,Oct,55884,50573,5311,9.5,"Kings County, CA"
94,2020,Nov,55724,50127,5597,10.0,"Kings County, CA"
95,2020,Dec,56232,50177,6055,10.8,"Kings County, CA"
96,2021,Jan,56509,50103,6406,11.3,"Kings County, CA"
97,2021,Feb,56103,49550,6553,11.7,"Kings County, CA"
98,2021,Mar,54899,48530,6369,11.6,"Kings County, CA"
99,2021,Apr,54772,48697,6075,11.1,"Kings County, CA"
100,2021,May,56146,50682,5464,9.7,"Kings County, CA"
101,2021,Jun,55525,49404,6121,11.0,"Kings County, CA"
102,2021,Jul,55923,50403,5520,9.9,"Kings County, CA"
103,2021,Aug,55400,50390,5010,9.0,"Kings County, CA"
104,2021,Sep,55243,50909,4334,7.8,"Kings County, CA"
105,2021,Oct,55125,50851,4274,7.8,"Kings County, CA"
106,2021,Nov,54641,50526,4115,7.5,"Kings County, CA"
107,2021,Dec,55197,50934,4263,7.7,"Kings County, CA"
108,2022,Jan,56251,51110,5141,9.1,"Kings County, CA"
109,2022,Feb,56216,51220,4996,8.9,"Kings County, CA"
110,2022,Mar,55759,51195,4564,8.2,"Kings County, CA"
111,2022,Apr,55653,51735,3918,7.0,"Kings County, CA"
112,2022,May,56112,52646,3466,6.2,"Kings County, CA"
113,2022,Jun,55569,51826,3743,6.7,"Kings County, CA"
114,2022,Jul,56395,52766,3629,6.4,"Kings County, CA"
115,2022,Aug,56661,53191,3470,6.1,"Kings County, CA"
116,2022,Sep,56820,53707,3113,5.5,"Kings County, CA"
117,2022,Oct,56960,53484,3476,6.1,"Kings County, CA"
118,2022,Nov,57223,53402,3821,6.7,"Kings County, CA"
119,2022,Dec,57764,53708,4056,7.0,"Kings County, CA"
120,2023,Jan,57863,52853,5010,8.7,"Kings County, CA"
121,2023,Feb,58635,53127,5508,9.4,"Kings County, CA"
122,2023,Mar,58459,52721,5738,9.8,"Kings County, CA"
123,2023,Apr,57613,52823,4790,8.3,"Kings County, CA"
124,2023,May,58480,53794,4686,8.0,"Kings County, CA"
125,2023,Jun,57279,52454,4825,8.4,"Kings County, CA"
126,2023,Jul,57608,53027,4581,8.0,"Kings County, CA"
127,2023,Aug,57025,52612,4413,7.7,"Kings County, CA"
128,2023,Sep,57324,53341,3983,6.9,"Kings County, CA"
129,2023,Oct,57591,53326,4265,7.4,"Kings County, CA"
0,2013,Jan,128531,114297,14234,11.1,"St. Lucie County, FL"
1,2013,Feb,128069,114860,13209,10.3,"St. Lucie County, FL"
2,2013,Mar,128146,115498,12648,9.9,"St. Lucie County, FL"
3,2013,Apr,127970,115435,12535,9.8,"St. Lucie County, FL"
4,2013,May,129581,116477,13104,10.1,"St. Lucie County, FL"
5,2013,Jun,129534,115141,14393,11.1,"St. Lucie County, FL"
6,2013,Jul,129184,114748,14436,11.2,"St. Lucie County, FL"
7,2013,Aug,130181,115631,14550,11.2,"St. Lucie County, FL"
8,2013,Sep,130298,116468,13830,10.6,"St. Lucie County, FL"
9,2013,Oct,129439,115894,13545,10.5,"St. Lucie County, FL"
10,2013,Nov,128982,116515,12467,9.7,"St. Lucie County, FL"
11,2013,Dec,128569,116844,11725,9.1,"St. Lucie County, FL"
12,2014,Jan,129355,117163,12192,9.4,"St. Lucie County, FL"
13,2014,Feb,130011,118277,11734,9.0,"St. Lucie County, FL"
14,2014,Mar,130625,119366,11259,8.6,"St. Lucie County, FL"
15,2014,Apr,129551,119191,10360,8.0,"St. Lucie County, FL"
16,2014,May,130572,119939,10633,8.1,"St. Lucie County, FL"
17,2014,Jun,130351,119116,11235,8.6,"St. Lucie County, FL"
18,2014,Jul,130184,118417,11767,9.0,"St. Lucie County, FL"
19,2014,Aug,130793,119243,11550,8.8,"St. Lucie County, FL"
20,2014,Sep,131365,120809,10556,8.0,"St. Lucie County, FL"
21,2014,Oct,131367,121725,9642,7.3,"St. Lucie County, FL"
22,2014,Nov,130655,121294,9361,7.2,"St. Lucie County, FL"
23,2014,Dec,130014,121414,8600,6.6,"St. Lucie County, FL"
24,2015,Jan,131189,121864,9325,7.1,"St. Lucie County, FL"
25,2015,Feb,130655,122161,8494,6.5,"St. Lucie County, FL"
26,2015,Mar,131120,123123,7997,6.1,"St. Lucie County, FL"
27,2015,Apr,131141,123206,7935,6.1,"St. Lucie County, FL"
28,2015,May,132430,123868,8562,6.5,"St. Lucie County, FL"
29,2015,Jun,131784,122847,8937,6.8,"St. Lucie County, FL"
30,2015,Jul,131418,121926,9492,7.2,"St. Lucie County, FL"
31,2015,Aug,132206,123088,9118,6.9,"St. Lucie County, FL"
32,2015,Sep,132468,124014,8454,6.4,"St. Lucie County, FL"
33,2015,Oct,132549,124534,8015,6.0,"St. Lucie County, FL"
34,2015,Nov,132422,124573,7849,5.9,"St. Lucie County, FL"
35,2015,Dec,132495,124952,7543,5.7,"St. Lucie County, FL"
36,2016,Jan,133997,126017,7980,6.0,"St. Lucie County, FL"
37,2016,Feb,134592,127164,7428,5.5,"St. Lucie County, FL"
38,2016,Mar,134968,127691,7277,5.4,"St. Lucie County, FL"
39,2016,Apr,134697,127520,7177,5.3,"St. Lucie County, FL"
40,2016,May,135802,128549,7253,5.3,"St. Lucie County, FL"
41,2016,Jun,135515,127270,8245,6.1,"St. Lucie County, FL"
42,2016,Jul,135571,126892,8679,6.4,"St. Lucie County, FL"
43,2016,Aug,135972,127176,8796,6.5,"St. Lucie County, FL"
44,2016,Sep,137136,128567,8569,6.2,"St. Lucie County, FL"
45,2016,Oct,136864,128684,8180,6.0,"St. Lucie County, FL"
46,2016,Nov,136260,128441,7819,5.7,"St. Lucie County, FL"
47,2016,Dec,136507,128860,7647,5.6,"St. Lucie County, FL"
48,2017,Jan,137381,129209,8172,5.9,"St. Lucie County, FL"
49,2017,Feb,137502,130028,7474,5.4,"St. Lucie County, FL"
50,2017,Mar,138384,131371,7013,5.1,"St. Lucie County, FL"
51,2017,Apr,137688,131058,6630,4.8,"St. Lucie County, FL"
52,2017,May,138569,131652,6917,5.0,"St. Lucie County, FL"
53,2017,Jun,138545,131024,7521,5.4,"St. Lucie County, FL"
54,2017,Jul,138267,130496,7771,5.6,"St. Lucie County, FL"
55,2017,Aug,138278,130473,7805,5.6,"St. Lucie County, FL"
56,2017,Sep,137500,130257,7243,5.3,"St. Lucie County, FL"
57,2017,Oct,138479,131580,6899,5.0,"St. Lucie County, FL"
58,2017,Nov,138413,131507,6906,5.0,"St. Lucie County, FL"
59,2017,Dec,138543,131924,6619,4.8,"St. Lucie County, FL"
60,2018,Jan,140001,132878,7123,5.1,"St. Lucie County, FL"
61,2018,Feb,140845,134187,6658,4.7,"St. Lucie County, FL"
62,2018,Mar,141246,134857,6389,4.5,"St. Lucie County, FL"
63,2018,Apr,141208,135256,5952,4.2,"St. Lucie County, FL"
64,2018,May,142247,136182,6065,4.3,"St. Lucie County, FL"
65,2018,Jun,142469,135392,7077,5.0,"St. Lucie County, FL"
66,2018,Jul,142029,135011,7018,4.9,"St. Lucie County, FL"
67,2018,Aug,141463,134730,6733,4.8,"St. Lucie County, FL"
68,2018,Sep,142391,136198,6193,4.3,"St. Lucie County, FL"
69,2018,Oct,143157,137044,6113,4.3,"St. Lucie County, FL"
70,2018,Nov,142405,136673,5732,4.0,"St. Lucie County, FL"
71,2018,Dec,142349,136606,5743,4.0,"St. Lucie County, FL"
72,2019,Jan,143948,137253,6695,4.7,"St. Lucie County, FL"
73,2019,Feb,144132,138221,5911,4.1,"St. Lucie County, FL"
74,2019,Mar,144347,138671,5676,3.9,"St. Lucie County, FL"
75,2019,Apr,144350,139186,5164,3.6,"St. Lucie County, FL"
76,2019,May,145652,140085,5567,3.8,"St. Lucie County, FL"
77,2019,Jun,145630,139267,6363,4.4,"St. Lucie County, FL"
78,2019,Jul,145674,139086,6588,4.5,"St. Lucie County, FL"
79,2019,Aug,146156,139671,6485,4.4,"St. Lucie County, FL"
80,2019,Sep,146497,140649,5848,4.0,"St. Lucie County, FL"
81,2019,Oct,147298,141559,5739,3.9,"St. Lucie County, FL"
82,2019,Nov,146900,141491,5409,3.7,"St. Lucie County, FL"
83,2019,Dec,147184,142185,4999,3.4,"St. Lucie County, FL"
84,2020,Jan,148637,142815,5822,3.9,"St. Lucie County, FL"
85,2020,Feb,149115,144007,5108,3.4,"St. Lucie County, FL"
86,2020,Mar,147598,139951,7647,5.2,"St. Lucie County, FL"
87,2020,Apr,135565,117625,17940,13.2,"St. Lucie County, FL"
88,2020,May,146477,126931,19546,13.3,"St. Lucie County, FL"
89,2020,Jun,146802,130518,16284,11.1,"St. Lucie County, FL"
90,2020,Jul,149631,131754,17877,11.9,"St. Lucie County, FL"
91,2020,Aug,146925,134122,12803,8.7,"St. Lucie County, FL"
92,2020,Sep,148558,136571,11987,8.1,"St. Lucie County, FL"
93,2020,Oct,149618,139506,10112,6.8,"St. Lucie County, FL"
94,2020,Nov,148003,138679,9324,6.3,"St. Lucie County, FL"
95,2020,Dec,147939,139081,8858,6.0,"St. Lucie County, FL"
96,2021,Jan,148254,139274,8980,6.1,"St. Lucie County, FL"
97,2021,Feb,148874,140710,8164,5.5,"St. Lucie County, FL"
98,2021,Mar,149757,141916,7841,5.2,"St. Lucie County, FL"
99,2021,Apr,149934,142244,7690,5.1,"St. Lucie County, FL"
100,2021,May,150755,143290,7465,5.0,"St. Lucie County, FL"
101,2021,Jun,151486,142917,8569,5.7,"St. Lucie County, FL"
102,2021,Jul,151122,143055,8067,5.3,"St. Lucie County, FL"
103,2021,Aug,151256,143434,7822,5.2,"St. Lucie County, FL"
104,2021,Sep,151843,144853,6990,4.6,"St. Lucie County, FL"
105,2021,Oct,152045,145422,6623,4.4,"St. Lucie County, FL"
106,2021,Nov,152217,146003,6214,4.1,"St. Lucie County, FL"
107,2021,Dec,152530,147074,5456,3.6,"St. Lucie County, FL"
108,2022,Jan,153525,146871,6654,4.3,"St. Lucie County, FL"
109,2022,Feb,153637,147765,5872,3.8,"St. Lucie County, FL"
110,2022,Mar,154490,149136,5354,3.5,"St. Lucie County, FL"
111,2022,Apr,154425,149551,4874,3.2,"St. Lucie County, FL"
112,2022,May,155824,150813,5011,3.2,"St. Lucie County, FL"
113,2022,Jun,155691,149898,5793,3.7,"St. Lucie County, FL"
114,2022,Jul,155366,149840,5526,3.6,"St. Lucie County, FL"
115,2022,Aug,156573,150886,5687,3.6,"St. Lucie County, FL"
116,2022,Sep,157184,152146,5038,3.2,"St. Lucie County, FL"
117,2022,Oct,157103,152100,5003,3.2,"St. Lucie County, FL"
118,2022,Nov,155919,151223,4696,3.0,"St. Lucie County, FL"
119,2022,Dec,157029,152862,4167,2.7,"St. Lucie County, FL"
120,2023,Jan,156474,151671,4803,3.1,"St. Lucie County, FL"
121,2023,Feb,157819,153049,4770,3.0,"St. Lucie County, FL"
122,2023,Mar,159514,154646,4868,3.1,"St. Lucie County, FL"
123,2023,Apr,159860,155475,4385,2.7,"St. Lucie County, FL"
124,2023,May,161053,156023,5030,3.1,"St. Lucie County, FL"
125,2023,Jun,161989,156187,5802,3.6,"St. Lucie County, FL"
126,2023,Jul,162132,156151,5981,3.7,"St. Lucie County, FL"
127,2023,Aug,163547,157309,6238,3.8,"St. Lucie County, FL"
128,2023,Sep,163410,157322,6088,3.7,"St. Lucie County, FL"
129,2023,Oct,163124,157133,5991,3.7,"St. Lucie County, FL"
0,2013,Jan,963674,891041,72633,7.5,"Santa Clara County, CA"
1,2013,Feb,965704,896754,68950,7.1,"Santa Clara County, CA"
2,2013,Mar,964478,897756,66722,6.9,"Santa Clara County, CA"
3,2013,Apr,960041,898735,61306,6.4,"Santa Clara County, CA"
4,2013,May,963339,902260,61079,6.3,"Santa Clara County, CA"
5,2013,Jun,969637,902522,67115,6.9,"Santa Clara County, CA"
6,2013,Jul,971689,904883,66806,6.9,"Santa Clara County, CA"
7,2013,Aug,970279,906481,63798,6.6,"Santa Clara County, CA"
8,2013,Sep,975045,914046,60999,6.3,"Santa Clara County, CA"
9,2013,Oct,968527,908027,60500,6.2,"Santa Clara County, CA"
10,2013,Nov,973230,915662,57568,5.9,"Santa Clara County, CA"
11,2013,Dec,972210,918449,53761,5.5,"Santa Clara County, CA"
12,2014,Jan,974057,917520,56537,5.8,"Santa Clara County, CA"
13,2014,Feb,980776,923653,57123,5.8,"Santa Clara County, CA"
14,2014,Mar,984182,927052,57130,5.8,"Santa Clara County, CA"
15,2014,Apr,974239,925677,48562,5.0,"Santa Clara County, CA"
16,2014,May,980609,931144,49465,5.0,"Santa Clara County, CA"
17,2014,Jun,986159,933599,52560,5.3,"Santa Clara County, CA"
18,2014,Jul,992343,936515,55828,5.6,"Santa Clara County, CA"
19,2014,Aug,991609,938215,53394,5.4,"Santa Clara County, CA"
20,2014,Sep,994286,945165,49121,4.9,"Santa Clara County, CA"
21,2014,Oct,999890,951562,48328,4.8,"Santa Clara County, CA"
22,2014,Nov,998418,951013,47405,4.7,"Santa Clara County, CA"
23,2014,Dec,994785,951968,42817,4.3,"Santa Clara County, CA"
24,2015,Jan,1002079,954263,47816,4.8,"Santa Clara County, CA"
25,2015,Feb,1005519,960299,45220,4.5,"Santa Clara County, CA"
26,2015,Mar,1005135,960672,44463,4.4,"Santa Clara County, CA"
27,2015,Apr,1004058,962968,41090,4.1,"Santa Clara County, CA"
28,2015,May,1010349,969248,41101,4.1,"Santa Clara County, CA"
29,2015,Jun,1014658,971066,43592,4.3,"Santa Clara County, CA"
30,2015,Jul,1018531,973575,44956,4.4,"Santa Clara County, CA"
31,2015,Aug,1016244,973917,42327,4.2,"Santa Clara County, CA"
32,2015,Sep,1014813,975471,39342,3.9,"Santa Clara County, CA"
33,2015,Oct,1019518,979246,40272,4.0,"Santa Clara County, CA"
34,2015,Nov,1018078,978543,39535,3.9,"Santa Clara County, CA"
35,2015,Dec,1017592,980132,37460,3.7,"Santa Clara County, CA"
36,2016,Jan,1020196,980653,39543,3.9,"Santa Clara County, CA"
37,2016,Feb,1025577,985771,39806,3.9,"Santa Clara County, CA"
38,2016,Mar,1027436,986745,40691,4.0,"Santa Clara County, CA"
39,2016,Apr,1020198,982274,37924,3.7,"Santa Clara County, CA"
40,2016,May,1023355,988687,34668,3.4,"Santa Clara County, CA"
41,2016,Jun,1031049,990158,40891,4.0,"Santa Clara County, CA"
42,2016,Jul,1035707,993837,41870,4.0,"Santa Clara County, CA"
43,2016,Aug,1032324,991269,41055,4.0,"Santa Clara County, CA"
44,2016,Sep,1031654,992385,39269,3.8,"Santa Clara County, CA"
45,2016,Oct,1030234,991072,39162,3.8,"Santa Clara County, CA"
46,2016,Nov,1030033,993495,36538,3.5,"Santa Clara County, CA"
47,2016,Dec,1027260,992232,35028,3.4,"Santa Clara County, CA"
48,2017,Jan,1032255,993196,39059,3.8,"Santa Clara County, CA"
49,2017,Feb,1036614,999257,37357,3.6,"Santa Clara County, CA"
50,2017,Mar,1037673,1002161,35512,3.4,"Santa Clara County, CA"
51,2017,Apr,1029735,997292,32443,3.2,"Santa Clara County, CA"
52,2017,May,1031682,1000449,31233,3.0,"Santa Clara County, CA"
53,2017,Jun,1038258,1002502,35756,3.4,"Santa Clara County, CA"
54,2017,Jul,1050515,1013378,37137,3.5,"Santa Clara County, CA"
55,2017,Aug,1041938,1005875,36063,3.5,"Santa Clara County, CA"
56,2017,Sep,1041548,1010014,31534,3.0,"Santa Clara County, CA"
57,2017,Oct,1036608,1006308,30300,2.9,"Santa Clara County, CA"
58,2017,Nov,1037354,1007889,29465,2.8,"Santa Clara County, CA"
59,2017,Dec,1034087,1005869,28218,2.7,"Santa Clara County, CA"
60,2018,Jan,1028886,997961,30925,3.0,"Santa Clara County, CA"
61,2018,Feb,1039580,1009643,29937,2.9,"Santa Clara County, CA"
62,2018,Mar,1039716,1011350,28366,2.7,"Santa Clara County, CA"
63,2018,Apr,1032086,1006356,25730,2.5,"Santa Clara County, CA"
64,2018,May,1037541,1013905,23636,2.3,"Santa Clara County, CA"
65,2018,Jun,1044767,1015122,29645,2.8,"Santa Clara County, CA"
66,2018,Jul,1054885,1025804,29081,2.8,"Santa Clara County, CA"
67,2018,Aug,1043702,1015134,28568,2.7,"Santa Clara County, CA"
68,2018,Sep,1044607,1018331,26276,2.5,"Santa Clara County, CA"
69,2018,Oct,1047962,1021300,26662,2.5,"Santa Clara County, CA"
70,2018,Nov,1049428,1023549,25879,2.5,"Santa Clara County, CA"
71,2018,Dec,1047294,1021188,26106,2.5,"Santa Clara County, CA"
72,2019,Jan,1046155,1015038,31117,3.0,"Santa Clara County, CA"
73,2019,Feb,1053708,1025859,27849,2.6,"Santa Clara County, CA"
74,2019,Mar,1053328,1024901,28427,2.7,"Santa Clara County, CA"
75,2019,Apr,1036951,1013588,23363,2.3,"Santa Clara County, CA"
76,2019,May,1039834,1017130,22704,2.2,"Santa Clara County, CA"
77,2019,Jun,1043119,1015560,27559,2.6,"Santa Clara County, CA"
78,2019,Jul,1057889,1028877,29012,2.7,"Santa Clara County, CA"
79,2019,Aug,1053031,1025132,27899,2.6,"Santa Clara County, CA"
80,2019,Sep,1052552,1028297,24255,2.3,"Santa Clara County, CA"
81,2019,Oct,1056620,1031298,25322,2.4,"Santa Clara County, CA"
82,2019,Nov,1056369,1031004,25365,2.4,"Santa Clara County, CA"
83,2019,Dec,1058047,1033909,24138,2.3,"Santa Clara County, CA"
84,2020,Jan,1055000,1026930,28070,2.7,"Santa Clara County, CA"
85,2020,Feb,1064517,1037580,26937,2.5,"Santa Clara County, CA"
86,2020,Mar,1046319,1006845,39474,3.8,"Santa Clara County, CA"
87,2020,Apr,1015079,889488,125591,12.4,"Santa Clara County, CA"
88,2020,May,1002409,886791,115618,11.5,"Santa Clara County, CA"
89,2020,Jun,1028514,923659,104855,10.2,"Santa Clara County, CA"
90,2020,Jul,1029746,933569,96177,9.3,"Santa Clara County, CA"
91,2020,Aug,1022689,943885,78804,7.7,"Santa Clara County, CA"
92,2020,Sep,1017464,943095,74369,7.3,"Santa Clara County, CA"
93,2020,Oct,1012906,948181,64725,6.4,"Santa Clara County, CA"
94,2020,Nov,1007029,945213,61816,6.1,"Santa Clara County, CA"
95,2020,Dec,1005715,944747,60968,6.1,"Santa Clara County, CA"
96,2021,Jan,1000614,940264,60350,6.0,"Santa Clara County, CA"
97,2021,Feb,1007610,949121,58489,5.8,"Santa Clara County, CA"
98,2021,Mar,1007420,951471,55949,5.6,"Santa Clara County, CA"
99,2021,Apr,999662,945525,54137,5.4,"Santa Clara County, CA"
100,2021,May,1002983,953397,49586,4.9,"Santa Clara County, CA"
101,2021,Jun,1009065,954082,54983,5.4,"Santa Clara County, CA"
102,2021,Jul,1020313,968173,52140,5.1,"Santa Clara County, CA"
103,2021,Aug,1018172,968637,49535,4.9,"Santa Clara County, CA"
104,2021,Sep,1018628,977354,41274,4.1,"Santa Clara County, CA"
105,2021,Oct,1018417,978747,39670,3.9,"Santa Clara County, CA"
106,2021,Nov,1022604,987047,35557,3.5,"Santa Clara County, CA"
107,2021,Dec,1023135,991114,32021,3.1,"Santa Clara County, CA"
108,2022,Jan,1024380,988456,35924,3.5,"Santa Clara County, CA"
109,2022,Feb,1030516,998045,32471,3.2,"Santa Clara County, CA"
110,2022,Mar,1035098,1005955,29143,2.8,"Santa Clara County, CA"
111,2022,Apr,1023985,998818,25167,2.5,"Santa Clara County, CA"
112,2022,May,1030884,1007850,23034,2.2,"Santa Clara County, CA"
113,2022,Jun,1034418,1006652,27766,2.7,"Santa Clara County, CA"
114,2022,Jul,1046153,1018945,27208,2.6,"Santa Clara County, CA"
115,2022,Aug,1047414,1019516,27898,2.7,"Santa Clara County, CA"
116,2022,Sep,1049882,1025126,24756,2.4,"Santa Clara County, CA"
117,2022,Oct,1054919,1028809,26110,2.5,"Santa Clara County, CA"
118,2022,Nov,1053449,1026618,26831,2.5,"Santa Clara County, CA"
119,2022,Dec,1059173,1034662,24511,2.3,"Santa Clara County, CA"
120,2023,Jan,1043837,1012902,30935,3.0,"Santa Clara County, CA"
121,2023,Feb,1052287,1019279,33008,3.1,"Santa Clara County, CA"
122,2023,Mar,1059931,1026057,33874,3.2,"Santa Clara County, CA"
123,2023,Apr,1045493,1014463,31030,3.0,"Santa Clara County, CA"
124,2023,May,1043247,1009511,33736,3.2,"Santa Clara County, CA"
125,2023,Jun,1043782,1005512,38270,3.7,"Santa Clara County, CA"
126,2023,Jul,1055805,1018083,37722,3.6,"Santa Clara County, CA"
127,2023,Aug,1053504,1012482,41022,3.9,"Santa Clara County, CA"
128,2023,Sep,1055945,1017061,38884,3.7,"Santa Clara County, CA"
129,2023,Oct,1055031,1015419,39612,3.8,"Santa Clara County, CA"
0,2013,Jan,86941,80896,6045,7.0,"Hawaii County, HI"
1,2013,Feb,85864,80111,5753,6.7,"Hawaii County, HI"
2,2013,Mar,86466,80959,5507,6.4,"Hawaii County, HI"
3,2013,Apr,86638,81157,5481,6.3,"Hawaii County, HI"
4,2013,May,86189,80693,5496,6.4,"Hawaii County, HI"
5,2013,Jun,88210,81671,6539,7.4,"Hawaii County, HI"
6,2013,Jul,88097,82212,5885,6.7,"Hawaii County, HI"
7,2013,Aug,87542,82243,5299,6.1,"Hawaii County, HI"
8,2013,Sep,87136,81636,5500,6.3,"Hawaii County, HI"
9,2013,Oct,86365,80926,5439,6.3,"Hawaii County, HI"
10,2013,Nov,86560,81475,5085,5.9,"Hawaii County, HI"
11,2013,Dec,86235,81416,4819,5.6,"Hawaii County, HI"
12,2014,Jan,86466,81459,5007,5.8,"Hawaii County, HI"
13,2014,Feb,86357,81363,4994,5.8,"Hawaii County, HI"
14,2014,Mar,87548,82732,4816,5.5,"Hawaii County, HI"
15,2014,Apr,88000,83357,4643,5.3,"Hawaii County, HI"
16,2014,May,87819,83105,4714,5.4,"Hawaii County, HI"
17,2014,Jun,89764,84120,5644,6.3,"Hawaii County, HI"
18,2014,Jul,90653,85510,5143,5.7,"Hawaii County, HI"
19,2014,Aug,89988,85378,4610,5.1,"Hawaii County, HI"
20,2014,Sep,89235,84726,4509,5.1,"Hawaii County, HI"
21,2014,Oct,88213,84094,4119,4.7,"Hawaii County, HI"
22,2014,Nov,88771,84597,4174,4.7,"Hawaii County, HI"
23,2014,Dec,88003,84222,3781,4.3,"Hawaii County, HI"
24,2015,Jan,88391,84216,4175,4.7,"Hawaii County, HI"
25,2015,Feb,87786,83787,3999,4.6,"Hawaii County, HI"
26,2015,Mar,88808,84968,3840,4.3,"Hawaii County, HI"
27,2015,Apr,88660,84962,3698,4.2,"Hawaii County, HI"
28,2015,May,88970,85217,3753,4.2,"Hawaii County, HI"
29,2015,Jun,90485,86003,4482,5.0,"Hawaii County, HI"
30,2015,Jul,91197,87398,3799,4.2,"Hawaii County, HI"
31,2015,Aug,90439,86776,3663,4.1,"Hawaii County, HI"
32,2015,Sep,89956,86361,3595,4.0,"Hawaii County, HI"
33,2015,Oct,89104,85804,3300,3.7,"Hawaii County, HI"
34,2015,Nov,89440,86074,3366,3.8,"Hawaii County, HI"
35,2015,Dec,89778,86712,3066,3.4,"Hawaii County, HI"
36,2016,Jan,91259,88005,3254,3.6,"Hawaii County, HI"
37,2016,Feb,91286,88012,3274,3.6,"Hawaii County, HI"
38,2016,Mar,91561,88279,3282,3.6,"Hawaii County, HI"
39,2016,Apr,92185,88795,3390,3.7,"Hawaii County, HI"
40,2016,May,92159,88992,3167,3.4,"Hawaii County, HI"
41,2016,Jun,93416,89217,4199,4.5,"Hawaii County, HI"
42,2016,Jul,94453,90770,3683,3.9,"Hawaii County, HI"
43,2016,Aug,93821,90541,3280,3.5,"Hawaii County, HI"
44,2016,Sep,92437,89304,3133,3.4,"Hawaii County, HI"
45,2016,Oct,92100,89123,2977,3.2,"Hawaii County, HI"
46,2016,Nov,92480,89692,2788,3.0,"Hawaii County, HI"
47,2016,Dec,92531,90005,2526,2.7,"Hawaii County, HI"
48,2017,Jan,94401,91450,2951,3.1,"Hawaii County, HI"
49,2017,Feb,94906,92095,2811,3.0,"Hawaii County, HI"
50,2017,Mar,95641,93021,2620,2.7,"Hawaii County, HI"
51,2017,Apr,95960,93349,2611,2.7,"Hawaii County, HI"
52,2017,May,95430,92965,2465,2.6,"Hawaii County, HI"
53,2017,Jun,96374,93213,3161,3.3,"Hawaii County, HI"
54,2017,Jul,95781,93101,2680,2.8,"Hawaii County, HI"
55,2017,Aug,95290,93109,2181,2.3,"Hawaii County, HI"
56,2017,Sep,94607,92469,2138,2.3,"Hawaii County, HI"
57,2017,Oct,94424,92444,1980,2.1,"Hawaii County, HI"
58,2017,Nov,94377,92351,2026,2.1,"Hawaii County, HI"
59,2017,Dec,94061,92293,1768,1.9,"Hawaii County, HI"
60,2018,Jan,94205,92008,2197,2.3,"Hawaii County, HI"
61,2018,Feb,94767,92632,2135,2.3,"Hawaii County, HI"
62,2018,Mar,95441,93143,2298,2.4,"Hawaii County, HI"
63,2018,Apr,95415,93150,2265,2.4,"Hawaii County, HI"
64,2018,May,95539,93266,2273,2.4,"Hawaii County, HI"
65,2018,Jun,95613,92113,3500,3.7,"Hawaii County, HI"
66,2018,Jul,96288,93124,3164,3.3,"Hawaii County, HI"
67,2018,Aug,94749,91889,2860,3.0,"Hawaii County, HI"
68,2018,Sep,94780,91776,3004,3.2,"Hawaii County, HI"
69,2018,Oct,93594,90272,3322,3.5,"Hawaii County, HI"
70,2018,Nov,93735,90747,2988,3.2,"Hawaii County, HI"
71,2018,Dec,93441,90556,2885,3.1,"Hawaii County, HI"
72,2019,Jan,92745,89348,3397,3.7,"Hawaii County, HI"
73,2019,Feb,93661,90615,3046,3.3,"Hawaii County, HI"
74,2019,Mar,93381,90282,3099,3.3,"Hawaii County, HI"
75,2019,Apr,93638,90657,2981,3.2,"Hawaii County, HI"
76,2019,May,93897,91086,2811,3.0,"Hawaii County, HI"
77,2019,Jun,93606,89962,3644,3.9,"Hawaii County, HI"
78,2019,Jul,93973,90632,3341,3.6,"Hawaii County, HI"
79,2019,Aug,92954,90022,2932,3.2,"Hawaii County, HI"
80,2019,Sep,94342,91405,2937,3.1,"Hawaii County, HI"
81,2019,Oct,94008,91044,2964,3.2,"Hawaii County, HI"
82,2019,Nov,94840,92062,2778,2.9,"Hawaii County, HI"
83,2019,Dec,94761,92381,2380,2.5,"Hawaii County, HI"
84,2020,Jan,94307,91614,2693,2.9,"Hawaii County, HI"
85,2020,Feb,94530,92179,2351,2.5,"Hawaii County, HI"
86,2020,Mar,94145,91658,2487,2.6,"Hawaii County, HI"
87,2020,Apr,89190,69357,19833,22.2,"Hawaii County, HI"
88,2020,May,90666,72282,18384,20.3,"Hawaii County, HI"
89,2020,Jun,92864,76941,15923,17.1,"Hawaii County, HI"
90,2020,Jul,93248,78836,14412,15.5,"Hawaii County, HI"
91,2020,Aug,93517,81872,11645,12.5,"Hawaii County, HI"
92,2020,Sep,86732,76096,10636,12.3,"Hawaii County, HI"
93,2020,Oct,89024,79503,9521,10.7,"Hawaii County, HI"
94,2020,Nov,91126,81977,9149,10.0,"Hawaii County, HI"
95,2020,Dec,93263,84344,8919,9.6,"Hawaii County, HI"
96,2021,Jan,94079,85611,8468,9.0,"Hawaii County, HI"
97,2021,Feb,94553,86487,8066,8.5,"Hawaii County, HI"
98,2021,Mar,94902,87397,7505,7.9,"Hawaii County, HI"
99,2021,Apr,95140,88208,6932,7.3,"Hawaii County, HI"
100,2021,May,94584,88539,6045,6.4,"Hawaii County, HI"
101,2021,Jun,93910,87406,6504,6.9,"Hawaii County, HI"
102,2021,Jul,94405,89198,5207,5.5,"Hawaii County, HI"
103,2021,Aug,94386,89852,4534,4.8,"Hawaii County, HI"
104,2021,Sep,93035,89223,3812,4.1,"Hawaii County, HI"
105,2021,Oct,92237,89198,3039,3.3,"Hawaii County, HI"
106,2021,Nov,93105,90271,2834,3.0,"Hawaii County, HI"
107,2021,Dec,92448,89939,2509,2.7,"Hawaii County, HI"
108,2022,Jan,93483,90539,2944,3.1,"Hawaii County, HI"
109,2022,Feb,93468,90574,2894,3.1,"Hawaii County, HI"
110,2022,Mar,94595,91792,2803,3.0,"Hawaii County, HI"
111,2022,Apr,93803,90790,3013,3.2,"Hawaii County, HI"
112,2022,May,93792,90676,3116,3.3,"Hawaii County, HI"
113,2022,Jun,93264,89178,4086,4.4,"Hawaii County, HI"
114,2022,Jul,94219,90557,3662,3.9,"Hawaii County, HI"
115,2022,Aug,94614,90947,3667,3.9,"Hawaii County, HI"
116,2022,Sep,94540,90814,3726,3.9,"Hawaii County, HI"
117,2022,Oct,94913,91140,3773,4.0,"Hawaii County, HI"
118,2022,Nov,95094,91160,3934,4.1,"Hawaii County, HI"
119,2022,Dec,95171,91591,3580,3.8,"Hawaii County, HI"
120,2023,Jan,95220,92007,3213,3.4,"Hawaii County, HI"
121,2023,Feb,95035,91798,3237,3.4,"Hawaii County, HI"
122,2023,Mar,95177,91897,3280,3.4,"Hawaii County, HI"
123,2023,Apr,94370,91549,2821,3.0,"Hawaii County, HI"
124,2023,May,93494,90684,2810,3.0,"Hawaii County, HI"
125,2023,Jun,94123,90593,3530,3.8,"Hawaii County, HI"
126,2023,Jul,94206,91203,3003,3.2,"Hawaii County, HI"
127,2023,Aug,94314,91348,2966,3.1,"Hawaii County, HI"
128,2023,Sep,94555,91949,2606,2.8,"Hawaii County, HI"
129,2023,Oct,94756,92249,2507,2.6,"Hawaii County, HI"
0,2013,Jan,9222,8324,898,9.7,"Taylor County, FL"
1,2013,Feb,9243,8435,808,8.7,"Taylor County, FL"
2,2013,Mar,9222,8453,769,8.3,"Taylor County, FL"
3,2013,Apr,9425,8690,735,7.8,"Taylor County, FL"
4,2013,May,9561,8803,758,7.9,"Taylor County, FL"
5,2013,Jun,9838,9037,801,8.1,"Taylor County, FL"
6,2013,Jul,9696,8902,794,8.2,"Taylor County, FL"
7,2013,Aug,9840,9063,777,7.9,"Taylor County, FL"
8,2013,Sep,9600,8852,748,7.8,"Taylor County, FL"
9,2013,Oct,9383,8629,754,8.0,"Taylor County, FL"
10,2013,Nov,9241,8509,732,7.9,"Taylor County, FL"
11,2013,Dec,9289,8581,708,7.6,"Taylor County, FL"
12,2014,Jan,9360,8631,729,7.8,"Taylor County, FL"
13,2014,Feb,9292,8597,695,7.5,"Taylor County, FL"
14,2014,Mar,9461,8799,662,7.0,"Taylor County, FL"
15,2014,Apr,9362,8762,600,6.4,"Taylor County, FL"
16,2014,May,9375,8748,627,6.7,"Taylor County, FL"
17,2014,Jun,9386,8728,658,7.0,"Taylor County, FL"
18,2014,Jul,9416,8726,690,7.3,"Taylor County, FL"
19,2014,Aug,9350,8658,692,7.4,"Taylor County, FL"
20,2014,Sep,9374,8721,653,7.0,"Taylor County, FL"
21,2014,Oct,9349,8726,623,6.7,"Taylor County, FL"
22,2014,Nov,9207,8546,661,7.2,"Taylor County, FL"
23,2014,Dec,9263,8630,633,6.8,"Taylor County, FL"
24,2015,Jan,9263,8589,674,7.3,"Taylor County, FL"
25,2015,Feb,8987,8310,677,7.5,"Taylor County, FL"
26,2015,Mar,9054,8438,616,6.8,"Taylor County, FL"
27,2015,Apr,9097,8520,577,6.3,"Taylor County, FL"
28,2015,May,9175,8558,617,6.7,"Taylor County, FL"
29,2015,Jun,9036,8408,628,6.9,"Taylor County, FL"
30,2015,Jul,9037,8381,656,7.3,"Taylor County, FL"
31,2015,Aug,9017,8386,631,7.0,"Taylor County, FL"
32,2015,Sep,9009,8436,573,6.4,"Taylor County, FL"
33,2015,Oct,8949,8375,574,6.4,"Taylor County, FL"
34,2015,Nov,8806,8234,572,6.5,"Taylor County, FL"
35,2015,Dec,8754,8214,540,6.2,"Taylor County, FL"
36,2016,Jan,8820,8270,550,6.2,"Taylor County, FL"
37,2016,Feb,8800,8312,488,5.5,"Taylor County, FL"
38,2016,Mar,8878,8402,476,5.4,"Taylor County, FL"
39,2016,Apr,8838,8372,466,5.3,"Taylor County, FL"
40,2016,May,9015,8566,449,5.0,"Taylor County, FL"
41,2016,Jun,8905,8398,507,5.7,"Taylor County, FL"
42,2016,Jul,8870,8379,491,5.5,"Taylor County, FL"
43,2016,Aug,8825,8336,489,5.5,"Taylor County, FL"
44,2016,Sep,9026,8522,504,5.6,"Taylor County, FL"
45,2016,Oct,8966,8473,493,5.5,"Taylor County, FL"
46,2016,Nov,8812,8358,454,5.2,"Taylor County, FL"
47,2016,Dec,8635,8202,433,5.0,"Taylor County, FL"
48,2017,Jan,8610,8148,462,5.4,"Taylor County, FL"
49,2017,Feb,8600,8182,418,4.9,"Taylor County, FL"
50,2017,Mar,8664,8263,401,4.6,"Taylor County, FL"
51,2017,Apr,8737,8357,380,4.3,"Taylor County, FL"
52,2017,May,8762,8373,389,4.4,"Taylor County, FL"
53,2017,Jun,8952,8535,417,4.7,"Taylor County, FL"
54,2017,Jul,8758,8322,436,5.0,"Taylor County, FL"
55,2017,Aug,8644,8229,415,4.8,"Taylor County, FL"
56,2017,Sep,8820,8447,373,4.2,"Taylor County, FL"
57,2017,Oct,8696,8334,362,4.2,"Taylor County, FL"
58,2017,Nov,8592,8225,367,4.3,"Taylor County, FL"
59,2017,Dec,8575,8228,347,4.0,"Taylor County, FL"
60,2018,Jan,8553,8186,367,4.3,"Taylor County, FL"
61,2018,Feb,8627,8281,346,4.0,"Taylor County, FL"
62,2018,Mar,8617,8292,325,3.8,"Taylor County, FL"
63,2018,Apr,8785,8469,316,3.6,"Taylor County, FL"
64,2018,May,8878,8566,312,3.5,"Taylor County, FL"
65,2018,Jun,8915,8537,378,4.2,"Taylor County, FL"
66,2018,Jul,8745,8366,379,4.3,"Taylor County, FL"
67,2018,Aug,8508,8149,359,4.2,"Taylor County, FL"
68,2018,Sep,8574,8247,327,3.8,"Taylor County, FL"
69,2018,Oct,8429,8112,317,3.8,"Taylor County, FL"
70,2018,Nov,8315,8017,298,3.6,"Taylor County, FL"
71,2018,Dec,8281,7979,302,3.6,"Taylor County, FL"
72,2019,Jan,7892,7540,352,4.5,"Taylor County, FL"
73,2019,Feb,7859,7560,299,3.8,"Taylor County, FL"
74,2019,Mar,8060,7771,289,3.6,"Taylor County, FL"
75,2019,Apr,8148,7871,277,3.4,"Taylor County, FL"
76,2019,May,8266,7989,277,3.4,"Taylor County, FL"
77,2019,Jun,8362,8034,328,3.9,"Taylor County, FL"
78,2019,Jul,8228,7886,342,4.2,"Taylor County, FL"
79,2019,Aug,8261,7925,336,4.1,"Taylor County, FL"
80,2019,Sep,8327,8030,297,3.6,"Taylor County, FL"
81,2019,Oct,8299,8012,287,3.5,"Taylor County, FL"
82,2019,Nov,8274,8004,270,3.3,"Taylor County, FL"
83,2019,Dec,8170,7918,252,3.1,"Taylor County, FL"
84,2020,Jan,8139,7852,287,3.5,"Taylor County, FL"
85,2020,Feb,8167,7927,240,2.9,"Taylor County, FL"
86,2020,Mar,8085,7737,348,4.3,"Taylor County, FL"
87,2020,Apr,7506,6970,536,7.1,"Taylor County, FL"
88,2020,May,8115,7426,689,8.5,"Taylor County, FL"
89,2020,Jun,8316,7671,645,7.8,"Taylor County, FL"
90,2020,Jul,8439,7571,868,10.3,"Taylor County, FL"
91,2020,Aug,8276,7603,673,8.1,"Taylor County, FL"
92,2020,Sep,8354,7673,681,8.2,"Taylor County, FL"
93,2020,Oct,8278,7712,566,6.8,"Taylor County, FL"
94,2020,Nov,8151,7608,543,6.7,"Taylor County, FL"
95,2020,Dec,8127,7604,523,6.4,"Taylor County, FL"
96,2021,Jan,8070,7535,535,6.6,"Taylor County, FL"
97,2021,Feb,8133,7644,489,6.0,"Taylor County, FL"
98,2021,Mar,8201,7748,453,5.5,"Taylor County, FL"
99,2021,Apr,8143,7715,428,5.3,"Taylor County, FL"
100,2021,May,8284,7862,422,5.1,"Taylor County, FL"
101,2021,Jun,8196,7733,463,5.6,"Taylor County, FL"
102,2021,Jul,8144,7704,440,5.4,"Taylor County, FL"
103,2021,Aug,8055,7640,415,5.2,"Taylor County, FL"
104,2021,Sep,7996,7632,364,4.6,"Taylor County, FL"
105,2021,Oct,8024,7677,347,4.3,"Taylor County, FL"
106,2021,Nov,7940,7599,341,4.3,"Taylor County, FL"
107,2021,Dec,7898,7585,313,4.0,"Taylor County, FL"
108,2022,Jan,7931,7567,364,4.6,"Taylor County, FL"
109,2022,Feb,7884,7572,312,4.0,"Taylor County, FL"
110,2022,Mar,7957,7674,283,3.6,"Taylor County, FL"
111,2022,Apr,8033,7783,250,3.1,"Taylor County, FL"
112,2022,May,8203,7950,253,3.1,"Taylor County, FL"
113,2022,Jun,8187,7882,305,3.7,"Taylor County, FL"
114,2022,Jul,8165,7886,279,3.4,"Taylor County, FL"
115,2022,Aug,8156,7883,273,3.3,"Taylor County, FL"
116,2022,Sep,8187,7940,247,3.0,"Taylor County, FL"
117,2022,Oct,8141,7913,228,2.8,"Taylor County, FL"
118,2022,Nov,8113,7880,233,2.9,"Taylor County, FL"
119,2022,Dec,8063,7847,216,2.7,"Taylor County, FL"
120,2023,Jan,7935,7694,241,3.0,"Taylor County, FL"
121,2023,Feb,8003,7760,243,3.0,"Taylor County, FL"
122,2023,Mar,8130,7899,231,2.8,"Taylor County, FL"
123,2023,Apr,8161,7956,205,2.5,"Taylor County, FL"
124,2023,May,8327,8082,245,2.9,"Taylor County, FL"
125,2023,Jun,8431,8155,276,3.3,"Taylor County, FL"
126,2023,Jul,8417,8141,276,3.3,"Taylor County, FL"
127,2023,Aug,8420,8130,290,3.4,"Taylor County, FL"
128,2023,Sep,8447,8122,325,3.8,"Taylor County, FL"
129,2023,Oct,8485,8139,346,4.1,"Taylor County, FL"
0,2013,Jan,5452,4939,513,9.4,"Jefferson County, FL"
1,2013,Feb,5434,4976,458,8.4,"Jefferson County, FL"
2,2013,Mar,5404,4973,431,8.0,"Jefferson County, FL"
3,2013,Apr,5439,5027,412,7.6,"Jefferson County, FL"
4,2013,May,5383,4955,428,8.0,"Jefferson County, FL"
5,2013,Jun,5438,4968,470,8.6,"Jefferson County, FL"
6,2013,Jul,5449,4987,462,8.5,"Jefferson County, FL"
7,2013,Aug,5441,4988,453,8.3,"Jefferson County, FL"
8,2013,Sep,5560,5130,430,7.7,"Jefferson County, FL"
9,2013,Oct,5549,5121,428,7.7,"Jefferson County, FL"
10,2013,Nov,5502,5087,415,7.5,"Jefferson County, FL"
11,2013,Dec,5425,5032,393,7.2,"Jefferson County, FL"
12,2014,Jan,5434,5032,402,7.4,"Jefferson County, FL"
13,2014,Feb,5504,5105,399,7.2,"Jefferson County, FL"
14,2014,Mar,5473,5088,385,7.0,"Jefferson County, FL"
15,2014,Apr,5460,5114,346,6.3,"Jefferson County, FL"
16,2014,May,5433,5072,361,6.6,"Jefferson County, FL"
17,2014,Jun,5444,5076,368,6.8,"Jefferson County, FL"
18,2014,Jul,5477,5092,385,7.0,"Jefferson County, FL"
19,2014,Aug,5467,5091,376,6.9,"Jefferson County, FL"
20,2014,Sep,5610,5239,371,6.6,"Jefferson County, FL"
21,2014,Oct,5611,5234,377,6.7,"Jefferson County, FL"
22,2014,Nov,5504,5143,361,6.6,"Jefferson County, FL"
23,2014,Dec,5447,5106,341,6.3,"Jefferson County, FL"
24,2015,Jan,5429,5068,361,6.6,"Jefferson County, FL"
25,2015,Feb,5411,5081,330,6.1,"Jefferson County, FL"
26,2015,Mar,5396,5067,329,6.1,"Jefferson County, FL"
27,2015,Apr,5397,5088,309,5.7,"Jefferson County, FL"
28,2015,May,5352,5027,325,6.1,"Jefferson County, FL"
29,2015,Jun,5402,5055,347,6.4,"Jefferson County, FL"
30,2015,Jul,5378,5030,348,6.5,"Jefferson County, FL"
31,2015,Aug,5368,5036,332,6.2,"Jefferson County, FL"
32,2015,Sep,5452,5147,305,5.6,"Jefferson County, FL"
33,2015,Oct,5443,5135,308,5.7,"Jefferson County, FL"
34,2015,Nov,5365,5062,303,5.6,"Jefferson County, FL"
35,2015,Dec,5351,5055,296,5.5,"Jefferson County, FL"
36,2016,Jan,5303,4996,307,5.8,"Jefferson County, FL"
37,2016,Feb,5358,5076,282,5.3,"Jefferson County, FL"
38,2016,Mar,5351,5071,280,5.2,"Jefferson County, FL"
39,2016,Apr,5386,5116,270,5.0,"Jefferson County, FL"
40,2016,May,5363,5090,273,5.1,"Jefferson County, FL"
41,2016,Jun,5374,5072,302,5.6,"Jefferson County, FL"
42,2016,Jul,5413,5111,302,5.6,"Jefferson County, FL"
43,2016,Aug,5405,5106,299,5.5,"Jefferson County, FL"
44,2016,Sep,5535,5247,288,5.2,"Jefferson County, FL"
45,2016,Oct,5520,5237,283,5.1,"Jefferson County, FL"
46,2016,Nov,5452,5170,282,5.2,"Jefferson County, FL"
47,2016,Dec,5383,5111,272,5.1,"Jefferson County, FL"
48,2017,Jan,5402,5110,292,5.4,"Jefferson County, FL"
49,2017,Feb,5445,5183,262,4.8,"Jefferson County, FL"
50,2017,Mar,5422,5177,245,4.5,"Jefferson County, FL"
51,2017,Apr,5478,5254,224,4.1,"Jefferson County, FL"
52,2017,May,5453,5215,238,4.4,"Jefferson County, FL"
53,2017,Jun,5413,5163,250,4.6,"Jefferson County, FL"
54,2017,Jul,5441,5187,254,4.7,"Jefferson County, FL"
55,2017,Aug,5373,5120,253,4.7,"Jefferson County, FL"
56,2017,Sep,5571,5338,233,4.2,"Jefferson County, FL"
57,2017,Oct,5550,5328,222,4.0,"Jefferson County, FL"
58,2017,Nov,5481,5262,219,4.0,"Jefferson County, FL"
59,2017,Dec,5429,5215,214,3.9,"Jefferson County, FL"
60,2018,Jan,5476,5243,233,4.3,"Jefferson County, FL"
61,2018,Feb,5512,5301,211,3.8,"Jefferson County, FL"
62,2018,Mar,5499,5290,209,3.8,"Jefferson County, FL"
63,2018,Apr,5529,5331,198,3.6,"Jefferson County, FL"
64,2018,May,5503,5304,199,3.6,"Jefferson County, FL"
65,2018,Jun,5492,5256,236,4.3,"Jefferson County, FL"
66,2018,Jul,5529,5297,232,4.2,"Jefferson County, FL"
67,2018,Aug,5470,5238,232,4.2,"Jefferson County, FL"
68,2018,Sep,5638,5427,211,3.7,"Jefferson County, FL"
69,2018,Oct,5626,5415,211,3.8,"Jefferson County, FL"
70,2018,Nov,5598,5396,202,3.6,"Jefferson County, FL"
71,2018,Dec,5550,5351,199,3.6,"Jefferson County, FL"
72,2019,Jan,5505,5285,220,4.0,"Jefferson County, FL"
73,2019,Feb,5513,5312,201,3.6,"Jefferson County, FL"
74,2019,Mar,5501,5311,190,3.5,"Jefferson County, FL"
75,2019,Apr,5526,5353,173,3.1,"Jefferson County, FL"
76,2019,May,5486,5304,182,3.3,"Jefferson County, FL"
77,2019,Jun,5437,5236,201,3.7,"Jefferson County, FL"
78,2019,Jul,5467,5259,208,3.8,"Jefferson County, FL"
79,2019,Aug,5443,5243,200,3.7,"Jefferson County, FL"
80,2019,Sep,5586,5406,180,3.2,"Jefferson County, FL"
81,2019,Oct,5591,5415,176,3.1,"Jefferson County, FL"
82,2019,Nov,5545,5373,172,3.1,"Jefferson County, FL"
83,2019,Dec,5489,5333,156,2.8,"Jefferson County, FL"
84,2020,Jan,5587,5400,187,3.3,"Jefferson County, FL"
85,2020,Feb,5600,5435,165,2.9,"Jefferson County, FL"
86,2020,Mar,5485,5245,240,4.4,"Jefferson County, FL"
87,2020,Apr,4951,4608,343,6.9,"Jefferson County, FL"
88,2020,May,5205,4808,397,7.6,"Jefferson County, FL"
89,2020,Jun,5262,4858,404,7.7,"Jefferson County, FL"
90,2020,Jul,5410,4930,480,8.9,"Jefferson County, FL"
91,2020,Aug,5436,5067,369,6.8,"Jefferson County, FL"
92,2020,Sep,5525,5192,333,6.0,"Jefferson County, FL"
93,2020,Oct,5615,5306,309,5.5,"Jefferson County, FL"
94,2020,Nov,5546,5236,310,5.6,"Jefferson County, FL"
95,2020,Dec,5433,5142,291,5.4,"Jefferson County, FL"
96,2021,Jan,5452,5164,288,5.3,"Jefferson County, FL"
97,2021,Feb,5481,5212,269,4.9,"Jefferson County, FL"
98,2021,Mar,5488,5243,245,4.5,"Jefferson County, FL"
99,2021,Apr,5519,5284,235,4.3,"Jefferson County, FL"
100,2021,May,5486,5267,219,4.0,"Jefferson County, FL"
101,2021,Jun,5517,5254,263,4.8,"Jefferson County, FL"
102,2021,Jul,5525,5267,258,4.7,"Jefferson County, FL"
103,2021,Aug,5531,5273,258,4.7,"Jefferson County, FL"
104,2021,Sep,5693,5453,240,4.2,"Jefferson County, FL"
105,2021,Oct,5714,5496,218,3.8,"Jefferson County, FL"
106,2021,Nov,5696,5478,218,3.8,"Jefferson County, FL"
107,2021,Dec,5607,5425,182,3.2,"Jefferson County, FL"
108,2022,Jan,5653,5426,227,4.0,"Jefferson County, FL"
109,2022,Feb,5662,5470,192,3.4,"Jefferson County, FL"
110,2022,Mar,5658,5486,172,3.0,"Jefferson County, FL"
111,2022,Apr,5726,5560,166,2.9,"Jefferson County, FL"
112,2022,May,5710,5532,178,3.1,"Jefferson County, FL"
113,2022,Jun,5732,5513,219,3.8,"Jefferson County, FL"
114,2022,Jul,5736,5525,211,3.7,"Jefferson County, FL"
115,2022,Aug,5736,5527,209,3.6,"Jefferson County, FL"
116,2022,Sep,5850,5681,169,2.9,"Jefferson County, FL"
117,2022,Oct,5879,5707,172,2.9,"Jefferson County, FL"
118,2022,Nov,5792,5637,155,2.7,"Jefferson County, FL"
119,2022,Dec,5742,5604,138,2.4,"Jefferson County, FL"
120,2023,Jan,5762,5605,157,2.7,"Jefferson County, FL"
121,2023,Feb,5819,5661,158,2.7,"Jefferson County, FL"
122,2023,Mar,5831,5673,158,2.7,"Jefferson County, FL"
123,2023,Apr,5847,5704,143,2.4,"Jefferson County, FL"
124,2023,May,5834,5667,167,2.9,"Jefferson County, FL"
125,2023,Jun,5876,5691,185,3.1,"Jefferson County, FL"
126,2023,Jul,5925,5722,203,3.4,"Jefferson County, FL"
127,2023,Aug,5977,5767,210,3.5,"Jefferson County, FL"
128,2023,Sep,6081,5875,206,3.4,"Jefferson County, FL"
129,2023,Oct,6088,5889,199,3.3,"Jefferson County, FL"
0,2013,Jan,18554,16556,1998,10.8,"Gadsden County, FL"
1,2013,Feb,18600,16741,1859,10.0,"Gadsden County, FL"
2,2013,Mar,18563,16814,1749,9.4,"Gadsden County, FL"
3,2013,Apr,18833,17137,1696,9.0,"Gadsden County, FL"
4,2013,May,18600,16842,1758,9.5,"Gadsden County, FL"
5,2013,Jun,19154,17262,1892,9.9,"Gadsden County, FL"
6,2013,Jul,18961,17083,1878,9.9,"Gadsden County, FL"
7,2013,Aug,18760,16889,1871,10.0,"Gadsden County, FL"
8,2013,Sep,19159,17366,1793,9.4,"Gadsden County, FL"
9,2013,Oct,19341,17569,1772,9.2,"Gadsden County, FL"
10,2013,Nov,19002,17303,1699,8.9,"Gadsden County, FL"
11,2013,Dec,18488,16877,1611,8.7,"Gadsden County, FL"
12,2014,Jan,18399,16706,1693,9.2,"Gadsden County, FL"
13,2014,Feb,18668,16970,1698,9.1,"Gadsden County, FL"
14,2014,Mar,18752,17056,1696,9.0,"Gadsden County, FL"
15,2014,Apr,18825,17295,1530,8.1,"Gadsden County, FL"
16,2014,May,18636,17022,1614,8.7,"Gadsden County, FL"
17,2014,Jun,19117,17482,1635,8.6,"Gadsden County, FL"
18,2014,Jul,18900,17221,1679,8.9,"Gadsden County, FL"
19,2014,Aug,18690,17043,1647,8.8,"Gadsden County, FL"
20,2014,Sep,19059,17541,1518,8.0,"Gadsden County, FL"
21,2014,Oct,19276,17790,1486,7.7,"Gadsden County, FL"
22,2014,Nov,18808,17316,1492,7.9,"Gadsden County, FL"
23,2014,Dec,18404,16987,1417,7.7,"Gadsden County, FL"
24,2015,Jan,18217,16705,1512,8.3,"Gadsden County, FL"
25,2015,Feb,18246,16846,1400,7.7,"Gadsden County, FL"
26,2015,Mar,18218,16879,1339,7.3,"Gadsden County, FL"
27,2015,Apr,18338,17053,1285,7.0,"Gadsden County, FL"
28,2015,May,18091,16750,1341,7.4,"Gadsden County, FL"
29,2015,Jun,18549,17168,1381,7.4,"Gadsden County, FL"
30,2015,Jul,18192,16788,1404,7.7,"Gadsden County, FL"
31,2015,Aug,18193,16858,1335,7.3,"Gadsden County, FL"
32,2015,Sep,18449,17185,1264,6.9,"Gadsden County, FL"
33,2015,Oct,18682,17421,1261,6.7,"Gadsden County, FL"
34,2015,Nov,18323,17080,1243,6.8,"Gadsden County, FL"
35,2015,Dec,17923,16747,1176,6.6,"Gadsden County, FL"
36,2016,Jan,17751,16520,1231,6.9,"Gadsden County, FL"
37,2016,Feb,17983,16816,1167,6.5,"Gadsden County, FL"
38,2016,Mar,17994,16863,1131,6.3,"Gadsden County, FL"
39,2016,Apr,18140,17019,1121,6.2,"Gadsden County, FL"
40,2016,May,18030,16902,1128,6.3,"Gadsden County, FL"
41,2016,Jun,18554,17332,1222,6.6,"Gadsden County, FL"
42,2016,Jul,18297,17078,1219,6.7,"Gadsden County, FL"
43,2016,Aug,18257,17051,1206,6.6,"Gadsden County, FL"
44,2016,Sep,18728,17564,1164,6.2,"Gadsden County, FL"
45,2016,Oct,18890,17782,1108,5.9,"Gadsden County, FL"
46,2016,Nov,18568,17472,1096,5.9,"Gadsden County, FL"
47,2016,Dec,18036,16964,1072,5.9,"Gadsden County, FL"
48,2017,Jan,17719,16546,1173,6.6,"Gadsden County, FL"
49,2017,Feb,17901,16824,1077,6.0,"Gadsden County, FL"
50,2017,Mar,17824,16849,975,5.5,"Gadsden County, FL"
51,2017,Apr,18045,17130,915,5.1,"Gadsden County, FL"
52,2017,May,17973,17018,955,5.3,"Gadsden County, FL"
53,2017,Jun,18300,17252,1048,5.7,"Gadsden County, FL"
54,2017,Jul,18061,16994,1067,5.9,"Gadsden County, FL"
55,2017,Aug,17835,16751,1084,6.1,"Gadsden County, FL"
56,2017,Sep,18387,17400,987,5.4,"Gadsden County, FL"
57,2017,Oct,18345,17396,949,5.2,"Gadsden County, FL"
58,2017,Nov,18085,17152,933,5.2,"Gadsden County, FL"
59,2017,Dec,17801,16907,894,5.0,"Gadsden County, FL"
60,2018,Jan,17883,16915,968,5.4,"Gadsden County, FL"
61,2018,Feb,18042,17155,887,4.9,"Gadsden County, FL"
62,2018,Mar,17985,17129,856,4.8,"Gadsden County, FL"
63,2018,Apr,18140,17343,797,4.4,"Gadsden County, FL"
64,2018,May,18097,17291,806,4.5,"Gadsden County, FL"
65,2018,Jun,18494,17550,944,5.1,"Gadsden County, FL"
66,2018,Jul,18286,17359,927,5.1,"Gadsden County, FL"
67,2018,Aug,18058,17188,870,4.8,"Gadsden County, FL"
68,2018,Sep,18629,17815,814,4.4,"Gadsden County, FL"
69,2018,Oct,18755,17982,773,4.1,"Gadsden County, FL"
70,2018,Nov,18473,17676,797,4.3,"Gadsden County, FL"
71,2018,Dec,18280,17496,784,4.3,"Gadsden County, FL"
72,2019,Jan,18034,17147,887,4.9,"Gadsden County, FL"
73,2019,Feb,18111,17338,773,4.3,"Gadsden County, FL"
74,2019,Mar,18164,17397,767,4.2,"Gadsden County, FL"
75,2019,Apr,18273,17586,687,3.8,"Gadsden County, FL"
76,2019,May,18177,17441,736,4.0,"Gadsden County, FL"
77,2019,Jun,18397,17566,831,4.5,"Gadsden County, FL"
78,2019,Jul,18411,17537,874,4.7,"Gadsden County, FL"
79,2019,Aug,18340,17484,856,4.7,"Gadsden County, FL"
80,2019,Sep,18882,18096,786,4.2,"Gadsden County, FL"
81,2019,Oct,19106,18325,781,4.1,"Gadsden County, FL"
82,2019,Nov,18902,18179,723,3.8,"Gadsden County, FL"
83,2019,Dec,18615,17959,656,3.5,"Gadsden County, FL"
84,2020,Jan,18387,17634,753,4.1,"Gadsden County, FL"
85,2020,Feb,18399,17750,649,3.5,"Gadsden County, FL"
86,2020,Mar,18165,17178,987,5.4,"Gadsden County, FL"
87,2020,Apr,16402,15171,1231,7.5,"Gadsden County, FL"
88,2020,May,17396,15848,1548,8.9,"Gadsden County, FL"
89,2020,Jun,17809,16247,1562,8.8,"Gadsden County, FL"
90,2020,Jul,18322,16299,2023,11.0,"Gadsden County, FL"
91,2020,Aug,18355,16744,1611,8.8,"Gadsden County, FL"
92,2020,Sep,18810,17233,1577,8.4,"Gadsden County, FL"
93,2020,Oct,19144,17730,1414,7.4,"Gadsden County, FL"
94,2020,Nov,18950,17595,1355,7.2,"Gadsden County, FL"
95,2020,Dec,18640,17349,1291,6.9,"Gadsden County, FL"
96,2021,Jan,18228,16946,1282,7.0,"Gadsden County, FL"
97,2021,Feb,18355,17148,1207,6.6,"Gadsden County, FL"
98,2021,Mar,18377,17302,1075,5.8,"Gadsden County, FL"
99,2021,Apr,18486,17461,1025,5.5,"Gadsden County, FL"
100,2021,May,18362,17383,979,5.3,"Gadsden County, FL"
101,2021,Jun,18627,17492,1135,6.1,"Gadsden County, FL"
102,2021,Jul,18575,17479,1096,5.9,"Gadsden County, FL"
103,2021,Aug,18528,17465,1063,5.7,"Gadsden County, FL"
104,2021,Sep,19081,18067,1014,5.3,"Gadsden County, FL"
105,2021,Oct,19200,18223,977,5.1,"Gadsden County, FL"
106,2021,Nov,19096,18174,922,4.8,"Gadsden County, FL"
107,2021,Dec,18785,17984,801,4.3,"Gadsden County, FL"
108,2022,Jan,18924,17992,932,4.9,"Gadsden County, FL"
109,2022,Feb,18933,18120,813,4.3,"Gadsden County, FL"
110,2022,Mar,18963,18221,742,3.9,"Gadsden County, FL"
111,2022,Apr,19060,18385,675,3.5,"Gadsden County, FL"
112,2022,May,18987,18309,678,3.6,"Gadsden County, FL"
113,2022,Jun,19225,18447,778,4.0,"Gadsden County, FL"
114,2022,Jul,19124,18377,747,3.9,"Gadsden County, FL"
115,2022,Aug,19068,18304,764,4.0,"Gadsden County, FL"
116,2022,Sep,19436,18762,674,3.5,"Gadsden County, FL"
117,2022,Oct,19555,18862,693,3.5,"Gadsden County, FL"
118,2022,Nov,19323,18652,671,3.5,"Gadsden County, FL"
119,2022,Dec,19112,18521,591,3.1,"Gadsden County, FL"
120,2023,Jan,19183,18523,660,3.4,"Gadsden County, FL"
121,2023,Feb,19351,18703,648,3.3,"Gadsden County, FL"
122,2023,Mar,19417,18777,640,3.3,"Gadsden County, FL"
123,2023,Apr,19412,18815,597,3.1,"Gadsden County, FL"
124,2023,May,19387,18720,667,3.4,"Gadsden County, FL"
125,2023,Jun,19746,18998,748,3.8,"Gadsden County, FL"
126,2023,Jul,19762,18987,775,3.9,"Gadsden County, FL"
127,2023,Aug,19832,19057,775,3.9,"Gadsden County, FL"
128,2023,Sep,20115,19358,757,3.8,"Gadsden County, FL"
129,2023,Oct,20203,19418,785,3.9,"Gadsden County, FL"
0,2013,Jan,204529,172768,31761,15.5,"Monterey County, CA"
1,2013,Feb,205780,175672,30108,14.6,"Monterey County, CA"
2,2013,Mar,206510,178563,27947,13.5,"Monterey County, CA"
3,2013,Apr,215646,192863,22783,10.6,"Monterey County, CA"
4,2013,May,221401,201910,19491,8.8,"Monterey County, CA"
5,2013,Jun,227539,207478,20061,8.8,"Monterey County, CA"
6,2013,Jul,226143,206646,19497,8.6,"Monterey County, CA"
7,2013,Aug,224345,205823,18522,8.3,"Monterey County, CA"
8,2013,Sep,221570,204129,17441,7.9,"Monterey County, CA"
9,2013,Oct,218305,200630,17675,8.1,"Monterey County, CA"
10,2013,Nov,214535,194145,20390,9.5,"Monterey County, CA"
11,2013,Dec,201814,177210,24604,12.2,"Monterey County, CA"
12,2014,Jan,205592,177599,27993,13.6,"Monterey County, CA"
13,2014,Feb,207197,179544,27653,13.3,"Monterey County, CA"
14,2014,Mar,211341,184621,26720,12.6,"Monterey County, CA"
15,2014,Apr,218066,198163,19903,9.1,"Monterey County, CA"
16,2014,May,222529,205554,16975,7.6,"Monterey County, CA"
17,2014,Jun,226976,210289,16687,7.4,"Monterey County, CA"
18,2014,Jul,226547,209599,16948,7.5,"Monterey County, CA"
19,2014,Aug,227107,211205,15902,7.0,"Monterey County, CA"
20,2014,Sep,224928,210477,14451,6.4,"Monterey County, CA"
21,2014,Oct,219728,205058,14670,6.7,"Monterey County, CA"
22,2014,Nov,214542,196346,18196,8.5,"Monterey County, CA"
23,2014,Dec,203692,180810,22882,11.2,"Monterey County, CA"
24,2015,Jan,205718,179699,26019,12.6,"Monterey County, CA"
25,2015,Feb,207362,182265,25097,12.1,"Monterey County, CA"
26,2015,Mar,210513,187762,22751,10.8,"Monterey County, CA"
27,2015,Apr,219264,201810,17454,8.0,"Monterey County, CA"
28,2015,May,224519,208835,15684,7.0,"Monterey County, CA"
29,2015,Jun,227547,212355,15192,6.7,"Monterey County, CA"
30,2015,Jul,228387,213593,14794,6.5,"Monterey County, CA"
31,2015,Aug,228840,215243,13597,5.9,"Monterey County, CA"
32,2015,Sep,226457,214082,12375,5.5,"Monterey County, CA"
33,2015,Oct,221042,208117,12925,5.8,"Monterey County, CA"
34,2015,Nov,215006,198508,16498,7.7,"Monterey County, CA"
35,2015,Dec,204633,183155,21478,10.5,"Monterey County, CA"
36,2016,Jan,207291,182748,24543,11.8,"Monterey County, CA"
37,2016,Feb,210360,186453,23907,11.4,"Monterey County, CA"
38,2016,Mar,211822,188187,23635,11.2,"Monterey County, CA"
39,2016,Apr,221784,204797,16987,7.7,"Monterey County, CA"
40,2016,May,224747,211153,13594,6.0,"Monterey County, CA"
41,2016,Jun,228318,214565,13753,6.0,"Monterey County, CA"
42,2016,Jul,227796,214366,13430,5.9,"Monterey County, CA"
43,2016,Aug,226495,213855,12640,5.6,"Monterey County, CA"
44,2016,Sep,225290,213475,11815,5.2,"Monterey County, CA"
45,2016,Oct,220118,208131,11987,5.4,"Monterey County, CA"
46,2016,Nov,214839,200379,14460,6.7,"Monterey County, CA"
47,2016,Dec,206759,185540,21219,10.3,"Monterey County, CA"
48,2017,Jan,206723,182789,23934,11.6,"Monterey County, CA"
49,2017,Feb,209838,185076,24762,11.8,"Monterey County, CA"
50,2017,Mar,212488,189196,23292,11.0,"Monterey County, CA"
51,2017,Apr,222185,204627,17558,7.9,"Monterey County, CA"
52,2017,May,225709,212261,13448,6.0,"Monterey County, CA"
53,2017,Jun,228423,215546,12877,5.6,"Monterey County, CA"
54,2017,Jul,229857,217320,12537,5.5,"Monterey County, CA"
55,2017,Aug,227174,215391,11783,5.2,"Monterey County, CA"
56,2017,Sep,226134,215945,10189,4.5,"Monterey County, CA"
57,2017,Oct,220422,210261,10161,4.6,"Monterey County, CA"
58,2017,Nov,217507,205514,11993,5.5,"Monterey County, CA"
59,2017,Dec,207385,189637,17748,8.6,"Monterey County, CA"
60,2018,Jan,208688,188160,20528,9.8,"Monterey County, CA"
61,2018,Feb,215148,193213,21935,10.2,"Monterey County, CA"
62,2018,Mar,216795,196026,20769,9.6,"Monterey County, CA"
63,2018,Apr,223125,207494,15631,7.0,"Monterey County, CA"
64,2018,May,227982,216013,11969,5.2,"Monterey County, CA"
65,2018,Jun,230813,219193,11620,5.0,"Monterey County, CA"
66,2018,Jul,231385,220397,10988,4.7,"Monterey County, CA"
67,2018,Aug,227972,217975,9997,4.4,"Monterey County, CA"
68,2018,Sep,227990,219009,8981,3.9,"Monterey County, CA"
69,2018,Oct,223907,214535,9372,4.2,"Monterey County, CA"
70,2018,Nov,218147,207203,10944,5.0,"Monterey County, CA"
71,2018,Dec,210776,193424,17352,8.2,"Monterey County, CA"
72,2019,Jan,210357,188610,21747,10.3,"Monterey County, CA"
73,2019,Feb,214252,192087,22165,10.3,"Monterey County, CA"
74,2019,Mar,215366,194226,21140,9.8,"Monterey County, CA"
75,2019,Apr,223298,207496,15802,7.1,"Monterey County, CA"
76,2019,May,228268,217182,11086,4.9,"Monterey County, CA"
77,2019,Jun,230205,219210,10995,4.8,"Monterey County, CA"
78,2019,Jul,230584,219803,10781,4.7,"Monterey County, CA"
79,2019,Aug,228163,218417,9746,4.3,"Monterey County, CA"
80,2019,Sep,227724,219395,8329,3.7,"Monterey County, CA"
81,2019,Oct,224087,215111,8976,4.0,"Monterey County, CA"
82,2019,Nov,217858,207126,10732,4.9,"Monterey County, CA"
83,2019,Dec,208838,192724,16114,7.7,"Monterey County, CA"
84,2020,Jan,210827,189660,21167,10.0,"Monterey County, CA"
85,2020,Feb,214735,193068,21667,10.1,"Monterey County, CA"
86,2020,Mar,219684,189602,30082,13.7,"Monterey County, CA"
87,2020,Apr,217792,175629,42163,19.4,"Monterey County, CA"
88,2020,May,216158,183515,32643,15.1,"Monterey County, CA"
89,2020,Jun,223985,197102,26883,12.0,"Monterey County, CA"
90,2020,Jul,222280,199171,23109,10.4,"Monterey County, CA"
91,2020,Aug,220216,201826,18390,8.4,"Monterey County, CA"
92,2020,Sep,216728,199409,17319,8.0,"Monterey County, CA"
93,2020,Oct,211917,196347,15570,7.3,"Monterey County, CA"
94,2020,Nov,204960,188207,16753,8.2,"Monterey County, CA"
95,2020,Dec,196190,174779,21411,10.9,"Monterey County, CA"
96,2021,Jan,196703,171656,25047,12.7,"Monterey County, CA"
97,2021,Feb,200577,175635,24942,12.4,"Monterey County, CA"
98,2021,Mar,201226,177423,23803,11.8,"Monterey County, CA"
99,2021,Apr,213943,193625,20318,9.5,"Monterey County, CA"
100,2021,May,217221,200205,17016,7.8,"Monterey County, CA"
101,2021,Jun,220877,203370,17507,7.9,"Monterey County, CA"
102,2021,Jul,223299,207511,15788,7.1,"Monterey County, CA"
103,2021,Aug,221739,207418,14321,6.5,"Monterey County, CA"
104,2021,Sep,219889,207821,12068,5.5,"Monterey County, CA"
105,2021,Oct,217364,205606,11758,5.4,"Monterey County, CA"
106,2021,Nov,212252,200048,12204,5.7,"Monterey County, CA"
107,2021,Dec,201607,185705,15902,7.9,"Monterey County, CA"
108,2022,Jan,204245,184356,19889,9.7,"Monterey County, CA"
109,2022,Feb,207849,187795,20054,9.6,"Monterey County, CA"
110,2022,Mar,209546,191449,18097,8.6,"Monterey County, CA"
111,2022,Apr,221051,207194,13857,6.3,"Monterey County, CA"
112,2022,May,225165,214488,10677,4.7,"Monterey County, CA"
113,2022,Jun,227350,217042,10308,4.5,"Monterey County, CA"
114,2022,Jul,230115,220196,9919,4.3,"Monterey County, CA"
115,2022,Aug,229271,219644,9627,4.2,"Monterey County, CA"
116,2022,Sep,229067,220591,8476,3.7,"Monterey County, CA"
117,2022,Oct,224906,215494,9412,4.2,"Monterey County, CA"
118,2022,Nov,221749,210144,11605,5.2,"Monterey County, CA"
119,2022,Dec,215385,200210,15175,7.0,"Monterey County, CA"
120,2023,Jan,216615,197356,19259,8.9,"Monterey County, CA"
121,2023,Feb,222466,200926,21540,9.7,"Monterey County, CA"
122,2023,Mar,225229,203345,21884,9.7,"Monterey County, CA"
123,2023,Apr,232746,215588,17158,7.4,"Monterey County, CA"
124,2023,May,236559,221552,15007,6.3,"Monterey County, CA"
125,2023,Jun,236773,223839,12934,5.5,"Monterey County, CA"
126,2023,Jul,238427,226781,11646,4.9,"Monterey County, CA"
127,2023,Aug,237290,225635,11655,4.9,"Monterey County, CA"
128,2023,Sep,236326,225912,10414,4.4,"Monterey County, CA"
129,2023,Oct,232671,221589,11082,4.8,"Monterey County, CA"
0,2013,Jan,648722,595344,53378,8.2,"Orange County, FL"
1,2013,Feb,649745,600487,49258,7.6,"Orange County, FL"
2,2013,Mar,651684,604667,47017,7.2,"Orange County, FL"
3,2013,Apr,652091,606669,45422,7.0,"Orange County, FL"
4,2013,May,662592,615963,46629,7.0,"Orange County, FL"
5,2013,Jun,668586,618929,49657,7.4,"Orange County, FL"
6,2013,Jul,670555,621683,48872,7.3,"Orange County, FL"
7,2013,Aug,670764,623134,47630,7.1,"Orange County, FL"
8,2013,Sep,671784,625966,45818,6.8,"Orange County, FL"
9,2013,Oct,666941,621925,45016,6.7,"Orange County, FL"
10,2013,Nov,662332,619610,42722,6.5,"Orange County, FL"
11,2013,Dec,660188,619465,40723,6.2,"Orange County, FL"
12,2014,Jan,662898,619552,43346,6.5,"Orange County, FL"
13,2014,Feb,665903,623638,42265,6.3,"Orange County, FL"
14,2014,Mar,671030,629509,41521,6.2,"Orange County, FL"
15,2014,Apr,666699,628662,38037,5.7,"Orange County, FL"
16,2014,May,676909,636678,40231,5.9,"Orange County, FL"
17,2014,Jun,680032,637915,42117,6.2,"Orange County, FL"
18,2014,Jul,683788,639793,43995,6.4,"Orange County, FL"
19,2014,Aug,684379,641342,43037,6.3,"Orange County, FL"
20,2014,Sep,684278,644280,39998,5.8,"Orange County, FL"
21,2014,Oct,681320,642876,38444,5.6,"Orange County, FL"
22,2014,Nov,675349,636857,38492,5.7,"Orange County, FL"
23,2014,Dec,672674,636716,35958,5.3,"Orange County, FL"
24,2015,Jan,673771,634599,39172,5.8,"Orange County, FL"
25,2015,Feb,674940,638999,35941,5.3,"Orange County, FL"
26,2015,Mar,677013,642850,34163,5.0,"Orange County, FL"
27,2015,Apr,680126,646812,33314,4.9,"Orange County, FL"
28,2015,May,690908,655512,35396,5.1,"Orange County, FL"
29,2015,Jun,694643,657886,36757,5.3,"Orange County, FL"
30,2015,Jul,696293,659353,36940,5.3,"Orange County, FL"
31,2015,Aug,695908,660283,35625,5.1,"Orange County, FL"
32,2015,Sep,697533,663491,34042,4.9,"Orange County, FL"
33,2015,Oct,696535,663047,33488,4.8,"Orange County, FL"
34,2015,Nov,692799,659747,33052,4.8,"Orange County, FL"
35,2015,Dec,694366,662874,31492,4.5,"Orange County, FL"
36,2016,Jan,692389,659382,33007,4.8,"Orange County, FL"
37,2016,Feb,697441,666731,30710,4.4,"Orange County, FL"
38,2016,Mar,700003,669730,30273,4.3,"Orange County, FL"
39,2016,Apr,699485,670089,29396,4.2,"Orange County, FL"
40,2016,May,707553,678573,28980,4.1,"Orange County, FL"
41,2016,Jun,712867,679955,32912,4.6,"Orange County, FL"
42,2016,Jul,717567,684281,33286,4.6,"Orange County, FL"
43,2016,Aug,717123,684134,32989,4.6,"Orange County, FL"
44,2016,Sep,721236,688784,32452,4.5,"Orange County, FL"
45,2016,Oct,717423,686310,31113,4.3,"Orange County, FL"
46,2016,Nov,711340,681575,29765,4.2,"Orange County, FL"
47,2016,Dec,711379,682509,28870,4.1,"Orange County, FL"
48,2017,Jan,708142,676582,31560,4.5,"Orange County, FL"
49,2017,Feb,712689,683988,28701,4.0,"Orange County, FL"
50,2017,Mar,715400,688378,27022,3.8,"Orange County, FL"
51,2017,Apr,716594,690981,25613,3.6,"Orange County, FL"
52,2017,May,721995,695702,26293,3.6,"Orange County, FL"
53,2017,Jun,728590,699510,29080,4.0,"Orange County, FL"
54,2017,Jul,730061,700400,29661,4.1,"Orange County, FL"
55,2017,Aug,727432,697818,29614,4.1,"Orange County, FL"
56,2017,Sep,733739,706375,27364,3.7,"Orange County, FL"
57,2017,Oct,730755,704552,26203,3.6,"Orange County, FL"
58,2017,Nov,727774,701255,26519,3.6,"Orange County, FL"
59,2017,Dec,727423,702670,24753,3.4,"Orange County, FL"
60,2018,Jan,726885,699557,27328,3.8,"Orange County, FL"
61,2018,Feb,731791,706434,25357,3.5,"Orange County, FL"
62,2018,Mar,733105,708746,24359,3.3,"Orange County, FL"
63,2018,Apr,733815,710873,22942,3.1,"Orange County, FL"
64,2018,May,739145,716439,22706,3.1,"Orange County, FL"
65,2018,Jun,746909,719757,27152,3.6,"Orange County, FL"
66,2018,Jul,750273,723591,26682,3.6,"Orange County, FL"
67,2018,Aug,746190,720411,25779,3.5,"Orange County, FL"
68,2018,Sep,750002,726457,23545,3.1,"Orange County, FL"
69,2018,Oct,752443,728805,23638,3.1,"Orange County, FL"
70,2018,Nov,745680,723171,22509,3.0,"Orange County, FL"
71,2018,Dec,743325,720808,22517,3.0,"Orange County, FL"
72,2019,Jan,738709,712475,26234,3.6,"Orange County, FL"
73,2019,Feb,743826,721177,22649,3.0,"Orange County, FL"
74,2019,Mar,744933,722733,22200,3.0,"Orange County, FL"
75,2019,Apr,744999,724948,20051,2.7,"Orange County, FL"
76,2019,May,751259,730005,21254,2.8,"Orange County, FL"
77,2019,Jun,758242,733755,24487,3.2,"Orange County, FL"
78,2019,Jul,761985,736621,25364,3.3,"Orange County, FL"
79,2019,Aug,762736,738055,24681,3.2,"Orange County, FL"
80,2019,Sep,765857,743331,22526,2.9,"Orange County, FL"
81,2019,Oct,765265,743140,22125,2.9,"Orange County, FL"
82,2019,Nov,760026,739255,20771,2.7,"Orange County, FL"
83,2019,Dec,759492,740168,19324,2.5,"Orange County, FL"
84,2020,Jan,757528,734959,22569,3.0,"Orange County, FL"
85,2020,Feb,760586,741174,19412,2.6,"Orange County, FL"
86,2020,Mar,748373,718318,30055,4.0,"Orange County, FL"
87,2020,Apr,712031,592763,119268,16.8,"Orange County, FL"
88,2020,May,759557,584878,174679,23.0,"Orange County, FL"
89,2020,Jun,753283,605442,147841,19.6,"Orange County, FL"
90,2020,Jul,762436,627662,134774,17.7,"Orange County, FL"
91,2020,Aug,736394,644452,91942,12.5,"Orange County, FL"
92,2020,Sep,734193,652164,82029,11.2,"Orange County, FL"
93,2020,Oct,731882,665850,66032,9.0,"Orange County, FL"
94,2020,Nov,728131,670507,57624,7.9,"Orange County, FL"
95,2020,Dec,721713,670434,51279,7.1,"Orange County, FL"
96,2021,Jan,715385,665172,50213,7.0,"Orange County, FL"
97,2021,Feb,717260,672881,44379,6.2,"Orange County, FL"
98,2021,Mar,721388,679781,41607,5.8,"Orange County, FL"
99,2021,Apr,727860,687282,40578,5.6,"Orange County, FL"
100,2021,May,733191,693407,39784,5.4,"Orange County, FL"
101,2021,Jun,744486,700866,43620,5.9,"Orange County, FL"
102,2021,Jul,752074,712290,39784,5.3,"Orange County, FL"
103,2021,Aug,757038,719416,37622,5.0,"Orange County, FL"
104,2021,Sep,763158,728877,34281,4.5,"Orange County, FL"
105,2021,Oct,768084,735848,32236,4.2,"Orange County, FL"
106,2021,Nov,768807,739095,29712,3.9,"Orange County, FL"
107,2021,Dec,767693,741993,25700,3.3,"Orange County, FL"
108,2022,Jan,772116,741863,30253,3.9,"Orange County, FL"
109,2022,Feb,775381,749341,26040,3.4,"Orange County, FL"
110,2022,Mar,780986,757786,23200,3.0,"Orange County, FL"
111,2022,Apr,781831,760280,21551,2.8,"Orange County, FL"
112,2022,May,787836,766429,21407,2.7,"Orange County, FL"
113,2022,Jun,795044,770826,24218,3.0,"Orange County, FL"
114,2022,Jul,799022,775670,23352,2.9,"Orange County, FL"
115,2022,Aug,803230,779863,23367,2.9,"Orange County, FL"
116,2022,Sep,807456,786591,20865,2.6,"Orange County, FL"
117,2022,Oct,804213,782784,21429,2.7,"Orange County, FL"
118,2022,Nov,801146,780739,20407,2.5,"Orange County, FL"
119,2022,Dec,800794,783159,17635,2.2,"Orange County, FL"
120,2023,Jan,799576,779520,20056,2.5,"Orange County, FL"
121,2023,Feb,806583,786615,19968,2.5,"Orange County, FL"
122,2023,Mar,812528,792223,20305,2.5,"Orange County, FL"
123,2023,Apr,813664,795248,18416,2.3,"Orange County, FL"
124,2023,May,815977,794521,21456,2.6,"Orange County, FL"
125,2023,Jun,825779,801584,24195,2.9,"Orange County, FL"
126,2023,Jul,829362,804249,25113,3.0,"Orange County, FL"
127,2023,Aug,834514,809021,25493,3.1,"Orange County, FL"
128,2023,Sep,836006,811326,24680,3.0,"Orange County, FL"
129,2023,Oct,832123,806789,25334,3.0,"Orange County, FL"
0,2013,Jan,7805,7091,714,9.1,"Madison County, FL"
1,2013,Feb,7834,7179,655,8.4,"Madison County, FL"
2,2013,Mar,7820,7203,617,7.9,"Madison County, FL"
3,2013,Apr,7809,7198,611,7.8,"Madison County, FL"
4,2013,May,7868,7248,620,7.9,"Madison County, FL"
5,2013,Jun,7896,7226,670,8.5,"Madison County, FL"
6,2013,Jul,8026,7355,671,8.4,"Madison County, FL"
7,2013,Aug,8072,7402,670,8.3,"Madison County, FL"
8,2013,Sep,7987,7356,631,7.9,"Madison County, FL"
9,2013,Oct,8010,7383,627,7.8,"Madison County, FL"
10,2013,Nov,7829,7221,608,7.8,"Madison County, FL"
11,2013,Dec,7753,7158,595,7.7,"Madison County, FL"
12,2014,Jan,7792,7177,615,7.9,"Madison County, FL"
13,2014,Feb,7850,7258,592,7.5,"Madison County, FL"
14,2014,Mar,7887,7300,587,7.4,"Madison County, FL"
15,2014,Apr,7646,7111,535,7.0,"Madison County, FL"
16,2014,May,7712,7157,555,7.2,"Madison County, FL"
17,2014,Jun,7594,7029,565,7.4,"Madison County, FL"
18,2014,Jul,7688,7083,605,7.9,"Madison County, FL"
19,2014,Aug,7755,7160,595,7.7,"Madison County, FL"
20,2014,Sep,7749,7208,541,7.0,"Madison County, FL"
21,2014,Oct,7840,7292,548,7.0,"Madison County, FL"
22,2014,Nov,7655,7096,559,7.3,"Madison County, FL"
23,2014,Dec,7553,7056,497,6.6,"Madison County, FL"
24,2015,Jan,7620,7095,525,6.9,"Madison County, FL"
25,2015,Feb,7552,7061,491,6.5,"Madison County, FL"
26,2015,Mar,7474,7012,462,6.2,"Madison County, FL"
27,2015,Apr,7477,7019,458,6.1,"Madison County, FL"
28,2015,May,7563,7091,472,6.2,"Madison County, FL"
29,2015,Jun,7314,6834,480,6.6,"Madison County, FL"
30,2015,Jul,7327,6833,494,6.7,"Madison County, FL"
31,2015,Aug,7482,7011,471,6.3,"Madison County, FL"
32,2015,Sep,7538,7093,445,5.9,"Madison County, FL"
33,2015,Oct,7629,7188,441,5.8,"Madison County, FL"
34,2015,Nov,7585,7142,443,5.8,"Madison County, FL"
35,2015,Dec,7493,7093,400,5.3,"Madison County, FL"
36,2016,Jan,7391,6987,404,5.5,"Madison County, FL"
37,2016,Feb,7329,6918,411,5.6,"Madison County, FL"
38,2016,Mar,7325,6930,395,5.4,"Madison County, FL"
39,2016,Apr,7305,6922,383,5.2,"Madison County, FL"
40,2016,May,7374,7012,362,4.9,"Madison County, FL"
41,2016,Jun,7289,6884,405,5.6,"Madison County, FL"
42,2016,Jul,7172,6762,410,5.7,"Madison County, FL"
43,2016,Aug,7438,7027,411,5.5,"Madison County, FL"
44,2016,Sep,7425,7031,394,5.3,"Madison County, FL"
45,2016,Oct,7442,7065,377,5.1,"Madison County, FL"
46,2016,Nov,7413,7040,373,5.0,"Madison County, FL"
47,2016,Dec,7287,6937,350,4.8,"Madison County, FL"
48,2017,Jan,7223,6839,384,5.3,"Madison County, FL"
49,2017,Feb,7234,6864,370,5.1,"Madison County, FL"
50,2017,Mar,7293,6962,331,4.5,"Madison County, FL"
51,2017,Apr,7290,6987,303,4.2,"Madison County, FL"
52,2017,May,7376,7062,314,4.3,"Madison County, FL"
53,2017,Jun,7460,7120,340,4.6,"Madison County, FL"
54,2017,Jul,7364,7000,364,4.9,"Madison County, FL"
55,2017,Aug,7411,7060,351,4.7,"Madison County, FL"
56,2017,Sep,7462,7144,318,4.3,"Madison County, FL"
57,2017,Oct,7297,6995,302,4.1,"Madison County, FL"
58,2017,Nov,7199,6894,305,4.2,"Madison County, FL"
59,2017,Dec,7147,6857,290,4.1,"Madison County, FL"
60,2018,Jan,7144,6825,319,4.5,"Madison County, FL"
61,2018,Feb,7142,6843,299,4.2,"Madison County, FL"
62,2018,Mar,7184,6902,282,3.9,"Madison County, FL"
63,2018,Apr,7191,6921,270,3.8,"Madison County, FL"
64,2018,May,7220,6935,285,3.9,"Madison County, FL"
65,2018,Jun,7286,6957,329,4.5,"Madison County, FL"
66,2018,Jul,7241,6934,307,4.2,"Madison County, FL"
67,2018,Aug,7295,7001,294,4.0,"Madison County, FL"
68,2018,Sep,7385,7121,264,3.6,"Madison County, FL"
69,2018,Oct,7367,7091,276,3.7,"Madison County, FL"
70,2018,Nov,7238,6963,275,3.8,"Madison County, FL"
71,2018,Dec,7243,6967,276,3.8,"Madison County, FL"
72,2019,Jan,7274,6947,327,4.5,"Madison County, FL"
73,2019,Feb,7243,6954,289,4.0,"Madison County, FL"
74,2019,Mar,7281,6999,282,3.9,"Madison County, FL"
75,2019,Apr,7370,7119,251,3.4,"Madison County, FL"
76,2019,May,7444,7179,265,3.6,"Madison County, FL"
77,2019,Jun,7469,7161,308,4.1,"Madison County, FL"
78,2019,Jul,7471,7140,331,4.4,"Madison County, FL"
79,2019,Aug,7574,7264,310,4.1,"Madison County, FL"
80,2019,Sep,7605,7309,296,3.9,"Madison County, FL"
81,2019,Oct,7515,7245,270,3.6,"Madison County, FL"
82,2019,Nov,7403,7136,267,3.6,"Madison County, FL"
83,2019,Dec,7352,7106,246,3.3,"Madison County, FL"
84,2020,Jan,7544,7276,268,3.6,"Madison County, FL"
85,2020,Feb,7503,7272,231,3.1,"Madison County, FL"
86,2020,Mar,7465,7129,336,4.5,"Madison County, FL"
87,2020,Apr,6960,6507,453,6.5,"Madison County, FL"
88,2020,May,7259,6699,560,7.7,"Madison County, FL"
89,2020,Jun,7398,6816,582,7.9,"Madison County, FL"
90,2020,Jul,7855,7030,825,10.5,"Madison County, FL"
91,2020,Aug,7864,7243,621,7.9,"Madison County, FL"
92,2020,Sep,7930,7337,593,7.5,"Madison County, FL"
93,2020,Oct,7674,7157,517,6.7,"Madison County, FL"
94,2020,Nov,7676,7224,452,5.9,"Madison County, FL"
95,2020,Dec,7550,7109,441,5.8,"Madison County, FL"
96,2021,Jan,7485,7022,463,6.2,"Madison County, FL"
97,2021,Feb,7562,7142,420,5.6,"Madison County, FL"
98,2021,Mar,7515,7119,396,5.3,"Madison County, FL"
99,2021,Apr,7582,7193,389,5.1,"Madison County, FL"
100,2021,May,7639,7225,414,5.4,"Madison County, FL"
101,2021,Jun,7639,7200,439,5.7,"Madison County, FL"
102,2021,Jul,7751,7328,423,5.5,"Madison County, FL"
103,2021,Aug,7863,7468,395,5.0,"Madison County, FL"
104,2021,Sep,7904,7554,350,4.4,"Madison County, FL"
105,2021,Oct,7806,7466,340,4.4,"Madison County, FL"
106,2021,Nov,7747,7424,323,4.2,"Madison County, FL"
107,2021,Dec,7731,7445,286,3.7,"Madison County, FL"
108,2022,Jan,7801,7457,344,4.4,"Madison County, FL"
109,2022,Feb,7794,7501,293,3.8,"Madison County, FL"
110,2022,Mar,7709,7455,254,3.3,"Madison County, FL"
111,2022,Apr,7800,7557,243,3.1,"Madison County, FL"
112,2022,May,7912,7659,253,3.2,"Madison County, FL"
113,2022,Jun,7922,7650,272,3.4,"Madison County, FL"
114,2022,Jul,7803,7549,254,3.3,"Madison County, FL"
115,2022,Aug,7857,7598,259,3.3,"Madison County, FL"
116,2022,Sep,7924,7683,241,3.0,"Madison County, FL"
117,2022,Oct,7874,7633,241,3.1,"Madison County, FL"
118,2022,Nov,7815,7580,235,3.0,"Madison County, FL"
119,2022,Dec,7773,7577,196,2.5,"Madison County, FL"
120,2023,Jan,7815,7587,228,2.9,"Madison County, FL"
121,2023,Feb,7873,7637,236,3.0,"Madison County, FL"
122,2023,Mar,7939,7710,229,2.9,"Madison County, FL"
123,2023,Apr,7917,7723,194,2.5,"Madison County, FL"
124,2023,May,7966,7746,220,2.8,"Madison County, FL"
125,2023,Jun,8042,7789,253,3.1,"Madison County, FL"
126,2023,Jul,8133,7868,265,3.3,"Madison County, FL"
127,2023,Aug,8311,8017,294,3.5,"Madison County, FL"
128,2023,Sep,8343,8028,315,3.8,"Madison County, FL"
129,2023,Oct,8238,7955,283,3.4,"Madison County, FL"
0,2013,Jan,40843,36642,4201,10.3,"Mendocino County, CA"
1,2013,Feb,40637,36664,3973,9.8,"Mendocino County, CA"
2,2013,Mar,40671,36838,3833,9.4,"Mendocino County, CA"
3,2013,Apr,40582,37108,3474,8.6,"Mendocino County, CA"
4,2013,May,41277,38082,3195,7.7,"Mendocino County, CA"
5,2013,Jun,41678,38256,3422,8.2,"Mendocino County, CA"
6,2013,Jul,40926,37492,3434,8.4,"Mendocino County, CA"
7,2013,Aug,40926,37672,3254,8.0,"Mendocino County, CA"
8,2013,Sep,40675,37557,3118,7.7,"Mendocino County, CA"
9,2013,Oct,40535,37415,3120,7.7,"Mendocino County, CA"
10,2013,Nov,39764,36607,3157,7.9,"Mendocino County, CA"
11,2013,Dec,39766,36623,3143,7.9,"Mendocino County, CA"
12,2014,Jan,39886,36532,3354,8.4,"Mendocino County, CA"
13,2014,Feb,40188,36750,3438,8.6,"Mendocino County, CA"
14,2014,Mar,40459,37067,3392,8.4,"Mendocino County, CA"
15,2014,Apr,40057,37208,2849,7.1,"Mendocino County, CA"
16,2014,May,40528,37905,2623,6.5,"Mendocino County, CA"
17,2014,Jun,40888,38142,2746,6.7,"Mendocino County, CA"
18,2014,Jul,40423,37565,2858,7.1,"Mendocino County, CA"
19,2014,Aug,40760,38024,2736,6.7,"Mendocino County, CA"
20,2014,Sep,40712,38236,2476,6.1,"Mendocino County, CA"
21,2014,Oct,40393,37917,2476,6.1,"Mendocino County, CA"
22,2014,Nov,39676,37052,2624,6.6,"Mendocino County, CA"
23,2014,Dec,39639,36950,2689,6.8,"Mendocino County, CA"
24,2015,Jan,39740,36850,2890,7.3,"Mendocino County, CA"
25,2015,Feb,39738,36968,2770,7.0,"Mendocino County, CA"
26,2015,Mar,40002,37266,2736,6.8,"Mendocino County, CA"
27,2015,Apr,40041,37719,2322,5.8,"Mendocino County, CA"
28,2015,May,40352,38217,2135,5.3,"Mendocino County, CA"
29,2015,Jun,40445,38198,2247,5.6,"Mendocino County, CA"
30,2015,Jul,39583,37337,2246,5.7,"Mendocino County, CA"
31,2015,Aug,40133,38021,2112,5.3,"Mendocino County, CA"
32,2015,Sep,39731,37798,1933,4.9,"Mendocino County, CA"
33,2015,Oct,39624,37570,2054,5.2,"Mendocino County, CA"
34,2015,Nov,39283,37092,2191,5.6,"Mendocino County, CA"
35,2015,Dec,39291,36960,2331,5.9,"Mendocino County, CA"
36,2016,Jan,39264,36710,2554,6.5,"Mendocino County, CA"
37,2016,Feb,39663,37247,2416,6.1,"Mendocino County, CA"
38,2016,Mar,40308,37802,2506,6.2,"Mendocino County, CA"
39,2016,Apr,39576,37503,2073,5.2,"Mendocino County, CA"
40,2016,May,39715,37974,1741,4.4,"Mendocino County, CA"
41,2016,Jun,40269,38295,1974,4.9,"Mendocino County, CA"
42,2016,Jul,39742,37732,2010,5.1,"Mendocino County, CA"
43,2016,Aug,39902,37919,1983,5.0,"Mendocino County, CA"
44,2016,Sep,39665,37828,1837,4.6,"Mendocino County, CA"
45,2016,Oct,39411,37499,1912,4.9,"Mendocino County, CA"
46,2016,Nov,38877,36861,2016,5.2,"Mendocino County, CA"
47,2016,Dec,39005,36880,2125,5.4,"Mendocino County, CA"
48,2017,Jan,39223,36908,2315,5.9,"Mendocino County, CA"
49,2017,Feb,39668,37479,2189,5.5,"Mendocino County, CA"
50,2017,Mar,39773,37662,2111,5.3,"Mendocino County, CA"
51,2017,Apr,39318,37418,1900,4.8,"Mendocino County, CA"
52,2017,May,39580,38026,1554,3.9,"Mendocino County, CA"
53,2017,Jun,39997,38264,1733,4.3,"Mendocino County, CA"
54,2017,Jul,39704,37910,1794,4.5,"Mendocino County, CA"
55,2017,Aug,39983,38253,1730,4.3,"Mendocino County, CA"
56,2017,Sep,39909,38416,1493,3.7,"Mendocino County, CA"
57,2017,Oct,39479,37966,1513,3.8,"Mendocino County, CA"
58,2017,Nov,38797,37222,1575,4.1,"Mendocino County, CA"
59,2017,Dec,38987,37301,1686,4.3,"Mendocino County, CA"
60,2018,Jan,38867,36983,1884,4.8,"Mendocino County, CA"
61,2018,Feb,39433,37598,1835,4.7,"Mendocino County, CA"
62,2018,Mar,39425,37619,1806,4.6,"Mendocino County, CA"
63,2018,Apr,39193,37618,1575,4.0,"Mendocino County, CA"
64,2018,May,39562,38291,1271,3.2,"Mendocino County, CA"
65,2018,Jun,39190,37651,1539,3.9,"Mendocino County, CA"
66,2018,Jul,39813,38305,1508,3.8,"Mendocino County, CA"
67,2018,Aug,39919,38414,1505,3.8,"Mendocino County, CA"
68,2018,Sep,39645,38258,1387,3.5,"Mendocino County, CA"
69,2018,Oct,39979,38554,1425,3.6,"Mendocino County, CA"
70,2018,Nov,39459,37967,1492,3.8,"Mendocino County, CA"
71,2018,Dec,38992,37268,1724,4.4,"Mendocino County, CA"
72,2019,Jan,38700,36610,2090,5.4,"Mendocino County, CA"
73,2019,Feb,38891,36913,1978,5.1,"Mendocino County, CA"
74,2019,Mar,39083,37156,1927,4.9,"Mendocino County, CA"
75,2019,Apr,38643,37069,1574,4.1,"Mendocino County, CA"
76,2019,May,38701,37430,1271,3.3,"Mendocino County, CA"
77,2019,Jun,38786,37331,1455,3.8,"Mendocino County, CA"
78,2019,Jul,38941,37415,1526,3.9,"Mendocino County, CA"
79,2019,Aug,38863,37426,1437,3.7,"Mendocino County, CA"
80,2019,Sep,38895,37671,1224,3.1,"Mendocino County, CA"
81,2019,Oct,38832,37557,1275,3.3,"Mendocino County, CA"
82,2019,Nov,38268,36889,1379,3.6,"Mendocino County, CA"
83,2019,Dec,38281,36783,1498,3.9,"Mendocino County, CA"
84,2020,Jan,38365,36504,1861,4.9,"Mendocino County, CA"
85,2020,Feb,38585,36801,1784,4.6,"Mendocino County, CA"
86,2020,Mar,38839,36273,2566,6.6,"Mendocino County, CA"
87,2020,Apr,36819,30981,5838,15.9,"Mendocino County, CA"
88,2020,May,35713,30733,4980,13.9,"Mendocino County, CA"
89,2020,Jun,37373,32936,4437,11.9,"Mendocino County, CA"
90,2020,Jul,37142,33082,4060,10.9,"Mendocino County, CA"
91,2020,Aug,37293,33931,3362,9.0,"Mendocino County, CA"
92,2020,Sep,37287,34099,3188,8.5,"Mendocino County, CA"
93,2020,Oct,36940,34102,2838,7.7,"Mendocino County, CA"
94,2020,Nov,36253,33422,2831,7.8,"Mendocino County, CA"
95,2020,Dec,36175,33307,2868,7.9,"Mendocino County, CA"
96,2021,Jan,36171,33211,2960,8.2,"Mendocino County, CA"
97,2021,Feb,36504,33588,2916,8.0,"Mendocino County, CA"
98,2021,Mar,36890,34071,2819,7.6,"Mendocino County, CA"
99,2021,Apr,36496,33941,2555,7.0,"Mendocino County, CA"
100,2021,May,36781,34537,2244,6.1,"Mendocino County, CA"
101,2021,Jun,37072,34602,2470,6.7,"Mendocino County, CA"
102,2021,Jul,37328,34955,2373,6.4,"Mendocino County, CA"
103,2021,Aug,37214,34979,2235,6.0,"Mendocino County, CA"
104,2021,Sep,37446,35586,1860,5.0,"Mendocino County, CA"
105,2021,Oct,36932,35090,1842,5.0,"Mendocino County, CA"
106,2021,Nov,36520,34703,1817,5.0,"Mendocino County, CA"
107,2021,Dec,36493,34773,1720,4.7,"Mendocino County, CA"
108,2022,Jan,36875,34854,2021,5.5,"Mendocino County, CA"
109,2022,Feb,37098,35254,1844,5.0,"Mendocino County, CA"
110,2022,Mar,37364,35722,1642,4.4,"Mendocino County, CA"
111,2022,Apr,36674,35209,1465,4.0,"Mendocino County, CA"
112,2022,May,37054,35795,1259,3.4,"Mendocino County, CA"
113,2022,Jun,37294,35855,1439,3.9,"Mendocino County, CA"
114,2022,Jul,37251,35823,1428,3.8,"Mendocino County, CA"
115,2022,Aug,37379,35938,1441,3.9,"Mendocino County, CA"
116,2022,Sep,37625,36350,1275,3.4,"Mendocino County, CA"
117,2022,Oct,37443,36055,1388,3.7,"Mendocino County, CA"
118,2022,Nov,37043,35479,1564,4.2,"Mendocino County, CA"
119,2022,Dec,37097,35503,1594,4.3,"Mendocino County, CA"
120,2023,Jan,36912,34902,2010,5.4,"Mendocino County, CA"
121,2023,Feb,37357,35366,1991,5.3,"Mendocino County, CA"
122,2023,Mar,37627,35622,2005,5.3,"Mendocino County, CA"
123,2023,Apr,35743,34082,1661,4.6,"Mendocino County, CA"
124,2023,May,36191,34638,1553,4.3,"Mendocino County, CA"
125,2023,Jun,36495,34831,1664,4.6,"Mendocino County, CA"
126,2023,Jul,36696,35092,1604,4.4,"Mendocino County, CA"
127,2023,Aug,36658,34960,1698,4.6,"Mendocino County, CA"
128,2023,Sep,37003,35392,1611,4.4,"Mendocino County, CA"
129,2023,Oct,36600,34944,1656,4.5,"Mendocino County, CA"
0,2013,Jan,65962,59608,6354,9.6,"Charlotte County, FL"
1,2013,Feb,65671,59980,5691,8.7,"Charlotte County, FL"
2,2013,Mar,65891,60477,5414,8.2,"Charlotte County, FL"
3,2013,Apr,66070,60733,5337,8.1,"Charlotte County, FL"
4,2013,May,66644,61171,5473,8.2,"Charlotte County, FL"
5,2013,Jun,66357,60610,5747,8.7,"Charlotte County, FL"
6,2013,Jul,66042,60334,5708,8.6,"Charlotte County, FL"
7,2013,Aug,65908,60256,5652,8.6,"Charlotte County, FL"
8,2013,Sep,66252,60666,5586,8.4,"Charlotte County, FL"
9,2013,Oct,65763,60315,5448,8.3,"Charlotte County, FL"
10,2013,Nov,66048,60922,5126,7.8,"Charlotte County, FL"
11,2013,Dec,66050,61256,4794,7.3,"Charlotte County, FL"
12,2014,Jan,66513,61370,5143,7.7,"Charlotte County, FL"
13,2014,Feb,67121,62212,4909,7.3,"Charlotte County, FL"
14,2014,Mar,67423,62595,4828,7.2,"Charlotte County, FL"
15,2014,Apr,66972,62594,4378,6.5,"Charlotte County, FL"
16,2014,May,66955,62318,4637,6.9,"Charlotte County, FL"
17,2014,Jun,66424,61715,4709,7.1,"Charlotte County, FL"
18,2014,Jul,66125,61096,5029,7.6,"Charlotte County, FL"
19,2014,Aug,66212,61252,4960,7.5,"Charlotte County, FL"
20,2014,Sep,66248,61496,4752,7.2,"Charlotte County, FL"
21,2014,Oct,66959,62343,4616,6.9,"Charlotte County, FL"
22,2014,Nov,67240,62745,4495,6.7,"Charlotte County, FL"
23,2014,Dec,67329,63161,4168,6.2,"Charlotte County, FL"
24,2015,Jan,67908,63328,4580,6.7,"Charlotte County, FL"
25,2015,Feb,67591,63373,4218,6.2,"Charlotte County, FL"
26,2015,Mar,67636,63576,4060,6.0,"Charlotte County, FL"
27,2015,Apr,67854,63891,3963,5.8,"Charlotte County, FL"
28,2015,May,68211,64064,4147,6.1,"Charlotte County, FL"
29,2015,Jun,67643,63509,4134,6.1,"Charlotte County, FL"
30,2015,Jul,67436,63111,4325,6.4,"Charlotte County, FL"
31,2015,Aug,67690,63447,4243,6.3,"Charlotte County, FL"
32,2015,Sep,67688,63600,4088,6.0,"Charlotte County, FL"
33,2015,Oct,68290,64220,4070,6.0,"Charlotte County, FL"
34,2015,Nov,68312,64422,3890,5.7,"Charlotte County, FL"
35,2015,Dec,68875,65178,3697,5.4,"Charlotte County, FL"
36,2016,Jan,69060,65080,3980,5.8,"Charlotte County, FL"
37,2016,Feb,69258,65549,3709,5.4,"Charlotte County, FL"
38,2016,Mar,69707,66032,3675,5.3,"Charlotte County, FL"
39,2016,Apr,69088,65554,3534,5.1,"Charlotte County, FL"
40,2016,May,69166,65675,3491,5.0,"Charlotte County, FL"
41,2016,Jun,69087,65315,3772,5.5,"Charlotte County, FL"
42,2016,Jul,69454,65507,3947,5.7,"Charlotte County, FL"
43,2016,Aug,69622,65699,3923,5.6,"Charlotte County, FL"
44,2016,Sep,69893,65950,3943,5.6,"Charlotte County, FL"
45,2016,Oct,70082,66288,3794,5.4,"Charlotte County, FL"
46,2016,Nov,69779,66153,3626,5.2,"Charlotte County, FL"
47,2016,Dec,70025,66565,3460,4.9,"Charlotte County, FL"
48,2017,Jan,69646,65824,3822,5.5,"Charlotte County, FL"
49,2017,Feb,69966,66412,3554,5.1,"Charlotte County, FL"
50,2017,Mar,70384,67078,3306,4.7,"Charlotte County, FL"
51,2017,Apr,69857,66758,3099,4.4,"Charlotte County, FL"
52,2017,May,69581,66316,3265,4.7,"Charlotte County, FL"
53,2017,Jun,69600,66184,3416,4.9,"Charlotte County, FL"
54,2017,Jul,69112,65597,3515,5.1,"Charlotte County, FL"
55,2017,Aug,69112,65514,3598,5.2,"Charlotte County, FL"
56,2017,Sep,68399,65048,3351,4.9,"Charlotte County, FL"
57,2017,Oct,69133,65955,3178,4.6,"Charlotte County, FL"
58,2017,Nov,69344,66244,3100,4.5,"Charlotte County, FL"
59,2017,Dec,69686,66747,2939,4.2,"Charlotte County, FL"
60,2018,Jan,70184,67009,3175,4.5,"Charlotte County, FL"
61,2018,Feb,70539,67621,2918,4.1,"Charlotte County, FL"
62,2018,Mar,71009,68196,2813,4.0,"Charlotte County, FL"
63,2018,Apr,70143,67479,2664,3.8,"Charlotte County, FL"
64,2018,May,70280,67587,2693,3.8,"Charlotte County, FL"
65,2018,Jun,70477,67319,3158,4.5,"Charlotte County, FL"
66,2018,Jul,69661,66576,3085,4.4,"Charlotte County, FL"
67,2018,Aug,69575,66466,3109,4.5,"Charlotte County, FL"
68,2018,Sep,70097,67221,2876,4.1,"Charlotte County, FL"
69,2018,Oct,70591,67754,2837,4.0,"Charlotte County, FL"
70,2018,Nov,70625,67862,2763,3.9,"Charlotte County, FL"
71,2018,Dec,70906,68189,2717,3.8,"Charlotte County, FL"
72,2019,Jan,71299,68165,3134,4.4,"Charlotte County, FL"
73,2019,Feb,71636,68873,2763,3.9,"Charlotte County, FL"
74,2019,Mar,71587,68880,2707,3.8,"Charlotte County, FL"
75,2019,Apr,71048,68612,2436,3.4,"Charlotte County, FL"
76,2019,May,71278,68718,2560,3.6,"Charlotte County, FL"
77,2019,Jun,71311,68439,2872,4.0,"Charlotte County, FL"
78,2019,Jul,70988,68113,2875,4.0,"Charlotte County, FL"
79,2019,Aug,71214,68241,2973,4.2,"Charlotte County, FL"
80,2019,Sep,71533,68845,2688,3.8,"Charlotte County, FL"
81,2019,Oct,71706,69147,2559,3.6,"Charlotte County, FL"
82,2019,Nov,71936,69395,2541,3.5,"Charlotte County, FL"
83,2019,Dec,72413,70107,2306,3.2,"Charlotte County, FL"
84,2020,Jan,72766,70059,2707,3.7,"Charlotte County, FL"
85,2020,Feb,73112,70737,2375,3.2,"Charlotte County, FL"
86,2020,Mar,71970,68614,3356,4.7,"Charlotte County, FL"
87,2020,Apr,65870,56721,9149,13.9,"Charlotte County, FL"
88,2020,May,70899,61707,9192,13.0,"Charlotte County, FL"
89,2020,Jun,71195,63678,7517,10.6,"Charlotte County, FL"
90,2020,Jul,71742,63794,7948,11.1,"Charlotte County, FL"
91,2020,Aug,71302,65660,5642,7.9,"Charlotte County, FL"
92,2020,Sep,71778,66446,5332,7.4,"Charlotte County, FL"
93,2020,Oct,72456,67986,4470,6.2,"Charlotte County, FL"
94,2020,Nov,71994,67883,4111,5.7,"Charlotte County, FL"
95,2020,Dec,72572,68593,3979,5.5,"Charlotte County, FL"
96,2021,Jan,72041,68243,3798,5.3,"Charlotte County, FL"
97,2021,Feb,72657,69166,3491,4.8,"Charlotte County, FL"
98,2021,Mar,72972,69470,3502,4.8,"Charlotte County, FL"
99,2021,Apr,72462,69306,3156,4.4,"Charlotte County, FL"
100,2021,May,72762,69683,3079,4.2,"Charlotte County, FL"
101,2021,Jun,73178,69471,3707,5.1,"Charlotte County, FL"
102,2021,Jul,73587,70047,3540,4.8,"Charlotte County, FL"
103,2021,Aug,73742,70221,3521,4.8,"Charlotte County, FL"
104,2021,Sep,73875,70738,3137,4.2,"Charlotte County, FL"
105,2021,Oct,74540,71587,2953,4.0,"Charlotte County, FL"
106,2021,Nov,74679,71790,2889,3.9,"Charlotte County, FL"
107,2021,Dec,75172,72635,2537,3.4,"Charlotte County, FL"
108,2022,Jan,75676,72531,3145,4.2,"Charlotte County, FL"
109,2022,Feb,76107,73355,2752,3.6,"Charlotte County, FL"
110,2022,Mar,76200,73691,2509,3.3,"Charlotte County, FL"
111,2022,Apr,76320,74158,2162,2.8,"Charlotte County, FL"
112,2022,May,76763,74480,2283,3.0,"Charlotte County, FL"
113,2022,Jun,76501,73850,2651,3.5,"Charlotte County, FL"
114,2022,Jul,76616,74137,2479,3.2,"Charlotte County, FL"
115,2022,Aug,76845,74245,2600,3.4,"Charlotte County, FL"
116,2022,Sep,77213,74786,2427,3.1,"Charlotte County, FL"
117,2022,Oct,78046,74739,3307,4.2,"Charlotte County, FL"
118,2022,Nov,77289,74472,2817,3.6,"Charlotte County, FL"
119,2022,Dec,77705,75257,2448,3.2,"Charlotte County, FL"
120,2023,Jan,77869,75323,2546,3.3,"Charlotte County, FL"
121,2023,Feb,78423,75965,2458,3.1,"Charlotte County, FL"
122,2023,Mar,78954,76475,2479,3.1,"Charlotte County, FL"
123,2023,Apr,78522,76447,2075,2.6,"Charlotte County, FL"
124,2023,May,78523,76134,2389,3.0,"Charlotte County, FL"
125,2023,Jun,78836,76154,2682,3.4,"Charlotte County, FL"
126,2023,Jul,79191,76372,2819,3.6,"Charlotte County, FL"
127,2023,Aug,79673,76662,3011,3.8,"Charlotte County, FL"
128,2023,Sep,79889,76819,3070,3.8,"Charlotte County, FL"
129,2023,Oct,79904,77012,2892,3.6,"Charlotte County, FL"
0,2013,Jan,10875,10058,817,7.5,"Bradford County, FL"
1,2013,Feb,10782,10020,762,7.1,"Bradford County, FL"
2,2013,Mar,10755,10038,717,6.7,"Bradford County, FL"
3,2013,Apr,10868,10177,691,6.4,"Bradford County, FL"
4,2013,May,10980,10269,711,6.5,"Bradford County, FL"
5,2013,Jun,10977,10224,753,6.9,"Bradford County, FL"
6,2013,Jul,11058,10313,745,6.7,"Bradford County, FL"
7,2013,Aug,11067,10343,724,6.5,"Bradford County, FL"
8,2013,Sep,11128,10431,697,6.3,"Bradford County, FL"
9,2013,Oct,11061,10369,692,6.3,"Bradford County, FL"
10,2013,Nov,10971,10295,676,6.2,"Bradford County, FL"
11,2013,Dec,10884,10245,639,5.9,"Bradford County, FL"
12,2014,Jan,10722,10046,676,6.3,"Bradford County, FL"
13,2014,Feb,10734,10079,655,6.1,"Bradford County, FL"
14,2014,Mar,10756,10107,649,6.0,"Bradford County, FL"
15,2014,Apr,10736,10151,585,5.4,"Bradford County, FL"
16,2014,May,10827,10188,639,5.9,"Bradford County, FL"
17,2014,Jun,10719,10073,646,6.0,"Bradford County, FL"
18,2014,Jul,10689,10024,665,6.2,"Bradford County, FL"
19,2014,Aug,10724,10065,659,6.1,"Bradford County, FL"
20,2014,Sep,10842,10226,616,5.7,"Bradford County, FL"
21,2014,Oct,10794,10219,575,5.3,"Bradford County, FL"
22,2014,Nov,10643,10071,572,5.4,"Bradford County, FL"
23,2014,Dec,10618,10075,543,5.1,"Bradford County, FL"
24,2015,Jan,10640,10048,592,5.6,"Bradford County, FL"
25,2015,Feb,10588,10044,544,5.1,"Bradford County, FL"
26,2015,Mar,10634,10111,523,4.9,"Bradford County, FL"
27,2015,Apr,10696,10191,505,4.7,"Bradford County, FL"
28,2015,May,10852,10322,530,4.9,"Bradford County, FL"
29,2015,Jun,10759,10213,546,5.1,"Bradford County, FL"
30,2015,Jul,10777,10224,553,5.1,"Bradford County, FL"
31,2015,Aug,10880,10346,534,4.9,"Bradford County, FL"
32,2015,Sep,10991,10481,510,4.6,"Bradford County, FL"
33,2015,Oct,10944,10451,493,4.5,"Bradford County, FL"
34,2015,Nov,10852,10348,504,4.6,"Bradford County, FL"
35,2015,Dec,10825,10346,479,4.4,"Bradford County, FL"
36,2016,Jan,10811,10312,499,4.6,"Bradford County, FL"
37,2016,Feb,10831,10372,459,4.2,"Bradford County, FL"
38,2016,Mar,10929,10466,463,4.2,"Bradford County, FL"
39,2016,Apr,10793,10354,439,4.1,"Bradford County, FL"
40,2016,May,10829,10395,434,4.0,"Bradford County, FL"
41,2016,Jun,10789,10292,497,4.6,"Bradford County, FL"
42,2016,Jul,10841,10337,504,4.6,"Bradford County, FL"
43,2016,Aug,10969,10478,491,4.5,"Bradford County, FL"
44,2016,Sep,11120,10633,487,4.4,"Bradford County, FL"
45,2016,Oct,11047,10583,464,4.2,"Bradford County, FL"
46,2016,Nov,10926,10474,452,4.1,"Bradford County, FL"
47,2016,Dec,10863,10428,435,4.0,"Bradford County, FL"
48,2017,Jan,11072,10590,482,4.4,"Bradford County, FL"
49,2017,Feb,11186,10752,434,3.9,"Bradford County, FL"
50,2017,Mar,11201,10794,407,3.6,"Bradford County, FL"
51,2017,Apr,11202,10827,375,3.3,"Bradford County, FL"
52,2017,May,11161,10772,389,3.5,"Bradford County, FL"
53,2017,Jun,10892,10467,425,3.9,"Bradford County, FL"
54,2017,Jul,11009,10557,452,4.1,"Bradford County, FL"
55,2017,Aug,11152,10711,441,4.0,"Bradford County, FL"
56,2017,Sep,11265,10872,393,3.5,"Bradford County, FL"
57,2017,Oct,11319,10938,381,3.4,"Bradford County, FL"
58,2017,Nov,11298,10898,400,3.5,"Bradford County, FL"
59,2017,Dec,11208,10823,385,3.4,"Bradford County, FL"
60,2018,Jan,11229,10784,445,4.0,"Bradford County, FL"
61,2018,Feb,11272,10870,402,3.6,"Bradford County, FL"
62,2018,Mar,11221,10836,385,3.4,"Bradford County, FL"
63,2018,Apr,11193,10833,360,3.2,"Bradford County, FL"
64,2018,May,11208,10858,350,3.1,"Bradford County, FL"
65,2018,Jun,10984,10569,415,3.8,"Bradford County, FL"
66,2018,Jul,11050,10645,405,3.7,"Bradford County, FL"
67,2018,Aug,11107,10706,401,3.6,"Bradford County, FL"
68,2018,Sep,11141,10774,367,3.3,"Bradford County, FL"
69,2018,Oct,10973,10618,355,3.2,"Bradford County, FL"
70,2018,Nov,10774,10426,348,3.2,"Bradford County, FL"
71,2018,Dec,10723,10369,354,3.3,"Bradford County, FL"
72,2019,Jan,10789,10371,418,3.9,"Bradford County, FL"
73,2019,Feb,10794,10440,354,3.3,"Bradford County, FL"
74,2019,Mar,10805,10449,356,3.3,"Bradford County, FL"
75,2019,Apr,10821,10506,315,2.9,"Bradford County, FL"
76,2019,May,10881,10548,333,3.1,"Bradford County, FL"
77,2019,Jun,10820,10434,386,3.6,"Bradford County, FL"
78,2019,Jul,10855,10458,397,3.7,"Bradford County, FL"
79,2019,Aug,10997,10592,405,3.7,"Bradford County, FL"
80,2019,Sep,11137,10777,360,3.2,"Bradford County, FL"
81,2019,Oct,10993,10646,347,3.2,"Bradford County, FL"
82,2019,Nov,10874,10542,332,3.1,"Bradford County, FL"
83,2019,Dec,10797,10489,308,2.9,"Bradford County, FL"
84,2020,Jan,10797,10427,370,3.4,"Bradford County, FL"
85,2020,Feb,10906,10532,374,3.4,"Bradford County, FL"
86,2020,Mar,10825,10264,561,5.2,"Bradford County, FL"
87,2020,Apr,9913,9095,818,8.3,"Bradford County, FL"
88,2020,May,10564,9620,944,8.9,"Bradford County, FL"
89,2020,Jun,10578,9673,905,8.6,"Bradford County, FL"
90,2020,Jul,10790,9808,982,9.1,"Bradford County, FL"
91,2020,Aug,10901,10182,719,6.6,"Bradford County, FL"
92,2020,Sep,11055,10355,700,6.3,"Bradford County, FL"
93,2020,Oct,10918,10304,614,5.6,"Bradford County, FL"
94,2020,Nov,10831,10250,581,5.4,"Bradford County, FL"
95,2020,Dec,10673,10124,549,5.1,"Bradford County, FL"
96,2021,Jan,10663,10107,556,5.2,"Bradford County, FL"
97,2021,Feb,10697,10186,511,4.8,"Bradford County, FL"
98,2021,Mar,10679,10209,470,4.4,"Bradford County, FL"
99,2021,Apr,10704,10262,442,4.1,"Bradford County, FL"
100,2021,May,10772,10343,429,4.0,"Bradford County, FL"
101,2021,Jun,10759,10252,507,4.7,"Bradford County, FL"
102,2021,Jul,10778,10290,488,4.5,"Bradford County, FL"
103,2021,Aug,10856,10382,474,4.4,"Bradford County, FL"
104,2021,Sep,10989,10558,431,3.9,"Bradford County, FL"
105,2021,Oct,10922,10506,416,3.8,"Bradford County, FL"
106,2021,Nov,10880,10461,419,3.9,"Bradford County, FL"
107,2021,Dec,10798,10439,359,3.3,"Bradford County, FL"
108,2022,Jan,11012,10574,438,4.0,"Bradford County, FL"
109,2022,Feb,10967,10579,388,3.5,"Bradford County, FL"
110,2022,Mar,11008,10658,350,3.2,"Bradford County, FL"
111,2022,Apr,10937,10615,322,2.9,"Bradford County, FL"
112,2022,May,10980,10661,319,2.9,"Bradford County, FL"
113,2022,Jun,10982,10608,374,3.4,"Bradford County, FL"
114,2022,Jul,11080,10713,367,3.3,"Bradford County, FL"
115,2022,Aug,11203,10825,378,3.4,"Bradford County, FL"
116,2022,Sep,11340,11008,332,2.9,"Bradford County, FL"
117,2022,Oct,11228,10900,328,2.9,"Bradford County, FL"
118,2022,Nov,11095,10788,307,2.8,"Bradford County, FL"
119,2022,Dec,11070,10806,264,2.4,"Bradford County, FL"
120,2023,Jan,11097,10813,284,2.6,"Bradford County, FL"
121,2023,Feb,11193,10899,294,2.6,"Bradford County, FL"
122,2023,Mar,11242,10949,293,2.6,"Bradford County, FL"
123,2023,Apr,11243,10983,260,2.3,"Bradford County, FL"
124,2023,May,11273,10968,305,2.7,"Bradford County, FL"
125,2023,Jun,11310,10954,356,3.1,"Bradford County, FL"
126,2023,Jul,11353,10994,359,3.2,"Bradford County, FL"
127,2023,Aug,11483,11111,372,3.2,"Bradford County, FL"
128,2023,Sep,11598,11223,375,3.2,"Bradford County, FL"
129,2023,Oct,11551,11164,387,3.4,"Bradford County, FL"
0,2013,Jan,2824,2600,224,7.9,"Liberty County, FL"
1,2013,Feb,2817,2616,201,7.1,"Liberty County, FL"
2,2013,Mar,2803,2613,190,6.8,"Liberty County, FL"
3,2013,Apr,2807,2626,181,6.4,"Liberty County, FL"
4,2013,May,2844,2642,202,7.1,"Liberty County, FL"
5,2013,Jun,2840,2627,213,7.5,"Liberty County, FL"
6,2013,Jul,2858,2647,211,7.4,"Liberty County, FL"
7,2013,Aug,2837,2636,201,7.1,"Liberty County, FL"
8,2013,Sep,2926,2725,201,6.9,"Liberty County, FL"
9,2013,Oct,2883,2691,192,6.7,"Liberty County, FL"
10,2013,Nov,2834,2642,192,6.8,"Liberty County, FL"
11,2013,Dec,2782,2594,188,6.8,"Liberty County, FL"
12,2014,Jan,2773,2570,203,7.3,"Liberty County, FL"
13,2014,Feb,2791,2589,202,7.2,"Liberty County, FL"
14,2014,Mar,2788,2607,181,6.5,"Liberty County, FL"
15,2014,Apr,2728,2557,171,6.3,"Liberty County, FL"
16,2014,May,2768,2572,196,7.1,"Liberty County, FL"
17,2014,Jun,2721,2519,202,7.4,"Liberty County, FL"
18,2014,Jul,2742,2531,211,7.7,"Liberty County, FL"
19,2014,Aug,2733,2535,198,7.2,"Liberty County, FL"
20,2014,Sep,2777,2592,185,6.7,"Liberty County, FL"
21,2014,Oct,2766,2588,178,6.4,"Liberty County, FL"
22,2014,Nov,2706,2534,172,6.4,"Liberty County, FL"
23,2014,Dec,2678,2521,157,5.9,"Liberty County, FL"
24,2015,Jan,2695,2517,178,6.6,"Liberty County, FL"
25,2015,Feb,2680,2522,158,5.9,"Liberty County, FL"
26,2015,Mar,2673,2512,161,6.0,"Liberty County, FL"
27,2015,Apr,2652,2495,157,5.9,"Liberty County, FL"
28,2015,May,2672,2512,160,6.0,"Liberty County, FL"
29,2015,Jun,2637,2465,172,6.5,"Liberty County, FL"
30,2015,Jul,2587,2425,162,6.3,"Liberty County, FL"
31,2015,Aug,2594,2436,158,6.1,"Liberty County, FL"
32,2015,Sep,2663,2513,150,5.6,"Liberty County, FL"
33,2015,Oct,2677,2531,146,5.5,"Liberty County, FL"
34,2015,Nov,2638,2493,145,5.5,"Liberty County, FL"
35,2015,Dec,2615,2475,140,5.4,"Liberty County, FL"
36,2016,Jan,2642,2494,148,5.6,"Liberty County, FL"
37,2016,Feb,2639,2505,134,5.1,"Liberty County, FL"
38,2016,Mar,2635,2497,138,5.2,"Liberty County, FL"
39,2016,Apr,2640,2509,131,5.0,"Liberty County, FL"
40,2016,May,2649,2521,128,4.8,"Liberty County, FL"
41,2016,Jun,2603,2460,143,5.5,"Liberty County, FL"
42,2016,Jul,2638,2494,144,5.5,"Liberty County, FL"
43,2016,Aug,2649,2506,143,5.4,"Liberty County, FL"
44,2016,Sep,2726,2580,146,5.4,"Liberty County, FL"
45,2016,Oct,2676,2541,135,5.0,"Liberty County, FL"
46,2016,Nov,2649,2521,128,4.8,"Liberty County, FL"
47,2016,Dec,2608,2483,125,4.8,"Liberty County, FL"
48,2017,Jan,2596,2456,140,5.4,"Liberty County, FL"
49,2017,Feb,2621,2489,132,5.0,"Liberty County, FL"
50,2017,Mar,2607,2480,127,4.9,"Liberty County, FL"
51,2017,Apr,2596,2475,121,4.7,"Liberty County, FL"
52,2017,May,2624,2511,113,4.3,"Liberty County, FL"
53,2017,Jun,2609,2486,123,4.7,"Liberty County, FL"
54,2017,Jul,2525,2399,126,5.0,"Liberty County, FL"
55,2017,Aug,2554,2427,127,5.0,"Liberty County, FL"
56,2017,Sep,2672,2559,113,4.2,"Liberty County, FL"
57,2017,Oct,2628,2521,107,4.1,"Liberty County, FL"
58,2017,Nov,2601,2492,109,4.2,"Liberty County, FL"
59,2017,Dec,2571,2465,106,4.1,"Liberty County, FL"
60,2018,Jan,2597,2473,124,4.8,"Liberty County, FL"
61,2018,Feb,2605,2488,117,4.5,"Liberty County, FL"
62,2018,Mar,2595,2485,110,4.2,"Liberty County, FL"
63,2018,Apr,2612,2508,104,4.0,"Liberty County, FL"
64,2018,May,2614,2519,95,3.6,"Liberty County, FL"
65,2018,Jun,2612,2502,110,4.2,"Liberty County, FL"
66,2018,Jul,2563,2461,102,4.0,"Liberty County, FL"
67,2018,Aug,2577,2479,98,3.8,"Liberty County, FL"
68,2018,Sep,2649,2559,90,3.4,"Liberty County, FL"
69,2018,Oct,2570,2474,96,3.7,"Liberty County, FL"
70,2018,Nov,2578,2473,105,4.1,"Liberty County, FL"
71,2018,Dec,2587,2491,96,3.7,"Liberty County, FL"
72,2019,Jan,2600,2484,116,4.5,"Liberty County, FL"
73,2019,Feb,2615,2513,102,3.9,"Liberty County, FL"
74,2019,Mar,2610,2511,99,3.8,"Liberty County, FL"
75,2019,Apr,2629,2542,87,3.3,"Liberty County, FL"
76,2019,May,2641,2549,92,3.5,"Liberty County, FL"
77,2019,Jun,2656,2551,105,4.0,"Liberty County, FL"
78,2019,Jul,2598,2497,101,3.9,"Liberty County, FL"
79,2019,Aug,2626,2536,90,3.4,"Liberty County, FL"
80,2019,Sep,2690,2610,80,3.0,"Liberty County, FL"
81,2019,Oct,2681,2591,90,3.4,"Liberty County, FL"
82,2019,Nov,2655,2568,87,3.3,"Liberty County, FL"
83,2019,Dec,2642,2562,80,3.0,"Liberty County, FL"
84,2020,Jan,2663,2575,88,3.3,"Liberty County, FL"
85,2020,Feb,2668,2589,79,3.0,"Liberty County, FL"
86,2020,Mar,2642,2528,114,4.3,"Liberty County, FL"
87,2020,Apr,2449,2310,139,5.7,"Liberty County, FL"
88,2020,May,2537,2395,142,5.6,"Liberty County, FL"
89,2020,Jun,2573,2416,157,6.1,"Liberty County, FL"
90,2020,Jul,2552,2356,196,7.7,"Liberty County, FL"
91,2020,Aug,2537,2392,145,5.7,"Liberty County, FL"
92,2020,Sep,2654,2507,147,5.5,"Liberty County, FL"
93,2020,Oct,2657,2530,127,4.8,"Liberty County, FL"
94,2020,Nov,2627,2509,118,4.5,"Liberty County, FL"
95,2020,Dec,2592,2476,116,4.5,"Liberty County, FL"
96,2021,Jan,2604,2473,131,5.0,"Liberty County, FL"
97,2021,Feb,2606,2484,122,4.7,"Liberty County, FL"
98,2021,Mar,2605,2499,106,4.1,"Liberty County, FL"
99,2021,Apr,2616,2509,107,4.1,"Liberty County, FL"
100,2021,May,2604,2510,94,3.6,"Liberty County, FL"
101,2021,Jun,2594,2475,119,4.6,"Liberty County, FL"
102,2021,Jul,2574,2459,115,4.5,"Liberty County, FL"
103,2021,Aug,2595,2469,126,4.9,"Liberty County, FL"
104,2021,Sep,2628,2507,121,4.6,"Liberty County, FL"
105,2021,Oct,2613,2509,104,4.0,"Liberty County, FL"
106,2021,Nov,2603,2497,106,4.1,"Liberty County, FL"
107,2021,Dec,2602,2508,94,3.6,"Liberty County, FL"
108,2022,Jan,2620,2503,117,4.5,"Liberty County, FL"
109,2022,Feb,2613,2514,99,3.8,"Liberty County, FL"
110,2022,Mar,2605,2520,85,3.3,"Liberty County, FL"
111,2022,Apr,2614,2539,75,2.9,"Liberty County, FL"
112,2022,May,2640,2560,80,3.0,"Liberty County, FL"
113,2022,Jun,2612,2526,86,3.3,"Liberty County, FL"
114,2022,Jul,2600,2519,81,3.1,"Liberty County, FL"
115,2022,Aug,2638,2552,86,3.3,"Liberty County, FL"
116,2022,Sep,2678,2597,81,3.0,"Liberty County, FL"
117,2022,Oct,2672,2594,78,2.9,"Liberty County, FL"
118,2022,Nov,2636,2566,70,2.7,"Liberty County, FL"
119,2022,Dec,2634,2572,62,2.4,"Liberty County, FL"
120,2023,Jan,2650,2577,73,2.8,"Liberty County, FL"
121,2023,Feb,2677,2604,73,2.7,"Liberty County, FL"
122,2023,Mar,2699,2626,73,2.7,"Liberty County, FL"
123,2023,Apr,2704,2637,67,2.5,"Liberty County, FL"
124,2023,May,2711,2637,74,2.7,"Liberty County, FL"
125,2023,Jun,2730,2641,89,3.3,"Liberty County, FL"
126,2023,Jul,2707,2609,98,3.6,"Liberty County, FL"
127,2023,Aug,2729,2636,93,3.4,"Liberty County, FL"
128,2023,Sep,2772,2679,93,3.4,"Liberty County, FL"
129,2023,Oct,2771,2676,95,3.4,"Liberty County, FL"
0,2013,Jan,136454,125535,10919,8.0,"San Luis Obispo County, CA"
1,2013,Feb,137796,127610,10186,7.4,"San Luis Obispo County, CA"
2,2013,Mar,138199,128351,9848,7.1,"San Luis Obispo County, CA"
3,2013,Apr,137862,128800,9062,6.6,"San Luis Obispo County, CA"
4,2013,May,138320,129375,8945,6.5,"San Luis Obispo County, CA"
5,2013,Jun,140260,130096,10164,7.2,"San Luis Obispo County, CA"
6,2013,Jul,138443,128174,10269,7.4,"San Luis Obispo County, CA"
7,2013,Aug,136177,126510,9667,7.1,"San Luis Obispo County, CA"
8,2013,Sep,136886,127767,9119,6.7,"San Luis Obispo County, CA"
9,2013,Oct,138111,128971,9140,6.6,"San Luis Obispo County, CA"
10,2013,Nov,138739,129987,8752,6.3,"San Luis Obispo County, CA"
11,2013,Dec,135470,127291,8179,6.0,"San Luis Obispo County, CA"
12,2014,Jan,138048,129441,8607,6.2,"San Luis Obispo County, CA"
13,2014,Feb,139788,131168,8620,6.2,"San Luis Obispo County, CA"
14,2014,Mar,140321,131724,8597,6.1,"San Luis Obispo County, CA"
15,2014,Apr,138853,131626,7227,5.2,"San Luis Obispo County, CA"
16,2014,May,140692,133409,7283,5.2,"San Luis Obispo County, CA"
17,2014,Jun,141899,133931,7968,5.6,"San Luis Obispo County, CA"
18,2014,Jul,140291,131610,8681,6.2,"San Luis Obispo County, CA"
19,2014,Aug,137522,129207,8315,6.0,"San Luis Obispo County, CA"
20,2014,Sep,139582,132024,7558,5.4,"San Luis Obispo County, CA"
21,2014,Oct,142121,134631,7490,5.3,"San Luis Obispo County, CA"
22,2014,Nov,141820,134307,7513,5.3,"San Luis Obispo County, CA"
23,2014,Dec,138098,131165,6933,5.0,"San Luis Obispo County, CA"
24,2015,Jan,140505,132834,7671,5.5,"San Luis Obispo County, CA"
25,2015,Feb,139367,132131,7236,5.2,"San Luis Obispo County, CA"
26,2015,Mar,139733,132729,7004,5.0,"San Luis Obispo County, CA"
27,2015,Apr,139457,133118,6339,4.5,"San Luis Obispo County, CA"
28,2015,May,140252,133995,6257,4.5,"San Luis Obispo County, CA"
29,2015,Jun,140965,134210,6755,4.8,"San Luis Obispo County, CA"
30,2015,Jul,138375,131374,7001,5.1,"San Luis Obispo County, CA"
31,2015,Aug,136063,129461,6602,4.9,"San Luis Obispo County, CA"
32,2015,Sep,137243,131237,6006,4.4,"San Luis Obispo County, CA"
33,2015,Oct,139082,132941,6141,4.4,"San Luis Obispo County, CA"
34,2015,Nov,139328,133097,6231,4.5,"San Luis Obispo County, CA"
35,2015,Dec,136583,130499,6084,4.5,"San Luis Obispo County, CA"
36,2016,Jan,138256,131767,6489,4.7,"San Luis Obispo County, CA"
37,2016,Feb,140114,133682,6432,4.6,"San Luis Obispo County, CA"
38,2016,Mar,141079,134602,6477,4.6,"San Luis Obispo County, CA"
39,2016,Apr,139933,134165,5768,4.1,"San Luis Obispo County, CA"
40,2016,May,140609,135402,5207,3.7,"San Luis Obispo County, CA"
41,2016,Jun,141415,134979,6436,4.6,"San Luis Obispo County, CA"
42,2016,Jul,138832,132306,6526,4.7,"San Luis Obispo County, CA"
43,2016,Aug,136836,130486,6350,4.6,"San Luis Obispo County, CA"
44,2016,Sep,138907,132969,5938,4.3,"San Luis Obispo County, CA"
45,2016,Oct,140617,134757,5860,4.2,"San Luis Obispo County, CA"
46,2016,Nov,140259,134728,5531,3.9,"San Luis Obispo County, CA"
47,2016,Dec,136947,131412,5535,4.0,"San Luis Obispo County, CA"
48,2017,Jan,137978,131803,6175,4.5,"San Luis Obispo County, CA"
49,2017,Feb,141247,135427,5820,4.1,"San Luis Obispo County, CA"
50,2017,Mar,141833,136401,5432,3.8,"San Luis Obispo County, CA"
51,2017,Apr,141160,136383,4777,3.4,"San Luis Obispo County, CA"
52,2017,May,141126,136675,4451,3.2,"San Luis Obispo County, CA"
53,2017,Jun,142587,137311,5276,3.7,"San Luis Obispo County, CA"
54,2017,Jul,141133,135470,5663,4.0,"San Luis Obispo County, CA"
55,2017,Aug,137417,131948,5469,4.0,"San Luis Obispo County, CA"
56,2017,Sep,140596,135893,4703,3.3,"San Luis Obispo County, CA"
57,2017,Oct,140838,136334,4504,3.2,"San Luis Obispo County, CA"
58,2017,Nov,140067,135652,4415,3.2,"San Luis Obispo County, CA"
59,2017,Dec,137023,132756,4267,3.1,"San Luis Obispo County, CA"
60,2018,Jan,138652,133821,4831,3.5,"San Luis Obispo County, CA"
61,2018,Feb,141388,136810,4578,3.2,"San Luis Obispo County, CA"
62,2018,Mar,140878,136552,4326,3.1,"San Luis Obispo County, CA"
63,2018,Apr,140499,136579,3920,2.8,"San Luis Obispo County, CA"
64,2018,May,141433,137859,3574,2.5,"San Luis Obispo County, CA"
65,2018,Jun,141164,136633,4531,3.2,"San Luis Obispo County, CA"
66,2018,Jul,139938,135449,4489,3.2,"San Luis Obispo County, CA"
67,2018,Aug,136794,132482,4312,3.2,"San Luis Obispo County, CA"
68,2018,Sep,139137,135183,3954,2.8,"San Luis Obispo County, CA"
69,2018,Oct,141369,137357,4012,2.8,"San Luis Obispo County, CA"
70,2018,Nov,141280,137320,3960,2.8,"San Luis Obispo County, CA"
71,2018,Dec,138761,134658,4103,3.0,"San Luis Obispo County, CA"
72,2019,Jan,139664,134630,5034,3.6,"San Luis Obispo County, CA"
73,2019,Feb,140322,135873,4449,3.2,"San Luis Obispo County, CA"
74,2019,Mar,141227,136805,4422,3.1,"San Luis Obispo County, CA"
75,2019,Apr,140438,136793,3645,2.6,"San Luis Obispo County, CA"
76,2019,May,141155,137706,3449,2.4,"San Luis Obispo County, CA"
77,2019,Jun,141007,136782,4225,3.0,"San Luis Obispo County, CA"
78,2019,Jul,139550,135074,4476,3.2,"San Luis Obispo County, CA"
79,2019,Aug,138518,134336,4182,3.0,"San Luis Obispo County, CA"
80,2019,Sep,139010,135430,3580,2.6,"San Luis Obispo County, CA"
81,2019,Oct,139978,136289,3689,2.6,"San Luis Obispo County, CA"
82,2019,Nov,140477,136716,3761,2.7,"San Luis Obispo County, CA"
83,2019,Dec,137514,133817,3697,2.7,"San Luis Obispo County, CA"
84,2020,Jan,139590,135106,4484,3.2,"San Luis Obispo County, CA"
85,2020,Feb,141705,137459,4246,3.0,"San Luis Obispo County, CA"
86,2020,Mar,139536,133425,6111,4.4,"San Luis Obispo County, CA"
87,2020,Apr,131094,111387,19707,15.0,"San Luis Obispo County, CA"
88,2020,May,128155,111049,17106,13.3,"San Luis Obispo County, CA"
89,2020,Jun,134300,119698,14602,10.9,"San Luis Obispo County, CA"
90,2020,Jul,134170,120921,13249,9.9,"San Luis Obispo County, CA"
91,2020,Aug,131682,121004,10678,8.1,"San Luis Obispo County, CA"
92,2020,Sep,133305,123424,9881,7.4,"San Luis Obispo County, CA"
93,2020,Oct,134190,125671,8519,6.3,"San Luis Obispo County, CA"
94,2020,Nov,133379,124970,8409,6.3,"San Luis Obispo County, CA"
95,2020,Dec,131891,122994,8897,6.7,"San Luis Obispo County, CA"
96,2021,Jan,131665,122171,9494,7.2,"San Luis Obispo County, CA"
97,2021,Feb,134787,125852,8935,6.6,"San Luis Obispo County, CA"
98,2021,Mar,136046,127751,8295,6.1,"San Luis Obispo County, CA"
99,2021,Apr,134015,126189,7826,5.8,"San Luis Obispo County, CA"
100,2021,May,134983,127855,7128,5.3,"San Luis Obispo County, CA"
101,2021,Jun,135212,127151,8061,6.0,"San Luis Obispo County, CA"
102,2021,Jul,136707,129015,7692,5.6,"San Luis Obispo County, CA"
103,2021,Aug,135518,128230,7288,5.4,"San Luis Obispo County, CA"
104,2021,Sep,136732,130641,6091,4.5,"San Luis Obispo County, CA"
105,2021,Oct,137816,131975,5841,4.2,"San Luis Obispo County, CA"
106,2021,Nov,136815,131607,5208,3.8,"San Luis Obispo County, CA"
107,2021,Dec,134843,130059,4784,3.5,"San Luis Obispo County, CA"
108,2022,Jan,134879,129392,5487,4.1,"San Luis Obispo County, CA"
109,2022,Feb,136738,131802,4936,3.6,"San Luis Obispo County, CA"
110,2022,Mar,137507,133119,4388,3.2,"San Luis Obispo County, CA"
111,2022,Apr,137029,133279,3750,2.7,"San Luis Obispo County, CA"
112,2022,May,138744,135252,3492,2.5,"San Luis Obispo County, CA"
113,2022,Jun,137830,133594,4236,3.1,"San Luis Obispo County, CA"
114,2022,Jul,137461,133319,4142,3.0,"San Luis Obispo County, CA"
115,2022,Aug,136138,131950,4188,3.1,"San Luis Obispo County, CA"
116,2022,Sep,137122,133446,3676,2.7,"San Luis Obispo County, CA"
117,2022,Oct,137716,133859,3857,2.8,"San Luis Obispo County, CA"
118,2022,Nov,137828,133807,4021,2.9,"San Luis Obispo County, CA"
119,2022,Dec,137450,133760,3690,2.7,"San Luis Obispo County, CA"
120,2023,Jan,137322,132573,4749,3.5,"San Luis Obispo County, CA"
121,2023,Feb,139964,135174,4790,3.4,"San Luis Obispo County, CA"
122,2023,Mar,140729,135968,4761,3.4,"San Luis Obispo County, CA"
123,2023,Apr,139398,135208,4190,3.0,"San Luis Obispo County, CA"
124,2023,May,139797,135573,4224,3.0,"San Luis Obispo County, CA"
125,2023,Jun,139817,134861,4956,3.5,"San Luis Obispo County, CA"
126,2023,Jul,139734,135053,4681,3.3,"San Luis Obispo County, CA"
127,2023,Aug,137268,132147,5121,3.7,"San Luis Obispo County, CA"
128,2023,Sep,139416,134562,4854,3.5,"San Luis Obispo County, CA"
129,2023,Oct,139668,134810,4858,3.5,"San Luis Obispo County, CA"
0,2013,Jan,128012,119423,8589,6.7,"Alachua County, FL"
1,2013,Feb,128250,120408,7842,6.1,"Alachua County, FL"
2,2013,Mar,128540,121119,7421,5.8,"Alachua County, FL"
3,2013,Apr,131282,124212,7070,5.4,"Alachua County, FL"
4,2013,May,129830,122220,7610,5.9,"Alachua County, FL"
5,2013,Jun,127771,119329,8442,6.6,"Alachua County, FL"
6,2013,Jul,128223,119855,8368,6.5,"Alachua County, FL"
7,2013,Aug,127532,119780,7752,6.1,"Alachua County, FL"
8,2013,Sep,131462,123801,7661,5.8,"Alachua County, FL"
9,2013,Oct,130382,123094,7288,5.6,"Alachua County, FL"
10,2013,Nov,129329,122033,7296,5.6,"Alachua County, FL"
11,2013,Dec,127469,120495,6974,5.5,"Alachua County, FL"
12,2014,Jan,128154,120752,7402,5.8,"Alachua County, FL"
13,2014,Feb,128957,121788,7169,5.6,"Alachua County, FL"
14,2014,Mar,129948,122878,7070,5.4,"Alachua County, FL"
15,2014,Apr,129991,123729,6262,4.8,"Alachua County, FL"
16,2014,May,129875,123026,6849,5.3,"Alachua County, FL"
17,2014,Jun,127464,120079,7385,5.8,"Alachua County, FL"
18,2014,Jul,128249,120528,7721,6.0,"Alachua County, FL"
19,2014,Aug,127490,120218,7272,5.7,"Alachua County, FL"
20,2014,Sep,132103,125306,6797,5.1,"Alachua County, FL"
21,2014,Oct,131249,124702,6547,5.0,"Alachua County, FL"
22,2014,Nov,129842,123224,6618,5.1,"Alachua County, FL"
23,2014,Dec,128289,122171,6118,4.8,"Alachua County, FL"
24,2015,Jan,128491,121675,6816,5.3,"Alachua County, FL"
25,2015,Feb,128566,122511,6055,4.7,"Alachua County, FL"
26,2015,Mar,128999,123179,5820,4.5,"Alachua County, FL"
27,2015,Apr,131006,125342,5664,4.3,"Alachua County, FL"
28,2015,May,130102,123902,6200,4.8,"Alachua County, FL"
29,2015,Jun,127983,121439,6544,5.1,"Alachua County, FL"
30,2015,Jul,128871,122451,6420,5.0,"Alachua County, FL"
31,2015,Aug,128076,121904,6172,4.8,"Alachua County, FL"
32,2015,Sep,133327,127373,5954,4.5,"Alachua County, FL"
33,2015,Oct,132566,126849,5717,4.3,"Alachua County, FL"
34,2015,Nov,131441,125674,5767,4.4,"Alachua County, FL"
35,2015,Dec,130486,124992,5494,4.2,"Alachua County, FL"
36,2016,Jan,131135,125177,5958,4.5,"Alachua County, FL"
37,2016,Feb,132534,127156,5378,4.1,"Alachua County, FL"
38,2016,Mar,133137,127712,5425,4.1,"Alachua County, FL"
39,2016,Apr,133620,128331,5289,4.0,"Alachua County, FL"
40,2016,May,131776,126500,5276,4.0,"Alachua County, FL"
41,2016,Jun,130938,124547,6391,4.9,"Alachua County, FL"
42,2016,Jul,132032,125724,6308,4.8,"Alachua County, FL"
43,2016,Aug,131065,124960,6105,4.7,"Alachua County, FL"
44,2016,Sep,136832,130715,6117,4.5,"Alachua County, FL"
45,2016,Oct,136071,130268,5803,4.3,"Alachua County, FL"
46,2016,Nov,134154,128559,5595,4.2,"Alachua County, FL"
47,2016,Dec,133366,127977,5389,4.0,"Alachua County, FL"
48,2017,Jan,134215,128149,6066,4.5,"Alachua County, FL"
49,2017,Feb,134787,129481,5306,3.9,"Alachua County, FL"
50,2017,Mar,134770,129680,5090,3.8,"Alachua County, FL"
51,2017,Apr,135260,130469,4791,3.5,"Alachua County, FL"
52,2017,May,133169,128341,4828,3.6,"Alachua County, FL"
53,2017,Jun,132477,126888,5589,4.2,"Alachua County, FL"
54,2017,Jul,133598,127997,5601,4.2,"Alachua County, FL"
55,2017,Aug,131746,126289,5457,4.1,"Alachua County, FL"
56,2017,Sep,137183,132077,5106,3.7,"Alachua County, FL"
57,2017,Oct,136275,131334,4941,3.6,"Alachua County, FL"
58,2017,Nov,135013,129880,5133,3.8,"Alachua County, FL"
59,2017,Dec,133683,129019,4664,3.5,"Alachua County, FL"
60,2018,Jan,135258,129978,5280,3.9,"Alachua County, FL"
61,2018,Feb,136658,131917,4741,3.5,"Alachua County, FL"
62,2018,Mar,136462,131905,4557,3.3,"Alachua County, FL"
63,2018,Apr,137551,133240,4311,3.1,"Alachua County, FL"
64,2018,May,135073,130926,4147,3.1,"Alachua County, FL"
65,2018,Jun,134513,129399,5114,3.8,"Alachua County, FL"
66,2018,Jul,135589,130729,4860,3.6,"Alachua County, FL"
67,2018,Aug,133984,129352,4632,3.5,"Alachua County, FL"
68,2018,Sep,139443,135126,4317,3.1,"Alachua County, FL"
69,2018,Oct,139403,134950,4453,3.2,"Alachua County, FL"
70,2018,Nov,136984,132808,4176,3.0,"Alachua County, FL"
71,2018,Dec,136395,132200,4195,3.1,"Alachua County, FL"
72,2019,Jan,137060,132116,4944,3.6,"Alachua County, FL"
73,2019,Feb,137619,133471,4148,3.0,"Alachua County, FL"
74,2019,Mar,137458,133371,4087,3.0,"Alachua County, FL"
75,2019,Apr,138395,134774,3621,2.6,"Alachua County, FL"
76,2019,May,136167,132382,3785,2.8,"Alachua County, FL"
77,2019,Jun,135825,131256,4569,3.4,"Alachua County, FL"
78,2019,Jul,136908,132109,4799,3.5,"Alachua County, FL"
79,2019,Aug,136247,131827,4420,3.2,"Alachua County, FL"
80,2019,Sep,142031,137955,4076,2.9,"Alachua County, FL"
81,2019,Oct,141061,137001,4060,2.9,"Alachua County, FL"
82,2019,Nov,139928,136176,3752,2.7,"Alachua County, FL"
83,2019,Dec,138849,135354,3495,2.5,"Alachua County, FL"
84,2020,Jan,138936,134796,4140,3.0,"Alachua County, FL"
85,2020,Feb,139712,136311,3401,2.4,"Alachua County, FL"
86,2020,Mar,137199,132177,5022,3.7,"Alachua County, FL"
87,2020,Apr,124931,114476,10455,8.4,"Alachua County, FL"
88,2020,May,130737,119441,11296,8.6,"Alachua County, FL"
89,2020,Jun,130180,120101,10079,7.7,"Alachua County, FL"
90,2020,Jul,133607,121858,11749,8.8,"Alachua County, FL"
91,2020,Aug,133138,124981,8157,6.1,"Alachua County, FL"
92,2020,Sep,137116,129459,7657,5.6,"Alachua County, FL"
93,2020,Oct,138139,131252,6887,5.0,"Alachua County, FL"
94,2020,Nov,136598,130074,6524,4.8,"Alachua County, FL"
95,2020,Dec,136355,130090,6265,4.6,"Alachua County, FL"
96,2021,Jan,135839,129204,6635,4.9,"Alachua County, FL"
97,2021,Feb,137322,131365,5957,4.3,"Alachua County, FL"
98,2021,Mar,137582,132172,5410,3.9,"Alachua County, FL"
99,2021,Apr,138407,133322,5085,3.7,"Alachua County, FL"
100,2021,May,137083,132104,4979,3.6,"Alachua County, FL"
101,2021,Jun,136685,130709,5976,4.4,"Alachua County, FL"
102,2021,Jul,137277,131454,5823,4.2,"Alachua County, FL"
103,2021,Aug,136343,130842,5501,4.0,"Alachua County, FL"
104,2021,Sep,141110,136288,4822,3.4,"Alachua County, FL"
105,2021,Oct,141001,136221,4780,3.4,"Alachua County, FL"
106,2021,Nov,140630,136282,4348,3.1,"Alachua County, FL"
107,2021,Dec,139312,135395,3917,2.8,"Alachua County, FL"
108,2022,Jan,140298,135418,4880,3.5,"Alachua County, FL"
109,2022,Feb,140434,136177,4257,3.0,"Alachua County, FL"
110,2022,Mar,140835,136942,3893,2.8,"Alachua County, FL"
111,2022,Apr,141919,138315,3604,2.5,"Alachua County, FL"
112,2022,May,139827,136030,3797,2.7,"Alachua County, FL"
113,2022,Jun,139574,135169,4405,3.2,"Alachua County, FL"
114,2022,Jul,139903,135590,4313,3.1,"Alachua County, FL"
115,2022,Aug,138889,134790,4099,3.0,"Alachua County, FL"
116,2022,Sep,144946,141210,3736,2.6,"Alachua County, FL"
117,2022,Oct,144554,140713,3841,2.7,"Alachua County, FL"
118,2022,Nov,143624,139856,3768,2.6,"Alachua County, FL"
119,2022,Dec,142790,139756,3034,2.1,"Alachua County, FL"
120,2023,Jan,143540,139879,3661,2.6,"Alachua County, FL"
121,2023,Feb,144981,141280,3701,2.6,"Alachua County, FL"
122,2023,Mar,145819,142050,3769,2.6,"Alachua County, FL"
123,2023,Apr,147018,143556,3462,2.4,"Alachua County, FL"
124,2023,May,144061,139988,4073,2.8,"Alachua County, FL"
125,2023,Jun,144655,139959,4696,3.2,"Alachua County, FL"
126,2023,Jul,145326,140473,4853,3.3,"Alachua County, FL"
127,2023,Aug,145124,140300,4824,3.3,"Alachua County, FL"
128,2023,Sep,149935,145282,4653,3.1,"Alachua County, FL"
129,2023,Oct,150524,145484,5040,3.3,"Alachua County, FL"
0,2013,Jan,17653,16009,1644,9.3,"Jackson County, FL"
1,2013,Feb,17449,15960,1489,8.5,"Jackson County, FL"
2,2013,Mar,17546,16153,1393,7.9,"Jackson County, FL"
3,2013,Apr,17605,16296,1309,7.4,"Jackson County, FL"
4,2013,May,17915,16546,1369,7.6,"Jackson County, FL"
5,2013,Jun,17969,16477,1492,8.3,"Jackson County, FL"
6,2013,Jul,17900,16449,1451,8.1,"Jackson County, FL"
7,2013,Aug,17904,16483,1421,7.9,"Jackson County, FL"
8,2013,Sep,17917,16557,1360,7.6,"Jackson County, FL"
9,2013,Oct,17808,16483,1325,7.4,"Jackson County, FL"
10,2013,Nov,17660,16381,1279,7.2,"Jackson County, FL"
11,2013,Dec,17502,16290,1212,6.9,"Jackson County, FL"
12,2014,Jan,17385,16105,1280,7.4,"Jackson County, FL"
13,2014,Feb,17277,16035,1242,7.2,"Jackson County, FL"
14,2014,Mar,17495,16269,1226,7.0,"Jackson County, FL"
15,2014,Apr,17311,16198,1113,6.4,"Jackson County, FL"
16,2014,May,17550,16352,1198,6.8,"Jackson County, FL"
17,2014,Jun,17528,16265,1263,7.2,"Jackson County, FL"
18,2014,Jul,17545,16249,1296,7.4,"Jackson County, FL"
19,2014,Aug,17504,16228,1276,7.3,"Jackson County, FL"
20,2014,Sep,17617,16439,1178,6.7,"Jackson County, FL"
21,2014,Oct,17642,16498,1144,6.5,"Jackson County, FL"
22,2014,Nov,17396,16257,1139,6.5,"Jackson County, FL"
23,2014,Dec,17247,16178,1069,6.2,"Jackson County, FL"
24,2015,Jan,17308,16121,1187,6.9,"Jackson County, FL"
25,2015,Feb,17166,16079,1087,6.3,"Jackson County, FL"
26,2015,Mar,17145,16135,1010,5.9,"Jackson County, FL"
27,2015,Apr,17470,16485,985,5.6,"Jackson County, FL"
28,2015,May,17719,16657,1062,6.0,"Jackson County, FL"
29,2015,Jun,17194,16103,1091,6.3,"Jackson County, FL"
30,2015,Jul,17085,15978,1107,6.5,"Jackson County, FL"
31,2015,Aug,17324,16286,1038,6.0,"Jackson County, FL"
32,2015,Sep,17697,16726,971,5.5,"Jackson County, FL"
33,2015,Oct,17729,16765,964,5.4,"Jackson County, FL"
34,2015,Nov,17368,16399,969,5.6,"Jackson County, FL"
35,2015,Dec,17341,16409,932,5.4,"Jackson County, FL"
36,2016,Jan,17388,16403,985,5.7,"Jackson County, FL"
37,2016,Feb,17546,16633,913,5.2,"Jackson County, FL"
38,2016,Mar,17659,16752,907,5.1,"Jackson County, FL"
39,2016,Apr,17288,16416,872,5.0,"Jackson County, FL"
40,2016,May,17512,16635,877,5.0,"Jackson County, FL"
41,2016,Jun,17213,16230,983,5.7,"Jackson County, FL"
42,2016,Jul,17158,16166,992,5.8,"Jackson County, FL"
43,2016,Aug,17385,16425,960,5.5,"Jackson County, FL"
44,2016,Sep,17585,16657,928,5.3,"Jackson County, FL"
45,2016,Oct,17546,16666,880,5.0,"Jackson County, FL"
46,2016,Nov,17296,16448,848,4.9,"Jackson County, FL"
47,2016,Dec,17180,16332,848,4.9,"Jackson County, FL"
48,2017,Jan,17310,16377,933,5.4,"Jackson County, FL"
49,2017,Feb,17106,16281,825,4.8,"Jackson County, FL"
50,2017,Mar,17219,16449,770,4.5,"Jackson County, FL"
51,2017,Apr,17190,16445,745,4.3,"Jackson County, FL"
52,2017,May,17354,16602,752,4.3,"Jackson County, FL"
53,2017,Jun,16804,15957,847,5.0,"Jackson County, FL"
54,2017,Jul,16750,15890,860,5.1,"Jackson County, FL"
55,2017,Aug,17047,16216,831,4.9,"Jackson County, FL"
56,2017,Sep,17654,16910,744,4.2,"Jackson County, FL"
57,2017,Oct,17353,16641,712,4.1,"Jackson County, FL"
58,2017,Nov,17179,16446,733,4.3,"Jackson County, FL"
59,2017,Dec,17063,16370,693,4.1,"Jackson County, FL"
60,2018,Jan,17006,16259,747,4.4,"Jackson County, FL"
61,2018,Feb,17086,16403,683,4.0,"Jackson County, FL"
62,2018,Mar,17168,16496,672,3.9,"Jackson County, FL"
63,2018,Apr,17260,16633,627,3.6,"Jackson County, FL"
64,2018,May,17351,16734,617,3.6,"Jackson County, FL"
65,2018,Jun,16915,16140,775,4.6,"Jackson County, FL"
66,2018,Jul,17063,16311,752,4.4,"Jackson County, FL"
67,2018,Aug,17269,16566,703,4.1,"Jackson County, FL"
68,2018,Sep,17644,17008,636,3.6,"Jackson County, FL"
69,2018,Oct,16922,16273,649,3.8,"Jackson County, FL"
70,2018,Nov,16890,16068,822,4.9,"Jackson County, FL"
71,2018,Dec,16973,16232,741,4.4,"Jackson County, FL"
72,2019,Jan,16877,16110,767,4.5,"Jackson County, FL"
73,2019,Feb,16828,16167,661,3.9,"Jackson County, FL"
74,2019,Mar,16889,16269,620,3.7,"Jackson County, FL"
75,2019,Apr,16977,16422,555,3.3,"Jackson County, FL"
76,2019,May,17184,16595,589,3.4,"Jackson County, FL"
77,2019,Jun,16775,16103,672,4.0,"Jackson County, FL"
78,2019,Jul,16508,15833,675,4.1,"Jackson County, FL"
79,2019,Aug,16974,16342,632,3.7,"Jackson County, FL"
80,2019,Sep,17349,16801,548,3.2,"Jackson County, FL"
81,2019,Oct,17333,16790,543,3.1,"Jackson County, FL"
82,2019,Nov,17139,16605,534,3.1,"Jackson County, FL"
83,2019,Dec,17172,16650,522,3.0,"Jackson County, FL"
84,2020,Jan,17068,16479,589,3.5,"Jackson County, FL"
85,2020,Feb,17054,16565,489,2.9,"Jackson County, FL"
86,2020,Mar,16962,16242,720,4.2,"Jackson County, FL"
87,2020,Apr,16178,15096,1082,6.7,"Jackson County, FL"
88,2020,May,17275,15962,1313,7.6,"Jackson County, FL"
89,2020,Jun,16792,15552,1240,7.4,"Jackson County, FL"
90,2020,Jul,17142,15682,1460,8.5,"Jackson County, FL"
91,2020,Aug,17282,16239,1043,6.0,"Jackson County, FL"
92,2020,Sep,17512,16483,1029,5.9,"Jackson County, FL"
93,2020,Oct,17608,16645,963,5.5,"Jackson County, FL"
94,2020,Nov,17447,16468,979,5.6,"Jackson County, FL"
95,2020,Dec,17508,16541,967,5.5,"Jackson County, FL"
96,2021,Jan,17118,16108,1010,5.9,"Jackson County, FL"
97,2021,Feb,17107,16174,933,5.5,"Jackson County, FL"
98,2021,Mar,17153,16343,810,4.7,"Jackson County, FL"
99,2021,Apr,17234,16444,790,4.6,"Jackson County, FL"
100,2021,May,17266,16493,773,4.5,"Jackson County, FL"
101,2021,Jun,17220,16312,908,5.3,"Jackson County, FL"
102,2021,Jul,16955,16068,887,5.2,"Jackson County, FL"
103,2021,Aug,17218,16374,844,4.9,"Jackson County, FL"
104,2021,Sep,17267,16518,749,4.3,"Jackson County, FL"
105,2021,Oct,17156,16436,720,4.2,"Jackson County, FL"
106,2021,Nov,16915,16287,628,3.7,"Jackson County, FL"
107,2021,Dec,16966,16406,560,3.3,"Jackson County, FL"
108,2022,Jan,16618,15922,696,4.2,"Jackson County, FL"
109,2022,Feb,16544,15955,589,3.6,"Jackson County, FL"
110,2022,Mar,16551,16006,545,3.3,"Jackson County, FL"
111,2022,Apr,16633,16125,508,3.1,"Jackson County, FL"
112,2022,May,16790,16268,522,3.1,"Jackson County, FL"
113,2022,Jun,16580,15987,593,3.6,"Jackson County, FL"
114,2022,Jul,16493,15946,547,3.3,"Jackson County, FL"
115,2022,Aug,16605,16065,540,3.3,"Jackson County, FL"
116,2022,Sep,16662,16154,508,3.0,"Jackson County, FL"
117,2022,Oct,16602,16102,500,3.0,"Jackson County, FL"
118,2022,Nov,16432,15950,482,2.9,"Jackson County, FL"
119,2022,Dec,16576,16156,420,2.5,"Jackson County, FL"
120,2023,Jan,16418,15919,499,3.0,"Jackson County, FL"
121,2023,Feb,16551,16062,489,3.0,"Jackson County, FL"
122,2023,Mar,16718,16220,498,3.0,"Jackson County, FL"
123,2023,Apr,16796,16340,456,2.7,"Jackson County, FL"
124,2023,May,16945,16418,527,3.1,"Jackson County, FL"
125,2023,Jun,16878,16266,612,3.6,"Jackson County, FL"
126,2023,Jul,16718,16091,627,3.8,"Jackson County, FL"
127,2023,Aug,17006,16365,641,3.8,"Jackson County, FL"
128,2023,Sep,17138,16502,636,3.7,"Jackson County, FL"
129,2023,Oct,17160,16507,653,3.8,"Jackson County, FL"
0,2013,Jan,9608,8679,929,9.7,"Washington County, FL"
1,2013,Feb,9624,8772,852,8.9,"Washington County, FL"
2,2013,Mar,9653,8864,789,8.2,"Washington County, FL"
3,2013,Apr,9944,9193,751,7.6,"Washington County, FL"
4,2013,May,9982,9219,763,7.6,"Washington County, FL"
5,2013,Jun,9979,9150,829,8.3,"Washington County, FL"
6,2013,Jul,10056,9247,809,8.0,"Washington County, FL"
7,2013,Aug,9981,9187,794,8.0,"Washington County, FL"
8,2013,Sep,10017,9240,777,7.8,"Washington County, FL"
9,2013,Oct,9848,9099,749,7.6,"Washington County, FL"
10,2013,Nov,9640,8905,735,7.6,"Washington County, FL"
11,2013,Dec,9627,8922,705,7.3,"Washington County, FL"
12,2014,Jan,9590,8844,746,7.8,"Washington County, FL"
13,2014,Feb,9566,8866,700,7.3,"Washington County, FL"
14,2014,Mar,9671,8988,683,7.1,"Washington County, FL"
15,2014,Apr,9718,9109,609,6.3,"Washington County, FL"
16,2014,May,9890,9225,665,6.7,"Washington County, FL"
17,2014,Jun,9843,9149,694,7.1,"Washington County, FL"
18,2014,Jul,9798,9069,729,7.4,"Washington County, FL"
19,2014,Aug,9738,9044,694,7.1,"Washington County, FL"
20,2014,Sep,9699,9055,644,6.6,"Washington County, FL"
21,2014,Oct,9681,9055,626,6.5,"Washington County, FL"
22,2014,Nov,9554,8902,652,6.8,"Washington County, FL"
23,2014,Dec,9423,8811,612,6.5,"Washington County, FL"
24,2015,Jan,9583,8909,674,7.0,"Washington County, FL"
25,2015,Feb,9477,8870,607,6.4,"Washington County, FL"
26,2015,Mar,9518,8938,580,6.1,"Washington County, FL"
27,2015,Apr,9550,8995,555,5.8,"Washington County, FL"
28,2015,May,9771,9181,590,6.0,"Washington County, FL"
29,2015,Jun,9686,9075,611,6.3,"Washington County, FL"
30,2015,Jul,9714,9115,599,6.2,"Washington County, FL"
31,2015,Aug,9863,9285,578,5.9,"Washington County, FL"
32,2015,Sep,9812,9256,556,5.7,"Washington County, FL"
33,2015,Oct,9689,9145,544,5.6,"Washington County, FL"
34,2015,Nov,9552,9006,546,5.7,"Washington County, FL"
35,2015,Dec,9560,9039,521,5.4,"Washington County, FL"
36,2016,Jan,9599,9055,544,5.7,"Washington County, FL"
37,2016,Feb,9591,9073,518,5.4,"Washington County, FL"
38,2016,Mar,9667,9164,503,5.2,"Washington County, FL"
39,2016,Apr,9618,9141,477,5.0,"Washington County, FL"
40,2016,May,9771,9301,470,4.8,"Washington County, FL"
41,2016,Jun,9773,9237,536,5.5,"Washington County, FL"
42,2016,Jul,9767,9236,531,5.4,"Washington County, FL"
43,2016,Aug,9901,9386,515,5.2,"Washington County, FL"
44,2016,Sep,9906,9392,514,5.2,"Washington County, FL"
45,2016,Oct,9867,9379,488,4.9,"Washington County, FL"
46,2016,Nov,9679,9206,473,4.9,"Washington County, FL"
47,2016,Dec,9636,9162,474,4.9,"Washington County, FL"
48,2017,Jan,9597,9064,533,5.6,"Washington County, FL"
49,2017,Feb,9588,9116,472,4.9,"Washington County, FL"
50,2017,Mar,9642,9216,426,4.4,"Washington County, FL"
51,2017,Apr,9658,9258,400,4.1,"Washington County, FL"
52,2017,May,9754,9345,409,4.2,"Washington County, FL"
53,2017,Jun,9793,9345,448,4.6,"Washington County, FL"
54,2017,Jul,9748,9293,455,4.7,"Washington County, FL"
55,2017,Aug,9847,9404,443,4.5,"Washington County, FL"
56,2017,Sep,9896,9475,421,4.3,"Washington County, FL"
57,2017,Oct,9707,9313,394,4.1,"Washington County, FL"
58,2017,Nov,9638,9243,395,4.1,"Washington County, FL"
59,2017,Dec,9631,9246,385,4.0,"Washington County, FL"
60,2018,Jan,9442,9005,437,4.6,"Washington County, FL"
61,2018,Feb,9581,9184,397,4.1,"Washington County, FL"
62,2018,Mar,9631,9272,359,3.7,"Washington County, FL"
63,2018,Apr,9700,9359,341,3.5,"Washington County, FL"
64,2018,May,9864,9522,342,3.5,"Washington County, FL"
65,2018,Jun,9892,9482,410,4.1,"Washington County, FL"
66,2018,Jul,9790,9406,384,3.9,"Washington County, FL"
67,2018,Aug,9969,9600,369,3.7,"Washington County, FL"
68,2018,Sep,9955,9599,356,3.6,"Washington County, FL"
69,2018,Oct,9364,9010,354,3.8,"Washington County, FL"
70,2018,Nov,9556,9110,446,4.7,"Washington County, FL"
71,2018,Dec,9574,9173,401,4.2,"Washington County, FL"
72,2019,Jan,9510,9059,451,4.7,"Washington County, FL"
73,2019,Feb,9495,9123,372,3.9,"Washington County, FL"
74,2019,Mar,9589,9239,350,3.7,"Washington County, FL"
75,2019,Apr,9562,9254,308,3.2,"Washington County, FL"
76,2019,May,9734,9422,312,3.2,"Washington County, FL"
77,2019,Jun,9709,9345,364,3.7,"Washington County, FL"
78,2019,Jul,9637,9269,368,3.8,"Washington County, FL"
79,2019,Aug,9784,9432,352,3.6,"Washington County, FL"
80,2019,Sep,9807,9491,316,3.2,"Washington County, FL"
81,2019,Oct,9704,9385,319,3.3,"Washington County, FL"
82,2019,Nov,9608,9303,305,3.2,"Washington County, FL"
83,2019,Dec,9640,9347,293,3.0,"Washington County, FL"
84,2020,Jan,9705,9347,358,3.7,"Washington County, FL"
85,2020,Feb,9639,9333,306,3.2,"Washington County, FL"
86,2020,Mar,9591,9174,417,4.3,"Washington County, FL"
87,2020,Apr,8759,7986,773,8.8,"Washington County, FL"
88,2020,May,9374,8541,833,8.9,"Washington County, FL"
89,2020,Jun,9342,8610,732,7.8,"Washington County, FL"
90,2020,Jul,9532,8692,840,8.8,"Washington County, FL"
91,2020,Aug,9517,8918,599,6.3,"Washington County, FL"
92,2020,Sep,9531,8964,567,5.9,"Washington County, FL"
93,2020,Oct,9548,9022,526,5.5,"Washington County, FL"
94,2020,Nov,9448,8959,489,5.2,"Washington County, FL"
95,2020,Dec,9446,8931,515,5.5,"Washington County, FL"
96,2021,Jan,9433,8887,546,5.8,"Washington County, FL"
97,2021,Feb,9448,8973,475,5.0,"Washington County, FL"
98,2021,Mar,9502,9049,453,4.8,"Washington County, FL"
99,2021,Apr,9573,9139,434,4.5,"Washington County, FL"
100,2021,May,9670,9233,437,4.5,"Washington County, FL"
101,2021,Jun,9690,9176,514,5.3,"Washington County, FL"
102,2021,Jul,9629,9152,477,5.0,"Washington County, FL"
103,2021,Aug,9673,9221,452,4.7,"Washington County, FL"
104,2021,Sep,9682,9281,401,4.1,"Washington County, FL"
105,2021,Oct,9623,9247,376,3.9,"Washington County, FL"
106,2021,Nov,9537,9180,357,3.7,"Washington County, FL"
107,2021,Dec,9565,9231,334,3.5,"Washington County, FL"
108,2022,Jan,9639,9228,411,4.3,"Washington County, FL"
109,2022,Feb,9652,9304,348,3.6,"Washington County, FL"
110,2022,Mar,9734,9424,310,3.2,"Washington County, FL"
111,2022,Apr,9689,9395,294,3.0,"Washington County, FL"
112,2022,May,9797,9497,300,3.1,"Washington County, FL"
113,2022,Jun,9808,9464,344,3.5,"Washington County, FL"
114,2022,Jul,9814,9485,329,3.4,"Washington County, FL"
115,2022,Aug,9920,9602,318,3.2,"Washington County, FL"
116,2022,Sep,9943,9653,290,2.9,"Washington County, FL"
117,2022,Oct,9862,9571,291,3.0,"Washington County, FL"
118,2022,Nov,9827,9544,283,2.9,"Washington County, FL"
119,2022,Dec,9857,9620,237,2.4,"Washington County, FL"
120,2023,Jan,9845,9567,278,2.8,"Washington County, FL"
121,2023,Feb,9929,9651,278,2.8,"Washington County, FL"
122,2023,Mar,10042,9764,278,2.8,"Washington County, FL"
123,2023,Apr,10045,9794,251,2.5,"Washington County, FL"
124,2023,May,10124,9830,294,2.9,"Washington County, FL"
125,2023,Jun,10187,9847,340,3.3,"Washington County, FL"
126,2023,Jul,10212,9869,343,3.4,"Washington County, FL"
127,2023,Aug,10419,10060,359,3.4,"Washington County, FL"
128,2023,Sep,10439,10074,365,3.5,"Washington County, FL"
129,2023,Oct,10385,10035,350,3.4,"Washington County, FL"
0,2013,Jan,997731,887189,110542,11.1,"Riverside County, CA"
1,2013,Feb,993303,888020,105283,10.6,"Riverside County, CA"
2,2013,Mar,992494,890809,101685,10.2,"Riverside County, CA"
3,2013,Apr,985361,890929,94432,9.6,"Riverside County, CA"
4,2013,May,987881,893893,93988,9.5,"Riverside County, CA"
5,2013,Jun,994216,889688,104528,10.5,"Riverside County, CA"
6,2013,Jul,992299,885577,106722,10.8,"Riverside County, CA"
7,2013,Aug,988995,885647,103348,10.4,"Riverside County, CA"
8,2013,Sep,993869,895761,98108,9.9,"Riverside County, CA"
9,2013,Oct,992481,894974,97507,9.8,"Riverside County, CA"
10,2013,Nov,999845,908374,91471,9.1,"Riverside County, CA"
11,2013,Dec,997790,910581,87209,8.7,"Riverside County, CA"
12,2014,Jan,1001633,910691,90942,9.1,"Riverside County, CA"
13,2014,Feb,1004947,913959,90988,9.1,"Riverside County, CA"
14,2014,Mar,1009392,918410,90982,9.0,"Riverside County, CA"
15,2014,Apr,995413,916676,78737,7.9,"Riverside County, CA"
16,2014,May,999500,920524,78976,7.9,"Riverside County, CA"
17,2014,Jun,1002758,917902,84856,8.5,"Riverside County, CA"
18,2014,Jul,1006843,915138,91705,9.1,"Riverside County, CA"
19,2014,Aug,1006381,916887,89494,8.9,"Riverside County, CA"
20,2014,Sep,1009856,928586,81270,8.0,"Riverside County, CA"
21,2014,Oct,1019424,940106,79318,7.8,"Riverside County, CA"
22,2014,Nov,1029187,952570,76617,7.4,"Riverside County, CA"
23,2014,Dec,1024604,954129,70475,6.9,"Riverside County, CA"
24,2015,Jan,1030012,953516,76496,7.4,"Riverside County, CA"
25,2015,Feb,1029052,955806,73246,7.1,"Riverside County, CA"
26,2015,Mar,1030282,958308,71974,7.0,"Riverside County, CA"
27,2015,Apr,1024147,957435,66712,6.5,"Riverside County, CA"
28,2015,May,1029047,962381,66666,6.5,"Riverside County, CA"
29,2015,Jun,1028856,956990,71866,7.0,"Riverside County, CA"
30,2015,Jul,1030731,953961,76770,7.4,"Riverside County, CA"
31,2015,Aug,1029205,956423,72782,7.1,"Riverside County, CA"
32,2015,Sep,1029301,962233,67068,6.5,"Riverside County, CA"
33,2015,Oct,1038757,972166,66591,6.4,"Riverside County, CA"
34,2015,Nov,1049707,985534,64173,6.1,"Riverside County, CA"
35,2015,Dec,1052399,991151,61248,5.8,"Riverside County, CA"
36,2016,Jan,1049303,985317,63986,6.1,"Riverside County, CA"
37,2016,Feb,1048546,984495,64051,6.1,"Riverside County, CA"
38,2016,Mar,1053761,988619,65142,6.2,"Riverside County, CA"
39,2016,Apr,1043293,982384,60909,5.8,"Riverside County, CA"
40,2016,May,1042720,985639,57081,5.5,"Riverside County, CA"
41,2016,Jun,1047074,978794,68280,6.5,"Riverside County, CA"
42,2016,Jul,1050713,978635,72078,6.9,"Riverside County, CA"
43,2016,Aug,1049109,978102,71007,6.8,"Riverside County, CA"
44,2016,Sep,1054475,987019,67456,6.4,"Riverside County, CA"
45,2016,Oct,1058670,993372,65298,6.2,"Riverside County, CA"
46,2016,Nov,1062236,1001989,60247,5.7,"Riverside County, CA"
47,2016,Dec,1059416,1001881,57535,5.4,"Riverside County, CA"
48,2017,Jan,1068447,1004549,63898,6.0,"Riverside County, CA"
49,2017,Feb,1067170,1006042,61128,5.7,"Riverside County, CA"
50,2017,Mar,1070923,1012279,58644,5.5,"Riverside County, CA"
51,2017,Apr,1059113,1005969,53144,5.0,"Riverside County, CA"
52,2017,May,1060237,1009573,50664,4.8,"Riverside County, CA"
53,2017,Jun,1064343,1005529,58814,5.5,"Riverside County, CA"
54,2017,Jul,1070912,1008516,62396,5.8,"Riverside County, CA"
55,2017,Aug,1068193,1005617,62576,5.9,"Riverside County, CA"
56,2017,Sep,1077229,1021262,55967,5.2,"Riverside County, CA"
57,2017,Oct,1077063,1023796,53267,4.9,"Riverside County, CA"
58,2017,Nov,1086210,1035337,50873,4.7,"Riverside County, CA"
59,2017,Dec,1080673,1032313,48360,4.5,"Riverside County, CA"
60,2018,Jan,1084032,1031712,52320,4.8,"Riverside County, CA"
61,2018,Feb,1088932,1038653,50279,4.6,"Riverside County, CA"
62,2018,Mar,1089606,1041430,48176,4.4,"Riverside County, CA"
63,2018,Apr,1079071,1035501,43570,4.0,"Riverside County, CA"
64,2018,May,1081368,1040676,40692,3.8,"Riverside County, CA"
65,2018,Jun,1084925,1034141,50784,4.7,"Riverside County, CA"
66,2018,Jul,1091786,1039647,52139,4.8,"Riverside County, CA"
67,2018,Aug,1081432,1028581,52851,4.9,"Riverside County, CA"
68,2018,Sep,1090979,1042517,48462,4.4,"Riverside County, CA"
69,2018,Oct,1098505,1049897,48608,4.4,"Riverside County, CA"
70,2018,Nov,1106209,1059548,46661,4.2,"Riverside County, CA"
71,2018,Dec,1104778,1057969,46809,4.2,"Riverside County, CA"
72,2019,Jan,1107997,1054109,53888,4.9,"Riverside County, CA"
73,2019,Feb,1107978,1059662,48316,4.4,"Riverside County, CA"
74,2019,Mar,1107963,1059610,48353,4.4,"Riverside County, CA"
75,2019,Apr,1093398,1052611,40787,3.7,"Riverside County, CA"
76,2019,May,1093369,1053785,39584,3.6,"Riverside County, CA"
77,2019,Jun,1096607,1048836,47771,4.4,"Riverside County, CA"
78,2019,Jul,1106823,1055089,51734,4.7,"Riverside County, CA"
79,2019,Aug,1101762,1050540,51222,4.6,"Riverside County, CA"
80,2019,Sep,1106579,1061732,44847,4.1,"Riverside County, CA"
81,2019,Oct,1118189,1072126,46063,4.1,"Riverside County, CA"
82,2019,Nov,1128183,1083541,44642,4.0,"Riverside County, CA"
83,2019,Dec,1128269,1085761,42508,3.8,"Riverside County, CA"
84,2020,Jan,1129471,1081542,47929,4.2,"Riverside County, CA"
85,2020,Feb,1135725,1089982,45743,4.0,"Riverside County, CA"
86,2020,Mar,1125611,1058817,66794,5.9,"Riverside County, CA"
87,2020,Apr,1102209,923385,178824,16.2,"Riverside County, CA"
88,2020,May,1091822,917432,174390,16.0,"Riverside County, CA"
89,2020,Jun,1128647,976104,152543,13.5,"Riverside County, CA"
90,2020,Jul,1125415,977217,148198,13.2,"Riverside County, CA"
91,2020,Aug,1115296,992158,123138,11.0,"Riverside County, CA"
92,2020,Sep,1117832,1000693,117139,10.5,"Riverside County, CA"
93,2020,Oct,1126089,1023063,103026,9.1,"Riverside County, CA"
94,2020,Nov,1128361,1028689,99672,8.8,"Riverside County, CA"
95,2020,Dec,1126429,1027348,99081,8.8,"Riverside County, CA"
96,2021,Jan,1123486,1023365,100121,8.9,"Riverside County, CA"
97,2021,Feb,1132295,1035562,96733,8.5,"Riverside County, CA"
98,2021,Mar,1129851,1037171,92680,8.2,"Riverside County, CA"
99,2021,Apr,1121234,1030640,90594,8.1,"Riverside County, CA"
100,2021,May,1124236,1040299,83937,7.5,"Riverside County, CA"
101,2021,Jun,1128410,1033989,94421,8.4,"Riverside County, CA"
102,2021,Jul,1135734,1044986,90748,8.0,"Riverside County, CA"
103,2021,Aug,1130781,1045208,85573,7.6,"Riverside County, CA"
104,2021,Sep,1131326,1057880,73446,6.5,"Riverside County, CA"
105,2021,Oct,1141704,1071865,69839,6.1,"Riverside County, CA"
106,2021,Nov,1148887,1087066,61821,5.4,"Riverside County, CA"
107,2021,Dec,1148591,1092474,56117,4.9,"Riverside County, CA"
108,2022,Jan,1151506,1089851,61655,5.4,"Riverside County, CA"
109,2022,Feb,1161462,1106989,54473,4.7,"Riverside County, CA"
110,2022,Mar,1160864,1112239,48625,4.2,"Riverside County, CA"
111,2022,Apr,1140903,1098473,42430,3.7,"Riverside County, CA"
112,2022,May,1143750,1104293,39457,3.4,"Riverside County, CA"
113,2022,Jun,1140328,1093441,46887,4.1,"Riverside County, CA"
114,2022,Jul,1146311,1098030,48281,4.2,"Riverside County, CA"
115,2022,Aug,1147243,1097281,49962,4.4,"Riverside County, CA"
116,2022,Sep,1152489,1107117,45372,3.9,"Riverside County, CA"
117,2022,Oct,1159626,1112073,47553,4.1,"Riverside County, CA"
118,2022,Nov,1158912,1111121,47791,4.1,"Riverside County, CA"
119,2022,Dec,1161750,1118014,43736,3.8,"Riverside County, CA"
120,2023,Jan,1151958,1100113,51845,4.5,"Riverside County, CA"
121,2023,Feb,1156856,1103989,52867,4.6,"Riverside County, CA"
122,2023,Mar,1158796,1105668,53128,4.6,"Riverside County, CA"
123,2023,Apr,1141670,1094188,47482,4.2,"Riverside County, CA"
124,2023,May,1141805,1091356,50449,4.4,"Riverside County, CA"
125,2023,Jun,1135238,1078188,57050,5.0,"Riverside County, CA"
126,2023,Jul,1142792,1085738,57054,5.0,"Riverside County, CA"
127,2023,Aug,1142498,1080533,61965,5.4,"Riverside County, CA"
128,2023,Sep,1155614,1097003,58611,5.1,"Riverside County, CA"
129,2023,Oct,1160938,1100682,60256,5.2,"Riverside County, CA"
0,2013,Jan,101887,89177,12710,12.5,"Butte County, CA"
1,2013,Feb,101500,89697,11803,11.6,"Butte County, CA"
2,2013,Mar,100611,89272,11339,11.3,"Butte County, CA"
3,2013,Apr,101389,91047,10342,10.2,"Butte County, CA"
4,2013,May,101432,91238,10194,10.1,"Butte County, CA"
5,2013,Jun,101771,90609,11162,11.0,"Butte County, CA"
6,2013,Jul,101233,90218,11015,10.9,"Butte County, CA"
7,2013,Aug,102421,92126,10295,10.1,"Butte County, CA"
8,2013,Sep,100685,91129,9556,9.5,"Butte County, CA"
9,2013,Oct,102028,92450,9578,9.4,"Butte County, CA"
10,2013,Nov,101357,91762,9595,9.5,"Butte County, CA"
11,2013,Dec,100574,91218,9356,9.3,"Butte County, CA"
12,2014,Jan,101447,91045,10402,10.3,"Butte County, CA"
13,2014,Feb,101594,91277,10317,10.2,"Butte County, CA"
14,2014,Mar,101661,91479,10182,10.0,"Butte County, CA"
15,2014,Apr,100878,92093,8785,8.7,"Butte County, CA"
16,2014,May,101250,92841,8409,8.3,"Butte County, CA"
17,2014,Jun,101289,92277,9012,8.9,"Butte County, CA"
18,2014,Jul,99821,90422,9399,9.4,"Butte County, CA"
19,2014,Aug,100686,91971,8715,8.7,"Butte County, CA"
20,2014,Sep,100503,92825,7678,7.6,"Butte County, CA"
21,2014,Oct,102135,94546,7589,7.4,"Butte County, CA"
22,2014,Nov,101035,93166,7869,7.8,"Butte County, CA"
23,2014,Dec,100377,92633,7744,7.7,"Butte County, CA"
24,2015,Jan,100641,91973,8668,8.6,"Butte County, CA"
25,2015,Feb,101249,93034,8215,8.1,"Butte County, CA"
26,2015,Mar,101089,93065,8024,7.9,"Butte County, CA"
27,2015,Apr,100721,93555,7166,7.1,"Butte County, CA"
28,2015,May,101789,94726,7063,6.9,"Butte County, CA"
29,2015,Jun,100902,93269,7633,7.6,"Butte County, CA"
30,2015,Jul,100522,92825,7697,7.7,"Butte County, CA"
31,2015,Aug,100709,93693,7016,7.0,"Butte County, CA"
32,2015,Sep,101206,94941,6265,6.2,"Butte County, CA"
33,2015,Oct,101896,95560,6336,6.2,"Butte County, CA"
34,2015,Nov,101156,94449,6707,6.6,"Butte County, CA"
35,2015,Dec,100914,94102,6812,6.8,"Butte County, CA"
36,2016,Jan,100304,92689,7615,7.6,"Butte County, CA"
37,2016,Feb,101312,93819,7493,7.4,"Butte County, CA"
38,2016,Mar,102060,94458,7602,7.4,"Butte County, CA"
39,2016,Apr,101625,94953,6672,6.6,"Butte County, CA"
40,2016,May,101878,95882,5996,5.9,"Butte County, CA"
41,2016,Jun,101000,93954,7046,7.0,"Butte County, CA"
42,2016,Jul,101158,94071,7087,7.0,"Butte County, CA"
43,2016,Aug,100834,94179,6655,6.6,"Butte County, CA"
44,2016,Sep,102990,96858,6132,6.0,"Butte County, CA"
45,2016,Oct,102886,96836,6050,5.9,"Butte County, CA"
46,2016,Nov,102444,96377,6067,5.9,"Butte County, CA"
47,2016,Dec,101292,94836,6456,6.4,"Butte County, CA"
48,2017,Jan,101399,94033,7366,7.3,"Butte County, CA"
49,2017,Feb,102032,94784,7248,7.1,"Butte County, CA"
50,2017,Mar,102787,96060,6727,6.5,"Butte County, CA"
51,2017,Apr,102371,96336,6035,5.9,"Butte County, CA"
52,2017,May,102429,97016,5413,5.3,"Butte County, CA"
53,2017,Jun,100977,94902,6075,6.0,"Butte County, CA"
54,2017,Jul,101505,95237,6268,6.2,"Butte County, CA"
55,2017,Aug,101261,95287,5974,5.9,"Butte County, CA"
56,2017,Sep,103400,98362,5038,4.9,"Butte County, CA"
57,2017,Oct,102793,97917,4876,4.7,"Butte County, CA"
58,2017,Nov,101833,96822,5011,4.9,"Butte County, CA"
59,2017,Dec,101198,95920,5278,5.2,"Butte County, CA"
60,2018,Jan,100313,94370,5943,5.9,"Butte County, CA"
61,2018,Feb,100887,94975,5912,5.9,"Butte County, CA"
62,2018,Mar,102602,96998,5604,5.5,"Butte County, CA"
63,2018,Apr,102251,97263,4988,4.9,"Butte County, CA"
64,2018,May,102446,98024,4422,4.3,"Butte County, CA"
65,2018,Jun,101335,96007,5328,5.3,"Butte County, CA"
66,2018,Jul,102266,96988,5278,5.2,"Butte County, CA"
67,2018,Aug,101030,96128,4902,4.9,"Butte County, CA"
68,2018,Sep,102783,98410,4373,4.3,"Butte County, CA"
69,2018,Oct,103683,99200,4483,4.3,"Butte County, CA"
70,2018,Nov,101011,96357,4654,4.6,"Butte County, CA"
71,2018,Dec,101150,95175,5975,5.9,"Butte County, CA"
72,2019,Jan,99185,92294,6891,6.9,"Butte County, CA"
73,2019,Feb,99944,93807,6137,6.1,"Butte County, CA"
74,2019,Mar,99799,93765,6034,6.0,"Butte County, CA"
75,2019,Apr,98449,93529,4920,5.0,"Butte County, CA"
76,2019,May,98537,94182,4355,4.4,"Butte County, CA"
77,2019,Jun,96515,91388,5127,5.3,"Butte County, CA"
78,2019,Jul,95515,90210,5305,5.6,"Butte County, CA"
79,2019,Aug,96166,91359,4807,5.0,"Butte County, CA"
80,2019,Sep,98416,94455,3961,4.0,"Butte County, CA"
81,2019,Oct,99150,95014,4136,4.2,"Butte County, CA"
82,2019,Nov,98145,93913,4232,4.3,"Butte County, CA"
83,2019,Dec,97661,93249,4412,4.5,"Butte County, CA"
84,2020,Jan,96550,91151,5399,5.6,"Butte County, CA"
85,2020,Feb,97683,92496,5187,5.3,"Butte County, CA"
86,2020,Mar,98232,90821,7411,7.5,"Butte County, CA"
87,2020,Apr,92454,77428,15026,16.3,"Butte County, CA"
88,2020,May,90631,78333,12298,13.6,"Butte County, CA"
89,2020,Jun,92881,82156,10725,11.5,"Butte County, CA"
90,2020,Jul,92279,82105,10174,11.0,"Butte County, CA"
91,2020,Aug,92338,83771,8567,9.3,"Butte County, CA"
92,2020,Sep,92291,84096,8195,8.9,"Butte County, CA"
93,2020,Oct,92605,85367,7238,7.8,"Butte County, CA"
94,2020,Nov,91541,84271,7270,7.9,"Butte County, CA"
95,2020,Dec,91513,84002,7511,8.2,"Butte County, CA"
96,2021,Jan,91947,84089,7858,8.5,"Butte County, CA"
97,2021,Feb,92159,84396,7763,8.4,"Butte County, CA"
98,2021,Mar,92694,85162,7532,8.1,"Butte County, CA"
99,2021,Apr,92003,84975,7028,7.6,"Butte County, CA"
100,2021,May,92115,85759,6356,6.9,"Butte County, CA"
101,2021,Jun,92201,85059,7142,7.7,"Butte County, CA"
102,2021,Jul,91171,84433,6738,7.4,"Butte County, CA"
103,2021,Aug,92306,86008,6298,6.8,"Butte County, CA"
104,2021,Sep,93031,87778,5253,5.6,"Butte County, CA"
105,2021,Oct,92639,87576,5063,5.5,"Butte County, CA"
106,2021,Nov,92638,87901,4737,5.1,"Butte County, CA"
107,2021,Dec,91700,87147,4553,5.0,"Butte County, CA"
108,2022,Jan,91591,86234,5357,5.8,"Butte County, CA"
109,2022,Feb,92543,87672,4871,5.3,"Butte County, CA"
110,2022,Mar,93549,89142,4407,4.7,"Butte County, CA"
111,2022,Apr,91795,88013,3782,4.1,"Butte County, CA"
112,2022,May,92259,88834,3425,3.7,"Butte County, CA"
113,2022,Jun,90691,86665,4026,4.4,"Butte County, CA"
114,2022,Jul,89320,85375,3945,4.4,"Butte County, CA"
115,2022,Aug,90948,86977,3971,4.4,"Butte County, CA"
116,2022,Sep,92506,88955,3551,3.8,"Butte County, CA"
117,2022,Oct,92894,89105,3789,4.1,"Butte County, CA"
118,2022,Nov,92908,88836,4072,4.4,"Butte County, CA"
119,2022,Dec,92734,88731,4003,4.3,"Butte County, CA"
120,2023,Jan,92345,87192,5153,5.6,"Butte County, CA"
121,2023,Feb,93446,88164,5282,5.7,"Butte County, CA"
122,2023,Mar,93503,88133,5370,5.7,"Butte County, CA"
123,2023,Apr,92102,87547,4555,4.9,"Butte County, CA"
124,2023,May,91985,87446,4539,4.9,"Butte County, CA"
125,2023,Jun,90922,86023,4899,5.4,"Butte County, CA"
126,2023,Jul,89916,85288,4628,5.1,"Butte County, CA"
127,2023,Aug,91073,86225,4848,5.3,"Butte County, CA"
128,2023,Sep,92345,87818,4527,4.9,"Butte County, CA"
129,2023,Oct,92669,88036,4633,5.0,"Butte County, CA"
0,2013,Jan,437463,367461,70002,16.0,"Fresno County, CA"
1,2013,Feb,436989,369647,67342,15.4,"Fresno County, CA"
2,2013,Mar,436151,370457,65694,15.1,"Fresno County, CA"
3,2013,Apr,437174,377056,60118,13.8,"Fresno County, CA"
4,2013,May,441109,384790,56319,12.8,"Fresno County, CA"
5,2013,Jun,444176,385529,58647,13.2,"Fresno County, CA"
6,2013,Jul,441570,384540,57030,12.9,"Fresno County, CA"
7,2013,Aug,438575,384862,53713,12.2,"Fresno County, CA"
8,2013,Sep,438470,387295,51175,11.7,"Fresno County, CA"
9,2013,Oct,432034,378190,53844,12.5,"Fresno County, CA"
10,2013,Nov,428126,373766,54360,12.7,"Fresno County, CA"
11,2013,Dec,427597,372909,54688,12.8,"Fresno County, CA"
12,2014,Jan,433245,372931,60314,13.9,"Fresno County, CA"
13,2014,Feb,436993,376629,60364,13.8,"Fresno County, CA"
14,2014,Mar,440053,378492,61561,14.0,"Fresno County, CA"
15,2014,Apr,436782,383548,53234,12.2,"Fresno County, CA"
16,2014,May,442075,392834,49241,11.1,"Fresno County, CA"
17,2014,Jun,440422,390686,49736,11.3,"Fresno County, CA"
18,2014,Jul,443220,393298,49922,11.3,"Fresno County, CA"
19,2014,Aug,440577,393975,46602,10.6,"Fresno County, CA"
20,2014,Sep,438209,395224,42985,9.8,"Fresno County, CA"
21,2014,Oct,436368,391420,44948,10.3,"Fresno County, CA"
22,2014,Nov,432912,384821,48091,11.1,"Fresno County, CA"
23,2014,Dec,430552,382535,48017,11.2,"Fresno County, CA"
24,2015,Jan,438797,385250,53547,12.2,"Fresno County, CA"
25,2015,Feb,440369,387890,52479,11.9,"Fresno County, CA"
26,2015,Mar,441686,389176,52510,11.9,"Fresno County, CA"
27,2015,Apr,440686,393761,46925,10.6,"Fresno County, CA"
28,2015,May,445188,400973,44215,9.9,"Fresno County, CA"
29,2015,Jun,444708,399925,44783,10.1,"Fresno County, CA"
30,2015,Jul,443029,399240,43789,9.9,"Fresno County, CA"
31,2015,Aug,440188,400218,39970,9.1,"Fresno County, CA"
32,2015,Sep,439992,402959,37033,8.4,"Fresno County, CA"
33,2015,Oct,438081,397811,40270,9.2,"Fresno County, CA"
34,2015,Nov,435097,392337,42760,9.8,"Fresno County, CA"
35,2015,Dec,435868,392545,43323,9.9,"Fresno County, CA"
36,2016,Jan,440831,392979,47852,10.9,"Fresno County, CA"
37,2016,Feb,443317,395371,47946,10.8,"Fresno County, CA"
38,2016,Mar,446819,397229,49590,11.1,"Fresno County, CA"
39,2016,Apr,446912,402949,43963,9.8,"Fresno County, CA"
40,2016,May,446657,407903,38754,8.7,"Fresno County, CA"
41,2016,Jun,448001,406749,41252,9.2,"Fresno County, CA"
42,2016,Jul,448625,407988,40637,9.1,"Fresno County, CA"
43,2016,Aug,447392,409157,38235,8.5,"Fresno County, CA"
44,2016,Sep,447407,410561,36846,8.2,"Fresno County, CA"
45,2016,Oct,441543,401708,39835,9.0,"Fresno County, CA"
46,2016,Nov,441188,399952,41236,9.3,"Fresno County, CA"
47,2016,Dec,438155,395821,42334,9.7,"Fresno County, CA"
48,2017,Jan,442715,396560,46155,10.4,"Fresno County, CA"
49,2017,Feb,447904,400770,47134,10.5,"Fresno County, CA"
50,2017,Mar,447770,401822,45948,10.3,"Fresno County, CA"
51,2017,Apr,449974,409372,40602,9.0,"Fresno County, CA"
52,2017,May,447769,412268,35501,7.9,"Fresno County, CA"
53,2017,Jun,447361,410372,36989,8.3,"Fresno County, CA"
54,2017,Jul,447245,410681,36564,8.2,"Fresno County, CA"
55,2017,Aug,445956,411238,34718,7.8,"Fresno County, CA"
56,2017,Sep,446758,415754,31004,6.9,"Fresno County, CA"
57,2017,Oct,436768,404522,32246,7.4,"Fresno County, CA"
58,2017,Nov,437057,402062,34995,8.0,"Fresno County, CA"
59,2017,Dec,436144,399761,36383,8.3,"Fresno County, CA"
60,2018,Jan,439675,400427,39248,8.9,"Fresno County, CA"
61,2018,Feb,446334,405412,40922,9.2,"Fresno County, CA"
62,2018,Mar,446068,405568,40500,9.1,"Fresno County, CA"
63,2018,Apr,444946,409709,35237,7.9,"Fresno County, CA"
64,2018,May,448089,417110,30979,6.9,"Fresno County, CA"
65,2018,Jun,450416,416927,33489,7.4,"Fresno County, CA"
66,2018,Jul,448393,415602,32791,7.3,"Fresno County, CA"
67,2018,Aug,446954,416842,30112,6.7,"Fresno County, CA"
68,2018,Sep,448412,421325,27087,6.0,"Fresno County, CA"
69,2018,Oct,444944,416118,28826,6.5,"Fresno County, CA"
70,2018,Nov,444192,412604,31588,7.1,"Fresno County, CA"
71,2018,Dec,445670,411212,34458,7.7,"Fresno County, CA"
72,2019,Jan,450546,409458,41088,9.1,"Fresno County, CA"
73,2019,Feb,452267,412285,39982,8.8,"Fresno County, CA"
74,2019,Mar,452418,412220,40198,8.9,"Fresno County, CA"
75,2019,Apr,450482,416544,33938,7.5,"Fresno County, CA"
76,2019,May,453205,423936,29269,6.5,"Fresno County, CA"
77,2019,Jun,451547,419898,31649,7.0,"Fresno County, CA"
78,2019,Jul,450307,417900,32407,7.2,"Fresno County, CA"
79,2019,Aug,450808,421252,29556,6.6,"Fresno County, CA"
80,2019,Sep,452235,426496,25739,5.7,"Fresno County, CA"
81,2019,Oct,451597,423848,27749,6.1,"Fresno County, CA"
82,2019,Nov,449428,418426,31002,6.9,"Fresno County, CA"
83,2019,Dec,450968,418363,32605,7.2,"Fresno County, CA"
84,2020,Jan,453945,416601,37344,8.2,"Fresno County, CA"
85,2020,Feb,458371,420028,38343,8.4,"Fresno County, CA"
86,2020,Mar,465113,408703,56410,12.1,"Fresno County, CA"
87,2020,Apr,448046,369903,78143,17.4,"Fresno County, CA"
88,2020,May,442110,373298,68812,15.6,"Fresno County, CA"
89,2020,Jun,451711,391271,60440,13.4,"Fresno County, CA"
90,2020,Jul,444523,386283,58240,13.1,"Fresno County, CA"
91,2020,Aug,442545,393948,48597,11.0,"Fresno County, CA"
92,2020,Sep,443579,397110,46469,10.5,"Fresno County, CA"
93,2020,Oct,438265,395865,42400,9.7,"Fresno County, CA"
94,2020,Nov,435141,391529,43612,10.0,"Fresno County, CA"
95,2020,Dec,434730,389125,45605,10.5,"Fresno County, CA"
96,2021,Jan,438090,390314,47776,10.9,"Fresno County, CA"
97,2021,Feb,442167,393386,48781,11.0,"Fresno County, CA"
98,2021,Mar,439961,391825,48136,10.9,"Fresno County, CA"
99,2021,Apr,442645,396718,45927,10.4,"Fresno County, CA"
100,2021,May,447239,405754,41485,9.3,"Fresno County, CA"
101,2021,Jun,449339,404390,44949,10.0,"Fresno County, CA"
102,2021,Jul,449205,407038,42167,9.4,"Fresno County, CA"
103,2021,Aug,446539,407629,38910,8.7,"Fresno County, CA"
104,2021,Sep,447155,413515,33640,7.5,"Fresno County, CA"
105,2021,Oct,445431,412397,33034,7.4,"Fresno County, CA"
106,2021,Nov,443149,411404,31745,7.2,"Fresno County, CA"
107,2021,Dec,443162,412068,31094,7.0,"Fresno County, CA"
108,2022,Jan,447364,411414,35950,8.0,"Fresno County, CA"
109,2022,Feb,451149,416196,34953,7.7,"Fresno County, CA"
110,2022,Mar,449905,417070,32835,7.3,"Fresno County, CA"
111,2022,Apr,448993,420105,28888,6.4,"Fresno County, CA"
112,2022,May,454048,428416,25632,5.6,"Fresno County, CA"
113,2022,Jun,452305,424907,27398,6.1,"Fresno County, CA"
114,2022,Jul,451569,424678,26891,6.0,"Fresno County, CA"
115,2022,Aug,454353,428064,26289,5.8,"Fresno County, CA"
116,2022,Sep,456526,432733,23793,5.2,"Fresno County, CA"
117,2022,Oct,454560,428422,26138,5.8,"Fresno County, CA"
118,2022,Nov,457730,428750,28980,6.3,"Fresno County, CA"
119,2022,Dec,459690,430521,29169,6.3,"Fresno County, CA"
120,2023,Jan,458484,423838,34646,7.6,"Fresno County, CA"
121,2023,Feb,466142,427597,38545,8.3,"Fresno County, CA"
122,2023,Mar,466843,426575,40268,8.6,"Fresno County, CA"
123,2023,Apr,462352,427877,34475,7.5,"Fresno County, CA"
124,2023,May,465668,430733,34935,7.5,"Fresno County, CA"
125,2023,Jun,460989,426477,34512,7.5,"Fresno County, CA"
126,2023,Jul,458183,425777,32406,7.1,"Fresno County, CA"
127,2023,Aug,461005,428693,32312,7.0,"Fresno County, CA"
128,2023,Sep,459766,430588,29178,6.3,"Fresno County, CA"
129,2023,Oct,458686,426922,31764,6.9,"Fresno County, CA"
0,2013,Jan,79368,59063,20305,25.6,"Imperial County, CA"
1,2013,Feb,78195,59106,19089,24.4,"Imperial County, CA"
2,2013,Mar,76961,58474,18487,24.0,"Imperial County, CA"
3,2013,Apr,77830,58182,19648,25.2,"Imperial County, CA"
4,2013,May,77199,58655,18544,24.0,"Imperial County, CA"
5,2013,Jun,79141,58838,20303,25.7,"Imperial County, CA"
6,2013,Jul,77998,56472,21526,27.6,"Imperial County, CA"
7,2013,Aug,78332,56477,21855,27.9,"Imperial County, CA"
8,2013,Sep,78365,57098,21267,27.1,"Imperial County, CA"
9,2013,Oct,78639,57654,20985,26.7,"Imperial County, CA"
10,2013,Nov,78001,59953,18048,23.1,"Imperial County, CA"
11,2013,Dec,77948,60722,17226,22.1,"Imperial County, CA"
12,2014,Jan,77649,60599,17050,22.0,"Imperial County, CA"
13,2014,Feb,77759,61588,16171,20.8,"Imperial County, CA"
14,2014,Mar,77775,61269,16506,21.2,"Imperial County, CA"
15,2014,Apr,78297,60538,17759,22.7,"Imperial County, CA"
16,2014,May,79142,60591,18551,23.4,"Imperial County, CA"
17,2014,Jun,78764,58402,20362,25.9,"Imperial County, CA"
18,2014,Jul,77976,55521,22455,28.8,"Imperial County, CA"
19,2014,Aug,79119,56163,22956,29.0,"Imperial County, CA"
20,2014,Sep,79026,57833,21193,26.8,"Imperial County, CA"
21,2014,Oct,77415,58640,18775,24.3,"Imperial County, CA"
22,2014,Nov,77713,59876,17837,23.0,"Imperial County, CA"
23,2014,Dec,78531,60349,18182,23.2,"Imperial County, CA"
24,2015,Jan,76201,57966,18235,23.9,"Imperial County, CA"
25,2015,Feb,75604,58289,17315,22.9,"Imperial County, CA"
26,2015,Mar,75296,57665,17631,23.4,"Imperial County, CA"
27,2015,Apr,76556,57563,18993,24.8,"Imperial County, CA"
28,2015,May,78047,59331,18716,24.0,"Imperial County, CA"
29,2015,Jun,78024,58474,19550,25.1,"Imperial County, CA"
30,2015,Jul,78282,56496,21786,27.8,"Imperial County, CA"
31,2015,Aug,77955,56679,21276,27.3,"Imperial County, CA"
32,2015,Sep,77333,57619,19714,25.5,"Imperial County, CA"
33,2015,Oct,76695,57628,19067,24.9,"Imperial County, CA"
34,2015,Nov,76048,58260,17788,23.4,"Imperial County, CA"
35,2015,Dec,74950,58393,16557,22.1,"Imperial County, CA"
36,2016,Jan,75303,58695,16608,22.1,"Imperial County, CA"
37,2016,Feb,74428,58490,15938,21.4,"Imperial County, CA"
38,2016,Mar,74119,57888,16231,21.9,"Imperial County, CA"
39,2016,Apr,73997,56151,17846,24.1,"Imperial County, CA"
40,2016,May,74657,57350,17307,23.2,"Imperial County, CA"
41,2016,Jun,74838,56041,18797,25.1,"Imperial County, CA"
42,2016,Jul,75527,54465,21062,27.9,"Imperial County, CA"
43,2016,Aug,76069,54873,21196,27.9,"Imperial County, CA"
44,2016,Sep,76574,56272,20302,26.5,"Imperial County, CA"
45,2016,Oct,76405,57082,19323,25.3,"Imperial County, CA"
46,2016,Nov,75711,58085,17626,23.3,"Imperial County, CA"
47,2016,Dec,74607,58587,16020,21.5,"Imperial County, CA"
48,2017,Jan,74474,59363,15111,20.3,"Imperial County, CA"
49,2017,Feb,73396,59377,14019,19.1,"Imperial County, CA"
50,2017,Mar,72364,58708,13656,18.9,"Imperial County, CA"
51,2017,Apr,70882,58036,12846,18.1,"Imperial County, CA"
52,2017,May,72117,58941,13176,18.3,"Imperial County, CA"
53,2017,Jun,72321,58154,14167,19.6,"Imperial County, CA"
54,2017,Jul,70381,55384,14997,21.3,"Imperial County, CA"
55,2017,Aug,71961,55595,16366,22.7,"Imperial County, CA"
56,2017,Sep,71997,56821,15176,21.1,"Imperial County, CA"
57,2017,Oct,72076,57742,14334,19.9,"Imperial County, CA"
58,2017,Nov,71569,57934,13635,19.1,"Imperial County, CA"
59,2017,Dec,71049,58577,12472,17.6,"Imperial County, CA"
60,2018,Jan,71285,58592,12693,17.8,"Imperial County, CA"
61,2018,Feb,71062,58771,12291,17.3,"Imperial County, CA"
62,2018,Mar,70552,58493,12059,17.1,"Imperial County, CA"
63,2018,Apr,68851,57650,11201,16.3,"Imperial County, CA"
64,2018,May,70535,58585,11950,16.9,"Imperial County, CA"
65,2018,Jun,72004,58560,13444,18.7,"Imperial County, CA"
66,2018,Jul,69990,55678,14312,20.4,"Imperial County, CA"
67,2018,Aug,71974,56178,15796,21.9,"Imperial County, CA"
68,2018,Sep,71225,56483,14742,20.7,"Imperial County, CA"
69,2018,Oct,71876,57352,14524,20.2,"Imperial County, CA"
70,2018,Nov,72361,58421,13940,19.3,"Imperial County, CA"
71,2018,Dec,71637,58312,13325,18.6,"Imperial County, CA"
72,2019,Jan,73683,58845,14838,20.1,"Imperial County, CA"
73,2019,Feb,72788,59304,13484,18.5,"Imperial County, CA"
74,2019,Mar,72663,59555,13108,18.0,"Imperial County, CA"
75,2019,Apr,70314,58113,12201,17.4,"Imperial County, CA"
76,2019,May,72587,59073,13514,18.6,"Imperial County, CA"
77,2019,Jun,74037,58897,15140,20.4,"Imperial County, CA"
78,2019,Jul,72626,56330,16296,22.4,"Imperial County, CA"
79,2019,Aug,75354,56636,18718,24.8,"Imperial County, CA"
80,2019,Sep,74647,57987,16660,22.3,"Imperial County, CA"
81,2019,Oct,75133,58057,17076,22.7,"Imperial County, CA"
82,2019,Nov,75552,58920,16632,22.0,"Imperial County, CA"
83,2019,Dec,74377,59117,15260,20.5,"Imperial County, CA"
84,2020,Jan,73992,59541,14451,19.5,"Imperial County, CA"
85,2020,Feb,73532,60409,13123,17.8,"Imperial County, CA"
86,2020,Mar,76942,58638,18304,23.8,"Imperial County, CA"
87,2020,Apr,74887,53525,21362,28.5,"Imperial County, CA"
88,2020,May,73242,53060,20182,27.6,"Imperial County, CA"
89,2020,Jun,73114,54204,18910,25.9,"Imperial County, CA"
90,2020,Jul,71013,51852,19161,27.0,"Imperial County, CA"
91,2020,Aug,69845,53577,16268,23.3,"Imperial County, CA"
92,2020,Sep,69647,54621,15026,21.6,"Imperial County, CA"
93,2020,Oct,68199,54921,13278,19.5,"Imperial County, CA"
94,2020,Nov,68385,55752,12633,18.5,"Imperial County, CA"
95,2020,Dec,67441,55473,11968,17.7,"Imperial County, CA"
96,2021,Jan,68168,56471,11697,17.2,"Imperial County, CA"
97,2021,Feb,68489,56736,11753,17.2,"Imperial County, CA"
98,2021,Mar,68246,56774,11472,16.8,"Imperial County, CA"
99,2021,Apr,67863,55964,11899,17.5,"Imperial County, CA"
100,2021,May,68515,56759,11756,17.2,"Imperial County, CA"
101,2021,Jun,69903,56598,13305,19.0,"Imperial County, CA"
102,2021,Jul,68693,54810,13883,20.2,"Imperial County, CA"
103,2021,Aug,69543,55764,13779,19.8,"Imperial County, CA"
104,2021,Sep,69702,57057,12645,18.1,"Imperial County, CA"
105,2021,Oct,70502,58445,12057,17.1,"Imperial County, CA"
106,2021,Nov,69834,59107,10727,15.4,"Imperial County, CA"
107,2021,Dec,68720,59073,9647,14.0,"Imperial County, CA"
108,2022,Jan,69694,59321,10373,14.9,"Imperial County, CA"
109,2022,Feb,69208,59904,9304,13.4,"Imperial County, CA"
110,2022,Mar,68278,59866,8412,12.3,"Imperial County, CA"
111,2022,Apr,66462,58629,7833,11.8,"Imperial County, CA"
112,2022,May,68393,59991,8402,12.3,"Imperial County, CA"
113,2022,Jun,69304,59767,9537,13.8,"Imperial County, CA"
114,2022,Jul,68932,58427,10505,15.2,"Imperial County, CA"
115,2022,Aug,71527,59395,12132,17.0,"Imperial County, CA"
116,2022,Sep,71655,59965,11690,16.3,"Imperial County, CA"
117,2022,Oct,72062,59854,12208,16.9,"Imperial County, CA"
118,2022,Nov,72259,60422,11837,16.4,"Imperial County, CA"
119,2022,Dec,72272,61287,10985,15.2,"Imperial County, CA"
120,2023,Jan,72254,60520,11734,16.2,"Imperial County, CA"
121,2023,Feb,71881,60568,11313,15.7,"Imperial County, CA"
122,2023,Mar,71508,60239,11269,15.8,"Imperial County, CA"
123,2023,Apr,69263,59404,9859,14.2,"Imperial County, CA"
124,2023,May,71081,59514,11567,16.3,"Imperial County, CA"
125,2023,Jun,71075,58973,12102,17.0,"Imperial County, CA"
126,2023,Jul,69699,57173,12526,18.0,"Imperial County, CA"
127,2023,Aug,72844,58443,14401,19.8,"Imperial County, CA"
128,2023,Sep,73251,59699,13552,18.5,"Imperial County, CA"
129,2023,Oct,74553,60167,14386,19.3,"Imperial County, CA"
0,2013,Jan,6948,6304,644,9.3,"Holmes County, FL"
1,2013,Feb,6964,6376,588,8.4,"Holmes County, FL"
2,2013,Mar,7013,6455,558,8.0,"Holmes County, FL"
3,2013,Apr,6995,6470,525,7.5,"Holmes County, FL"
4,2013,May,7124,6553,571,8.0,"Holmes County, FL"
5,2013,Jun,7101,6473,628,8.8,"Holmes County, FL"
6,2013,Jul,7006,6376,630,9.0,"Holmes County, FL"
7,2013,Aug,7060,6479,581,8.2,"Holmes County, FL"
8,2013,Sep,7115,6535,580,8.2,"Holmes County, FL"
9,2013,Oct,6978,6441,537,7.7,"Holmes County, FL"
10,2013,Nov,6826,6290,536,7.9,"Holmes County, FL"
11,2013,Dec,6824,6316,508,7.4,"Holmes County, FL"
12,2014,Jan,6813,6283,530,7.8,"Holmes County, FL"
13,2014,Feb,6865,6354,511,7.4,"Holmes County, FL"
14,2014,Mar,6898,6405,493,7.1,"Holmes County, FL"
15,2014,Apr,6821,6385,436,6.4,"Holmes County, FL"
16,2014,May,6930,6449,481,6.9,"Holmes County, FL"
17,2014,Jun,6893,6374,519,7.5,"Holmes County, FL"
18,2014,Jul,6903,6350,553,8.0,"Holmes County, FL"
19,2014,Aug,6862,6343,519,7.6,"Holmes County, FL"
20,2014,Sep,6908,6437,471,6.8,"Holmes County, FL"
21,2014,Oct,6867,6399,468,6.8,"Holmes County, FL"
22,2014,Nov,6738,6268,470,7.0,"Holmes County, FL"
23,2014,Dec,6725,6281,444,6.6,"Holmes County, FL"
24,2015,Jan,6716,6232,484,7.2,"Holmes County, FL"
25,2015,Feb,6664,6225,439,6.6,"Holmes County, FL"
26,2015,Mar,6696,6279,417,6.2,"Holmes County, FL"
27,2015,Apr,6763,6355,408,6.0,"Holmes County, FL"
28,2015,May,6906,6469,437,6.3,"Holmes County, FL"
29,2015,Jun,6740,6297,443,6.6,"Holmes County, FL"
30,2015,Jul,6683,6231,452,6.8,"Holmes County, FL"
31,2015,Aug,6631,6216,415,6.3,"Holmes County, FL"
32,2015,Sep,6763,6370,393,5.8,"Holmes County, FL"
33,2015,Oct,6778,6394,384,5.7,"Holmes County, FL"
34,2015,Nov,6632,6255,377,5.7,"Holmes County, FL"
35,2015,Dec,6638,6285,353,5.3,"Holmes County, FL"
36,2016,Jan,6596,6214,382,5.8,"Holmes County, FL"
37,2016,Feb,6672,6321,351,5.3,"Holmes County, FL"
38,2016,Mar,6781,6426,355,5.2,"Holmes County, FL"
39,2016,Apr,6759,6419,340,5.0,"Holmes County, FL"
40,2016,May,6867,6530,337,4.9,"Holmes County, FL"
41,2016,Jun,6775,6383,392,5.8,"Holmes County, FL"
42,2016,Jul,6716,6329,387,5.8,"Holmes County, FL"
43,2016,Aug,6694,6304,390,5.8,"Holmes County, FL"
44,2016,Sep,6848,6464,384,5.6,"Holmes County, FL"
45,2016,Oct,6763,6386,377,5.6,"Holmes County, FL"
46,2016,Nov,6664,6298,366,5.5,"Holmes County, FL"
47,2016,Dec,6675,6329,346,5.2,"Holmes County, FL"
48,2017,Jan,6708,6323,385,5.7,"Holmes County, FL"
49,2017,Feb,6794,6438,356,5.2,"Holmes County, FL"
50,2017,Mar,6815,6503,312,4.6,"Holmes County, FL"
51,2017,Apr,6822,6526,296,4.3,"Holmes County, FL"
52,2017,May,6893,6583,310,4.5,"Holmes County, FL"
53,2017,Jun,6889,6535,354,5.1,"Holmes County, FL"
54,2017,Jul,6719,6356,363,5.4,"Holmes County, FL"
55,2017,Aug,6783,6436,347,5.1,"Holmes County, FL"
56,2017,Sep,7091,6763,328,4.6,"Holmes County, FL"
57,2017,Oct,6894,6586,308,4.5,"Holmes County, FL"
58,2017,Nov,6821,6513,308,4.5,"Holmes County, FL"
59,2017,Dec,6821,6526,295,4.3,"Holmes County, FL"
60,2018,Jan,6819,6500,319,4.7,"Holmes County, FL"
61,2018,Feb,6858,6573,285,4.2,"Holmes County, FL"
62,2018,Mar,6908,6629,279,4.0,"Holmes County, FL"
63,2018,Apr,6861,6608,253,3.7,"Holmes County, FL"
64,2018,May,6930,6678,252,3.6,"Holmes County, FL"
65,2018,Jun,6944,6640,304,4.4,"Holmes County, FL"
66,2018,Jul,6683,6381,302,4.5,"Holmes County, FL"
67,2018,Aug,6742,6464,278,4.1,"Holmes County, FL"
68,2018,Sep,6928,6677,251,3.6,"Holmes County, FL"
69,2018,Oct,6844,6585,259,3.8,"Holmes County, FL"
70,2018,Nov,6778,6505,273,4.0,"Holmes County, FL"
71,2018,Dec,6796,6529,267,3.9,"Holmes County, FL"
72,2019,Jan,6770,6464,306,4.5,"Holmes County, FL"
73,2019,Feb,6819,6562,257,3.8,"Holmes County, FL"
74,2019,Mar,6858,6614,244,3.6,"Holmes County, FL"
75,2019,Apr,6857,6632,225,3.3,"Holmes County, FL"
76,2019,May,6964,6727,237,3.4,"Holmes County, FL"
77,2019,Jun,6957,6688,269,3.9,"Holmes County, FL"
78,2019,Jul,6769,6493,276,4.1,"Holmes County, FL"
79,2019,Aug,7011,6751,260,3.7,"Holmes County, FL"
80,2019,Sep,7076,6831,245,3.5,"Holmes County, FL"
81,2019,Oct,7011,6776,235,3.4,"Holmes County, FL"
82,2019,Nov,6873,6647,226,3.3,"Holmes County, FL"
83,2019,Dec,6882,6667,215,3.1,"Holmes County, FL"
84,2020,Jan,6935,6670,265,3.8,"Holmes County, FL"
85,2020,Feb,6881,6660,221,3.2,"Holmes County, FL"
86,2020,Mar,6810,6498,312,4.6,"Holmes County, FL"
87,2020,Apr,6379,5901,478,7.5,"Holmes County, FL"
88,2020,May,6750,6190,560,8.3,"Holmes County, FL"
89,2020,Jun,6737,6241,496,7.4,"Holmes County, FL"
90,2020,Jul,6792,6188,604,8.9,"Holmes County, FL"
91,2020,Aug,6941,6535,406,5.8,"Holmes County, FL"
92,2020,Sep,6968,6579,389,5.6,"Holmes County, FL"
93,2020,Oct,6993,6644,349,5.0,"Holmes County, FL"
94,2020,Nov,6857,6515,342,5.0,"Holmes County, FL"
95,2020,Dec,6864,6528,336,4.9,"Holmes County, FL"
96,2021,Jan,6777,6439,338,5.0,"Holmes County, FL"
97,2021,Feb,6839,6504,335,4.9,"Holmes County, FL"
98,2021,Mar,6932,6629,303,4.4,"Holmes County, FL"
99,2021,Apr,6919,6644,275,4.0,"Holmes County, FL"
100,2021,May,6953,6691,262,3.8,"Holmes County, FL"
101,2021,Jun,6955,6619,336,4.8,"Holmes County, FL"
102,2021,Jul,6964,6637,327,4.7,"Holmes County, FL"
103,2021,Aug,7007,6700,307,4.4,"Holmes County, FL"
104,2021,Sep,6994,6726,268,3.8,"Holmes County, FL"
105,2021,Oct,6951,6679,272,3.9,"Holmes County, FL"
106,2021,Nov,6902,6655,247,3.6,"Holmes County, FL"
107,2021,Dec,6912,6697,215,3.1,"Holmes County, FL"
108,2022,Jan,6984,6697,287,4.1,"Holmes County, FL"
109,2022,Feb,6964,6725,239,3.4,"Holmes County, FL"
110,2022,Mar,7025,6809,216,3.1,"Holmes County, FL"
111,2022,Apr,6965,6772,193,2.8,"Holmes County, FL"
112,2022,May,7060,6855,205,2.9,"Holmes County, FL"
113,2022,Jun,7020,6775,245,3.5,"Holmes County, FL"
114,2022,Jul,7027,6799,228,3.2,"Holmes County, FL"
115,2022,Aug,7103,6883,220,3.1,"Holmes County, FL"
116,2022,Sep,7122,6922,200,2.8,"Holmes County, FL"
117,2022,Oct,7094,6897,197,2.8,"Holmes County, FL"
118,2022,Nov,6998,6804,194,2.8,"Holmes County, FL"
119,2022,Dec,7052,6886,166,2.4,"Holmes County, FL"
120,2023,Jan,7060,6855,205,2.9,"Holmes County, FL"
121,2023,Feb,7099,6897,202,2.8,"Holmes County, FL"
122,2023,Mar,7168,6969,199,2.8,"Holmes County, FL"
123,2023,Apr,7199,7028,171,2.4,"Holmes County, FL"
124,2023,May,7248,7046,202,2.8,"Holmes County, FL"
125,2023,Jun,7290,7051,239,3.3,"Holmes County, FL"
126,2023,Jul,7276,7019,257,3.5,"Holmes County, FL"
127,2023,Aug,7432,7183,249,3.4,"Holmes County, FL"
128,2023,Sep,7441,7191,250,3.4,"Holmes County, FL"
129,2023,Oct,7427,7174,253,3.4,"Holmes County, FL"
0,2013,Jan,245969,224742,21227,8.6,"Sonoma County, CA"
1,2013,Feb,245870,225989,19881,8.1,"Sonoma County, CA"
2,2013,Mar,245348,226199,19149,7.8,"Sonoma County, CA"
3,2013,Apr,245194,227741,17453,7.1,"Sonoma County, CA"
4,2013,May,247928,230831,17097,6.9,"Sonoma County, CA"
5,2013,Jun,249191,230370,18821,7.6,"Sonoma County, CA"
6,2013,Jul,250567,231588,18979,7.6,"Sonoma County, CA"
7,2013,Aug,250508,232861,17647,7.0,"Sonoma County, CA"
8,2013,Sep,252350,235594,16756,6.6,"Sonoma County, CA"
9,2013,Oct,252837,236169,16668,6.6,"Sonoma County, CA"
10,2013,Nov,252049,235901,16148,6.4,"Sonoma County, CA"
11,2013,Dec,250418,235152,15266,6.1,"Sonoma County, CA"
12,2014,Jan,251181,234836,16345,6.5,"Sonoma County, CA"
13,2014,Feb,252185,235761,16424,6.5,"Sonoma County, CA"
14,2014,Mar,252717,236372,16345,6.5,"Sonoma County, CA"
15,2014,Apr,254075,240296,13779,5.4,"Sonoma County, CA"
16,2014,May,256020,242295,13725,5.4,"Sonoma County, CA"
17,2014,Jun,256414,241671,14743,5.7,"Sonoma County, CA"
18,2014,Jul,258319,242769,15550,6.0,"Sonoma County, CA"
19,2014,Aug,257087,242328,14759,5.7,"Sonoma County, CA"
20,2014,Sep,259042,245644,13398,5.2,"Sonoma County, CA"
21,2014,Oct,259762,246435,13327,5.1,"Sonoma County, CA"
22,2014,Nov,256388,243056,13332,5.2,"Sonoma County, CA"
23,2014,Dec,253569,241117,12452,4.9,"Sonoma County, CA"
24,2015,Jan,255200,241581,13619,5.3,"Sonoma County, CA"
25,2015,Feb,256211,243322,12889,5.0,"Sonoma County, CA"
26,2015,Mar,256635,244066,12569,4.9,"Sonoma County, CA"
27,2015,Apr,256565,245301,11264,4.4,"Sonoma County, CA"
28,2015,May,258865,247731,11134,4.3,"Sonoma County, CA"
29,2015,Jun,257984,246051,11933,4.6,"Sonoma County, CA"
30,2015,Jul,259582,247295,12287,4.7,"Sonoma County, CA"
31,2015,Aug,259135,247785,11350,4.4,"Sonoma County, CA"
32,2015,Sep,259907,249523,10384,4.0,"Sonoma County, CA"
33,2015,Oct,258485,247752,10733,4.2,"Sonoma County, CA"
34,2015,Nov,256737,245874,10863,4.2,"Sonoma County, CA"
35,2015,Dec,256594,246049,10545,4.1,"Sonoma County, CA"
36,2016,Jan,256251,244801,11450,4.5,"Sonoma County, CA"
37,2016,Feb,258596,247528,11068,4.3,"Sonoma County, CA"
38,2016,Mar,259278,247966,11312,4.4,"Sonoma County, CA"
39,2016,Apr,257932,247952,9980,3.9,"Sonoma County, CA"
40,2016,May,259263,250200,9063,3.5,"Sonoma County, CA"
41,2016,Jun,259274,248571,10703,4.1,"Sonoma County, CA"
42,2016,Jul,260098,249017,11081,4.3,"Sonoma County, CA"
43,2016,Aug,260752,250305,10447,4.0,"Sonoma County, CA"
44,2016,Sep,262593,252738,9855,3.8,"Sonoma County, CA"
45,2016,Oct,260477,250550,9927,3.8,"Sonoma County, CA"
46,2016,Nov,258053,248472,9581,3.7,"Sonoma County, CA"
47,2016,Dec,257997,248409,9588,3.7,"Sonoma County, CA"
48,2017,Jan,257536,246757,10779,4.2,"Sonoma County, CA"
49,2017,Feb,259449,249281,10168,3.9,"Sonoma County, CA"
50,2017,Mar,260053,250591,9462,3.6,"Sonoma County, CA"
51,2017,Apr,258928,250345,8583,3.3,"Sonoma County, CA"
52,2017,May,260150,252166,7984,3.1,"Sonoma County, CA"
53,2017,Jun,260092,250916,9176,3.5,"Sonoma County, CA"
54,2017,Jul,261423,251846,9577,3.7,"Sonoma County, CA"
55,2017,Aug,261821,252655,9166,3.5,"Sonoma County, CA"
56,2017,Sep,264324,256517,7807,3.0,"Sonoma County, CA"
57,2017,Oct,257625,249678,7947,3.1,"Sonoma County, CA"
58,2017,Nov,257697,249865,7832,3.0,"Sonoma County, CA"
59,2017,Dec,258114,250564,7550,2.9,"Sonoma County, CA"
60,2018,Jan,257290,248845,8445,3.3,"Sonoma County, CA"
61,2018,Feb,260359,252388,7971,3.1,"Sonoma County, CA"
62,2018,Mar,259551,251929,7622,2.9,"Sonoma County, CA"
63,2018,Apr,258910,251999,6911,2.7,"Sonoma County, CA"
64,2018,May,261212,255017,6195,2.4,"Sonoma County, CA"
65,2018,Jun,260161,252444,7717,3.0,"Sonoma County, CA"
66,2018,Jul,262312,254719,7593,2.9,"Sonoma County, CA"
67,2018,Aug,261498,254156,7342,2.8,"Sonoma County, CA"
68,2018,Sep,263556,256908,6648,2.5,"Sonoma County, CA"
69,2018,Oct,263027,256251,6776,2.6,"Sonoma County, CA"
70,2018,Nov,260440,253738,6702,2.6,"Sonoma County, CA"
71,2018,Dec,259291,252249,7042,2.7,"Sonoma County, CA"
72,2019,Jan,256220,247477,8743,3.4,"Sonoma County, CA"
73,2019,Feb,257703,249914,7789,3.0,"Sonoma County, CA"
74,2019,Mar,257844,249989,7855,3.0,"Sonoma County, CA"
75,2019,Apr,254295,247886,6409,2.5,"Sonoma County, CA"
76,2019,May,256051,250028,6023,2.4,"Sonoma County, CA"
77,2019,Jun,255405,248245,7160,2.8,"Sonoma County, CA"
78,2019,Jul,259202,251627,7575,2.9,"Sonoma County, CA"
79,2019,Aug,259377,252280,7097,2.7,"Sonoma County, CA"
80,2019,Sep,261587,255511,6076,2.3,"Sonoma County, CA"
81,2019,Oct,260742,254401,6341,2.4,"Sonoma County, CA"
82,2019,Nov,257136,250621,6515,2.5,"Sonoma County, CA"
83,2019,Dec,256583,250171,6412,2.5,"Sonoma County, CA"
84,2020,Jan,255503,247818,7685,3.0,"Sonoma County, CA"
85,2020,Feb,258512,251265,7247,2.8,"Sonoma County, CA"
86,2020,Mar,254905,244269,10636,4.2,"Sonoma County, CA"
87,2020,Apr,242628,204582,38046,15.7,"Sonoma County, CA"
88,2020,May,238800,205939,32861,13.8,"Sonoma County, CA"
89,2020,Jun,247319,219195,28124,11.4,"Sonoma County, CA"
90,2020,Jul,246706,221732,24974,10.1,"Sonoma County, CA"
91,2020,Aug,245295,224995,20300,8.3,"Sonoma County, CA"
92,2020,Sep,244821,225854,18967,7.7,"Sonoma County, CA"
93,2020,Oct,241891,225252,16639,6.9,"Sonoma County, CA"
94,2020,Nov,239118,223033,16085,6.7,"Sonoma County, CA"
95,2020,Dec,239087,223047,16040,6.7,"Sonoma County, CA"
96,2021,Jan,237847,220025,17822,7.5,"Sonoma County, CA"
97,2021,Feb,240869,224251,16618,6.9,"Sonoma County, CA"
98,2021,Mar,242110,226360,15750,6.5,"Sonoma County, CA"
99,2021,Apr,240801,225911,14890,6.2,"Sonoma County, CA"
100,2021,May,242286,228814,13472,5.6,"Sonoma County, CA"
101,2021,Jun,243375,228370,15005,6.2,"Sonoma County, CA"
102,2021,Jul,246442,232250,14192,5.8,"Sonoma County, CA"
103,2021,Aug,246516,233129,13387,5.4,"Sonoma County, CA"
104,2021,Sep,248080,236825,11255,4.5,"Sonoma County, CA"
105,2021,Oct,246271,235458,10813,4.4,"Sonoma County, CA"
106,2021,Nov,245022,235165,9857,4.0,"Sonoma County, CA"
107,2021,Dec,244531,235460,9071,3.7,"Sonoma County, CA"
108,2022,Jan,243986,233548,10438,4.3,"Sonoma County, CA"
109,2022,Feb,246352,237137,9215,3.7,"Sonoma County, CA"
110,2022,Mar,248267,239971,8296,3.3,"Sonoma County, CA"
111,2022,Apr,245769,238632,7137,2.9,"Sonoma County, CA"
112,2022,May,247569,241054,6515,2.6,"Sonoma County, CA"
113,2022,Jun,248603,240941,7662,3.1,"Sonoma County, CA"
114,2022,Jul,248844,241253,7591,3.1,"Sonoma County, CA"
115,2022,Aug,250255,242515,7740,3.1,"Sonoma County, CA"
116,2022,Sep,251465,244637,6828,2.7,"Sonoma County, CA"
117,2022,Oct,249860,242627,7233,2.9,"Sonoma County, CA"
118,2022,Nov,249031,241494,7537,3.0,"Sonoma County, CA"
119,2022,Dec,249325,242301,7024,2.8,"Sonoma County, CA"
120,2023,Jan,248585,239658,8927,3.6,"Sonoma County, CA"
121,2023,Feb,251325,242236,9089,3.6,"Sonoma County, CA"
122,2023,Mar,251143,242012,9131,3.6,"Sonoma County, CA"
123,2023,Apr,249198,241286,7912,3.2,"Sonoma County, CA"
124,2023,May,248549,240242,8307,3.3,"Sonoma County, CA"
125,2023,Jun,248087,238820,9267,3.7,"Sonoma County, CA"
126,2023,Jul,249592,240437,9155,3.7,"Sonoma County, CA"
127,2023,Aug,251836,242250,9586,3.8,"Sonoma County, CA"
128,2023,Sep,253822,244795,9027,3.6,"Sonoma County, CA"
129,2023,Oct,251966,242843,9123,3.6,"Sonoma County, CA"
0,2013,Jan,1441,1200,241,16.7,"Sierra County, CA"
1,2013,Feb,1407,1170,237,16.8,"Sierra County, CA"
2,2013,Mar,1405,1170,235,16.7,"Sierra County, CA"
3,2013,Apr,1409,1201,208,14.8,"Sierra County, CA"
4,2013,May,1435,1253,182,12.7,"Sierra County, CA"
5,2013,Jun,1518,1338,180,11.9,"Sierra County, CA"
6,2013,Jul,1494,1323,171,11.4,"Sierra County, CA"
7,2013,Aug,1488,1326,162,10.9,"Sierra County, CA"
8,2013,Sep,1464,1320,144,9.8,"Sierra County, CA"
9,2013,Oct,1476,1324,152,10.3,"Sierra County, CA"
10,2013,Nov,1411,1251,160,11.3,"Sierra County, CA"
11,2013,Dec,1422,1251,171,12.0,"Sierra County, CA"
12,2014,Jan,1416,1231,185,13.1,"Sierra County, CA"
13,2014,Feb,1429,1234,195,13.6,"Sierra County, CA"
14,2014,Mar,1423,1230,193,13.6,"Sierra County, CA"
15,2014,Apr,1386,1226,160,11.5,"Sierra County, CA"
16,2014,May,1426,1286,140,9.8,"Sierra County, CA"
17,2014,Jun,1479,1351,128,8.7,"Sierra County, CA"
18,2014,Jul,1429,1304,125,8.7,"Sierra County, CA"
19,2014,Aug,1419,1296,123,8.7,"Sierra County, CA"
20,2014,Sep,1423,1311,112,7.9,"Sierra County, CA"
21,2014,Oct,1413,1301,112,7.9,"Sierra County, CA"
22,2014,Nov,1342,1226,116,8.6,"Sierra County, CA"
23,2014,Dec,1338,1200,138,10.3,"Sierra County, CA"
24,2015,Jan,1375,1211,164,11.9,"Sierra County, CA"
25,2015,Feb,1326,1164,162,12.2,"Sierra County, CA"
26,2015,Mar,1308,1149,159,12.2,"Sierra County, CA"
27,2015,Apr,1341,1215,126,9.4,"Sierra County, CA"
28,2015,May,1398,1278,120,8.6,"Sierra County, CA"
29,2015,Jun,1413,1298,115,8.1,"Sierra County, CA"
30,2015,Jul,1369,1261,108,7.9,"Sierra County, CA"
31,2015,Aug,1360,1262,98,7.2,"Sierra County, CA"
32,2015,Sep,1399,1311,88,6.3,"Sierra County, CA"
33,2015,Oct,1392,1304,88,6.3,"Sierra County, CA"
34,2015,Nov,1317,1222,95,7.2,"Sierra County, CA"
35,2015,Dec,1339,1228,111,8.3,"Sierra County, CA"
36,2016,Jan,1315,1187,128,9.7,"Sierra County, CA"
37,2016,Feb,1321,1192,129,9.8,"Sierra County, CA"
38,2016,Mar,1342,1211,131,9.8,"Sierra County, CA"
39,2016,Apr,1308,1200,108,8.3,"Sierra County, CA"
40,2016,May,1320,1231,89,6.7,"Sierra County, CA"
41,2016,Jun,1385,1286,99,7.1,"Sierra County, CA"
42,2016,Jul,1351,1258,93,6.9,"Sierra County, CA"
43,2016,Aug,1332,1247,85,6.4,"Sierra County, CA"
44,2016,Sep,1385,1301,84,6.1,"Sierra County, CA"
45,2016,Oct,1357,1274,83,6.1,"Sierra County, CA"
46,2016,Nov,1299,1217,82,6.3,"Sierra County, CA"
47,2016,Dec,1290,1182,108,8.4,"Sierra County, CA"
48,2017,Jan,1281,1164,117,9.1,"Sierra County, CA"
49,2017,Feb,1285,1167,118,9.2,"Sierra County, CA"
50,2017,Mar,1288,1176,112,8.7,"Sierra County, CA"
51,2017,Apr,1255,1158,97,7.7,"Sierra County, CA"
52,2017,May,1295,1219,76,5.9,"Sierra County, CA"
53,2017,Jun,1315,1243,72,5.5,"Sierra County, CA"
54,2017,Jul,1308,1229,79,6.0,"Sierra County, CA"
55,2017,Aug,1307,1232,75,5.7,"Sierra County, CA"
56,2017,Sep,1330,1262,68,5.1,"Sierra County, CA"
57,2017,Oct,1309,1244,65,5.0,"Sierra County, CA"
58,2017,Nov,1249,1185,64,5.1,"Sierra County, CA"
59,2017,Dec,1245,1173,72,5.8,"Sierra County, CA"
60,2018,Jan,1231,1139,92,7.5,"Sierra County, CA"
61,2018,Feb,1257,1149,108,8.6,"Sierra County, CA"
62,2018,Mar,1260,1160,100,7.9,"Sierra County, CA"
63,2018,Apr,1229,1147,82,6.7,"Sierra County, CA"
64,2018,May,1294,1230,64,4.9,"Sierra County, CA"
65,2018,Jun,1332,1260,72,5.4,"Sierra County, CA"
66,2018,Jul,1286,1215,71,5.5,"Sierra County, CA"
67,2018,Aug,1282,1212,70,5.5,"Sierra County, CA"
68,2018,Sep,1312,1248,64,4.9,"Sierra County, CA"
69,2018,Oct,1328,1262,66,5.0,"Sierra County, CA"
70,2018,Nov,1256,1190,66,5.3,"Sierra County, CA"
71,2018,Dec,1256,1184,72,5.7,"Sierra County, CA"
72,2019,Jan,1255,1160,95,7.6,"Sierra County, CA"
73,2019,Feb,1273,1176,97,7.6,"Sierra County, CA"
74,2019,Mar,1285,1187,98,7.6,"Sierra County, CA"
75,2019,Apr,1268,1188,80,6.3,"Sierra County, CA"
76,2019,May,1329,1264,65,4.9,"Sierra County, CA"
77,2019,Jun,1353,1287,66,4.9,"Sierra County, CA"
78,2019,Jul,1378,1311,67,4.9,"Sierra County, CA"
79,2019,Aug,1352,1292,60,4.4,"Sierra County, CA"
80,2019,Sep,1398,1345,53,3.8,"Sierra County, CA"
81,2019,Oct,1377,1321,56,4.1,"Sierra County, CA"
82,2019,Nov,1347,1291,56,4.2,"Sierra County, CA"
83,2019,Dec,1345,1281,64,4.8,"Sierra County, CA"
84,2020,Jan,1307,1225,82,6.3,"Sierra County, CA"
85,2020,Feb,1318,1228,90,6.8,"Sierra County, CA"
86,2020,Mar,1319,1192,127,9.6,"Sierra County, CA"
87,2020,Apr,1219,1041,178,14.6,"Sierra County, CA"
88,2020,May,1230,1086,144,11.7,"Sierra County, CA"
89,2020,Jun,1312,1189,123,9.4,"Sierra County, CA"
90,2020,Jul,1274,1163,111,8.7,"Sierra County, CA"
91,2020,Aug,1297,1202,95,7.3,"Sierra County, CA"
92,2020,Sep,1327,1241,86,6.5,"Sierra County, CA"
93,2020,Oct,1338,1265,73,5.5,"Sierra County, CA"
94,2020,Nov,1264,1187,77,6.1,"Sierra County, CA"
95,2020,Dec,1254,1160,94,7.5,"Sierra County, CA"
96,2021,Jan,1250,1142,108,8.6,"Sierra County, CA"
97,2021,Feb,1265,1153,112,8.9,"Sierra County, CA"
98,2021,Mar,1275,1168,107,8.4,"Sierra County, CA"
99,2021,Apr,1295,1204,91,7.0,"Sierra County, CA"
100,2021,May,1345,1275,70,5.2,"Sierra County, CA"
101,2021,Jun,1420,1345,75,5.3,"Sierra County, CA"
102,2021,Jul,1370,1297,73,5.3,"Sierra County, CA"
103,2021,Aug,1340,1266,74,5.5,"Sierra County, CA"
104,2021,Sep,1339,1277,62,4.6,"Sierra County, CA"
105,2021,Oct,1305,1243,62,4.8,"Sierra County, CA"
106,2021,Nov,1247,1184,63,5.1,"Sierra County, CA"
107,2021,Dec,1241,1180,61,4.9,"Sierra County, CA"
108,2022,Jan,1264,1184,80,6.3,"Sierra County, CA"
109,2022,Feb,1301,1217,84,6.5,"Sierra County, CA"
110,2022,Mar,1288,1214,74,5.7,"Sierra County, CA"
111,2022,Apr,1263,1204,59,4.7,"Sierra County, CA"
112,2022,May,1307,1262,45,3.4,"Sierra County, CA"
113,2022,Jun,1387,1338,49,3.5,"Sierra County, CA"
114,2022,Jul,1367,1322,45,3.3,"Sierra County, CA"
115,2022,Aug,1380,1333,47,3.4,"Sierra County, CA"
116,2022,Sep,1368,1331,37,2.7,"Sierra County, CA"
117,2022,Oct,1348,1309,39,2.9,"Sierra County, CA"
118,2022,Nov,1280,1235,45,3.5,"Sierra County, CA"
119,2022,Dec,1286,1233,53,4.1,"Sierra County, CA"
120,2023,Jan,1264,1189,75,5.9,"Sierra County, CA"
121,2023,Feb,1279,1200,79,6.2,"Sierra County, CA"
122,2023,Mar,1295,1209,86,6.6,"Sierra County, CA"
123,2023,Apr,1270,1196,74,5.8,"Sierra County, CA"
124,2023,May,1321,1262,59,4.5,"Sierra County, CA"
125,2023,Jun,1380,1322,58,4.2,"Sierra County, CA"
126,2023,Jul,1364,1310,54,4.0,"Sierra County, CA"
127,2023,Aug,1351,1294,57,4.2,"Sierra County, CA"
128,2023,Sep,1358,1308,50,3.7,"Sierra County, CA"
129,2023,Oct,1345,1293,52,3.9,"Sierra County, CA"
0,2013,Jan,49783,44048,5735,11.5,"Citrus County, FL"
1,2013,Feb,49788,44591,5197,10.4,"Citrus County, FL"
2,2013,Mar,49727,44805,4922,9.9,"Citrus County, FL"
3,2013,Apr,49425,44657,4768,9.6,"Citrus County, FL"
4,2013,May,49968,44952,5016,10.0,"Citrus County, FL"
5,2013,Jun,49919,44662,5257,10.5,"Citrus County, FL"
6,2013,Jul,48691,43498,5193,10.7,"Citrus County, FL"
7,2013,Aug,49417,44351,5066,10.3,"Citrus County, FL"
8,2013,Sep,49593,44751,4842,9.8,"Citrus County, FL"
9,2013,Oct,49045,44287,4758,9.7,"Citrus County, FL"
10,2013,Nov,48264,43660,4604,9.5,"Citrus County, FL"
11,2013,Dec,48002,43610,4392,9.1,"Citrus County, FL"
12,2014,Jan,47807,43091,4716,9.9,"Citrus County, FL"
13,2014,Feb,48006,43448,4558,9.5,"Citrus County, FL"
14,2014,Mar,48971,44548,4423,9.0,"Citrus County, FL"
15,2014,Apr,48329,44349,3980,8.2,"Citrus County, FL"
16,2014,May,48905,44633,4272,8.7,"Citrus County, FL"
17,2014,Jun,48618,44310,4308,8.9,"Citrus County, FL"
18,2014,Jul,47807,43315,4492,9.4,"Citrus County, FL"
19,2014,Aug,48298,43927,4371,9.1,"Citrus County, FL"
20,2014,Sep,48369,44335,4034,8.3,"Citrus County, FL"
21,2014,Oct,48227,44299,3928,8.1,"Citrus County, FL"
22,2014,Nov,47631,43703,3928,8.2,"Citrus County, FL"
23,2014,Dec,47264,43458,3806,8.1,"Citrus County, FL"
24,2015,Jan,47277,43137,4140,8.8,"Citrus County, FL"
25,2015,Feb,47117,43256,3861,8.2,"Citrus County, FL"
26,2015,Mar,47848,44223,3625,7.6,"Citrus County, FL"
27,2015,Apr,48051,44542,3509,7.3,"Citrus County, FL"
28,2015,May,48589,44844,3745,7.7,"Citrus County, FL"
29,2015,Jun,48647,44855,3792,7.8,"Citrus County, FL"
30,2015,Jul,47484,43613,3871,8.2,"Citrus County, FL"
31,2015,Aug,48151,44468,3683,7.6,"Citrus County, FL"
32,2015,Sep,48164,44765,3399,7.1,"Citrus County, FL"
33,2015,Oct,48580,45180,3400,7.0,"Citrus County, FL"
34,2015,Nov,48090,44724,3366,7.0,"Citrus County, FL"
35,2015,Dec,48072,44763,3309,6.9,"Citrus County, FL"
36,2016,Jan,47986,44449,3537,7.4,"Citrus County, FL"
37,2016,Feb,48029,44739,3290,6.9,"Citrus County, FL"
38,2016,Mar,48460,45246,3214,6.6,"Citrus County, FL"
39,2016,Apr,48160,45060,3100,6.4,"Citrus County, FL"
40,2016,May,48394,45335,3059,6.3,"Citrus County, FL"
41,2016,Jun,48414,45062,3352,6.9,"Citrus County, FL"
42,2016,Jul,47293,43851,3442,7.3,"Citrus County, FL"
43,2016,Aug,48097,44684,3413,7.1,"Citrus County, FL"
44,2016,Sep,48255,44937,3318,6.9,"Citrus County, FL"
45,2016,Oct,48119,44925,3194,6.6,"Citrus County, FL"
46,2016,Nov,47556,44443,3113,6.5,"Citrus County, FL"
47,2016,Dec,47309,44249,3060,6.5,"Citrus County, FL"
48,2017,Jan,47061,43737,3324,7.1,"Citrus County, FL"
49,2017,Feb,47556,44507,3049,6.4,"Citrus County, FL"
50,2017,Mar,47687,44891,2796,5.9,"Citrus County, FL"
51,2017,Apr,48148,45513,2635,5.5,"Citrus County, FL"
52,2017,May,48264,45523,2741,5.7,"Citrus County, FL"
53,2017,Jun,48272,45361,2911,6.0,"Citrus County, FL"
54,2017,Jul,46980,44001,2979,6.3,"Citrus County, FL"
55,2017,Aug,47613,44631,2982,6.3,"Citrus County, FL"
56,2017,Sep,47680,44975,2705,5.7,"Citrus County, FL"
57,2017,Oct,47143,44512,2631,5.6,"Citrus County, FL"
58,2017,Nov,46812,44172,2640,5.6,"Citrus County, FL"
59,2017,Dec,46761,44119,2642,5.7,"Citrus County, FL"
60,2018,Jan,47007,44142,2865,6.1,"Citrus County, FL"
61,2018,Feb,47155,44513,2642,5.6,"Citrus County, FL"
62,2018,Mar,47278,44784,2494,5.3,"Citrus County, FL"
63,2018,Apr,47237,44929,2308,4.9,"Citrus County, FL"
64,2018,May,47546,45192,2354,5.0,"Citrus County, FL"
65,2018,Jun,47912,45129,2783,5.8,"Citrus County, FL"
66,2018,Jul,46584,43923,2661,5.7,"Citrus County, FL"
67,2018,Aug,47159,44518,2641,5.6,"Citrus County, FL"
68,2018,Sep,47551,45131,2420,5.1,"Citrus County, FL"
69,2018,Oct,47354,44921,2433,5.1,"Citrus County, FL"
70,2018,Nov,46809,44454,2355,5.0,"Citrus County, FL"
71,2018,Dec,46863,44484,2379,5.1,"Citrus County, FL"
72,2019,Jan,47071,44326,2745,5.8,"Citrus County, FL"
73,2019,Feb,47246,44827,2419,5.1,"Citrus County, FL"
74,2019,Mar,47296,44969,2327,4.9,"Citrus County, FL"
75,2019,Apr,46770,44684,2086,4.5,"Citrus County, FL"
76,2019,May,47167,44938,2229,4.7,"Citrus County, FL"
77,2019,Jun,47555,45049,2506,5.3,"Citrus County, FL"
78,2019,Jul,46575,44020,2555,5.5,"Citrus County, FL"
79,2019,Aug,47407,44861,2546,5.4,"Citrus County, FL"
80,2019,Sep,47545,45293,2252,4.7,"Citrus County, FL"
81,2019,Oct,47030,44852,2178,4.6,"Citrus County, FL"
82,2019,Nov,46495,44341,2154,4.6,"Citrus County, FL"
83,2019,Dec,46673,44653,2020,4.3,"Citrus County, FL"
84,2020,Jan,46941,44557,2384,5.1,"Citrus County, FL"
85,2020,Feb,46803,44730,2073,4.4,"Citrus County, FL"
86,2020,Mar,46648,43698,2950,6.3,"Citrus County, FL"
87,2020,Apr,43248,37146,6102,14.1,"Citrus County, FL"
88,2020,May,46725,40228,6497,13.9,"Citrus County, FL"
89,2020,Jun,46852,41562,5290,11.3,"Citrus County, FL"
90,2020,Jul,46799,40920,5879,12.6,"Citrus County, FL"
91,2020,Aug,47089,42912,4177,8.9,"Citrus County, FL"
92,2020,Sep,47383,43361,4022,8.5,"Citrus County, FL"
93,2020,Oct,47295,43784,3511,7.4,"Citrus County, FL"
94,2020,Nov,46836,43493,3343,7.1,"Citrus County, FL"
95,2020,Dec,46873,43554,3319,7.1,"Citrus County, FL"
96,2021,Jan,47029,43768,3261,6.9,"Citrus County, FL"
97,2021,Feb,47343,44295,3048,6.4,"Citrus County, FL"
98,2021,Mar,47586,44620,2966,6.2,"Citrus County, FL"
99,2021,Apr,47297,44608,2689,5.7,"Citrus County, FL"
100,2021,May,47778,45126,2652,5.6,"Citrus County, FL"
101,2021,Jun,48207,45095,3112,6.5,"Citrus County, FL"
102,2021,Jul,47354,44398,2956,6.2,"Citrus County, FL"
103,2021,Aug,47989,45071,2918,6.1,"Citrus County, FL"
104,2021,Sep,47903,45372,2531,5.3,"Citrus County, FL"
105,2021,Oct,48004,45624,2380,5.0,"Citrus County, FL"
106,2021,Nov,47711,45388,2323,4.9,"Citrus County, FL"
107,2021,Dec,47722,45642,2080,4.4,"Citrus County, FL"
108,2022,Jan,48660,46033,2627,5.4,"Citrus County, FL"
109,2022,Feb,48704,46458,2246,4.6,"Citrus County, FL"
110,2022,Mar,48958,46950,2008,4.1,"Citrus County, FL"
111,2022,Apr,49045,47270,1775,3.6,"Citrus County, FL"
112,2022,May,49772,47902,1870,3.8,"Citrus County, FL"
113,2022,Jun,49718,47508,2210,4.4,"Citrus County, FL"
114,2022,Jul,48634,46554,2080,4.3,"Citrus County, FL"
115,2022,Aug,49701,47543,2158,4.3,"Citrus County, FL"
116,2022,Sep,49962,47968,1994,4.0,"Citrus County, FL"
117,2022,Oct,49736,47810,1926,3.9,"Citrus County, FL"
118,2022,Nov,49310,47426,1884,3.8,"Citrus County, FL"
119,2022,Dec,49489,47804,1685,3.4,"Citrus County, FL"
120,2023,Jan,49394,47458,1936,3.9,"Citrus County, FL"
121,2023,Feb,50022,48112,1910,3.8,"Citrus County, FL"
122,2023,Mar,50570,48658,1912,3.8,"Citrus County, FL"
123,2023,Apr,50579,48866,1713,3.4,"Citrus County, FL"
124,2023,May,51137,49153,1984,3.9,"Citrus County, FL"
125,2023,Jun,52065,49804,2261,4.3,"Citrus County, FL"
126,2023,Jul,51091,48732,2359,4.6,"Citrus County, FL"
127,2023,Aug,52908,50393,2515,4.8,"Citrus County, FL"
128,2023,Sep,53011,50502,2509,4.7,"Citrus County, FL"
129,2023,Oct,52687,50240,2447,4.6,"Citrus County, FL"
0,2013,Jan,34782,32707,2075,6.0,"Kauai County, HI"
1,2013,Feb,34222,32254,1968,5.8,"Kauai County, HI"
2,2013,Mar,34279,32433,1846,5.4,"Kauai County, HI"
3,2013,Apr,34556,32740,1816,5.3,"Kauai County, HI"
4,2013,May,34455,32706,1749,5.1,"Kauai County, HI"
5,2013,Jun,35202,33149,2053,5.8,"Kauai County, HI"
6,2013,Jul,35334,33522,1812,5.1,"Kauai County, HI"
7,2013,Aug,35093,33341,1752,5.0,"Kauai County, HI"
8,2013,Sep,34786,32922,1864,5.4,"Kauai County, HI"
9,2013,Oct,34494,32606,1888,5.5,"Kauai County, HI"
10,2013,Nov,34526,32693,1833,5.3,"Kauai County, HI"
11,2013,Dec,34370,32678,1692,4.9,"Kauai County, HI"
12,2014,Jan,35150,33368,1782,5.1,"Kauai County, HI"
13,2014,Feb,34889,33084,1805,5.2,"Kauai County, HI"
14,2014,Mar,35190,33473,1717,4.9,"Kauai County, HI"
15,2014,Apr,35419,33815,1604,4.5,"Kauai County, HI"
16,2014,May,35352,33775,1577,4.5,"Kauai County, HI"
17,2014,Jun,35905,34076,1829,5.1,"Kauai County, HI"
18,2014,Jul,36215,34521,1694,4.7,"Kauai County, HI"
19,2014,Aug,35816,34188,1628,4.5,"Kauai County, HI"
20,2014,Sep,35215,33628,1587,4.5,"Kauai County, HI"
21,2014,Oct,35074,33628,1446,4.1,"Kauai County, HI"
22,2014,Nov,35042,33571,1471,4.2,"Kauai County, HI"
23,2014,Dec,34852,33494,1358,3.9,"Kauai County, HI"
24,2015,Jan,35690,34160,1530,4.3,"Kauai County, HI"
25,2015,Feb,35352,33914,1438,4.1,"Kauai County, HI"
26,2015,Mar,35677,34315,1362,3.8,"Kauai County, HI"
27,2015,Apr,35684,34297,1387,3.9,"Kauai County, HI"
28,2015,May,35751,34390,1361,3.8,"Kauai County, HI"
29,2015,Jun,36495,34968,1527,4.2,"Kauai County, HI"
30,2015,Jul,36501,35210,1291,3.5,"Kauai County, HI"
31,2015,Aug,36265,34960,1305,3.6,"Kauai County, HI"
32,2015,Sep,35966,34600,1366,3.8,"Kauai County, HI"
33,2015,Oct,35519,34276,1243,3.5,"Kauai County, HI"
34,2015,Nov,35520,34265,1255,3.5,"Kauai County, HI"
35,2015,Dec,35613,34464,1149,3.2,"Kauai County, HI"
36,2016,Jan,36289,35074,1215,3.3,"Kauai County, HI"
37,2016,Feb,36107,34908,1199,3.3,"Kauai County, HI"
38,2016,Mar,36280,35144,1136,3.1,"Kauai County, HI"
39,2016,Apr,36349,35158,1191,3.3,"Kauai County, HI"
40,2016,May,36386,35310,1076,3.0,"Kauai County, HI"
41,2016,Jun,37175,35832,1343,3.6,"Kauai County, HI"
42,2016,Jul,37528,36407,1121,3.0,"Kauai County, HI"
43,2016,Aug,37280,36211,1069,2.9,"Kauai County, HI"
44,2016,Sep,36542,35432,1110,3.0,"Kauai County, HI"
45,2016,Oct,36407,35359,1048,2.9,"Kauai County, HI"
46,2016,Nov,36404,35393,1011,2.8,"Kauai County, HI"
47,2016,Dec,36301,35387,914,2.5,"Kauai County, HI"
48,2017,Jan,37583,36513,1070,2.8,"Kauai County, HI"
49,2017,Feb,37510,36514,996,2.7,"Kauai County, HI"
50,2017,Mar,37860,36939,921,2.4,"Kauai County, HI"
51,2017,Apr,38013,37062,951,2.5,"Kauai County, HI"
52,2017,May,37863,36982,881,2.3,"Kauai County, HI"
53,2017,Jun,38656,37633,1023,2.6,"Kauai County, HI"
54,2017,Jul,38754,37978,776,2.0,"Kauai County, HI"
55,2017,Aug,38278,37559,719,1.9,"Kauai County, HI"
56,2017,Sep,37594,36909,685,1.8,"Kauai County, HI"
57,2017,Oct,37304,36700,604,1.6,"Kauai County, HI"
58,2017,Nov,37338,36664,674,1.8,"Kauai County, HI"
59,2017,Dec,37220,36643,577,1.6,"Kauai County, HI"
60,2018,Jan,37705,36955,750,2.0,"Kauai County, HI"
61,2018,Feb,37549,36871,678,1.8,"Kauai County, HI"
62,2018,Mar,37858,37141,717,1.9,"Kauai County, HI"
63,2018,Apr,37140,36433,707,1.9,"Kauai County, HI"
64,2018,May,37285,36463,822,2.2,"Kauai County, HI"
65,2018,Jun,37837,36653,1184,3.1,"Kauai County, HI"
66,2018,Jul,38340,37347,993,2.6,"Kauai County, HI"
67,2018,Aug,37840,36833,1007,2.7,"Kauai County, HI"
68,2018,Sep,37460,36313,1147,3.1,"Kauai County, HI"
69,2018,Oct,37159,36110,1049,2.8,"Kauai County, HI"
70,2018,Nov,37188,36228,960,2.6,"Kauai County, HI"
71,2018,Dec,37061,36148,913,2.5,"Kauai County, HI"
72,2019,Jan,37526,36426,1100,2.9,"Kauai County, HI"
73,2019,Feb,37306,36325,981,2.6,"Kauai County, HI"
74,2019,Mar,37247,36241,1006,2.7,"Kauai County, HI"
75,2019,Apr,37452,36554,898,2.4,"Kauai County, HI"
76,2019,May,37602,36769,833,2.2,"Kauai County, HI"
77,2019,Jun,38117,37032,1085,2.8,"Kauai County, HI"
78,2019,Jul,38665,37695,970,2.5,"Kauai County, HI"
79,2019,Aug,37990,37088,902,2.4,"Kauai County, HI"
80,2019,Sep,37893,36974,919,2.4,"Kauai County, HI"
81,2019,Oct,37860,36970,890,2.4,"Kauai County, HI"
82,2019,Nov,37801,36851,950,2.5,"Kauai County, HI"
83,2019,Dec,37687,36883,804,2.1,"Kauai County, HI"
84,2020,Jan,37948,37035,913,2.4,"Kauai County, HI"
85,2020,Feb,37888,37087,801,2.1,"Kauai County, HI"
86,2020,Mar,37572,36728,844,2.2,"Kauai County, HI"
87,2020,Apr,36462,24634,11828,32.4,"Kauai County, HI"
88,2020,May,36985,26395,10590,28.6,"Kauai County, HI"
89,2020,Jun,37178,27893,9285,25.0,"Kauai County, HI"
90,2020,Jul,37079,28731,8348,22.5,"Kauai County, HI"
91,2020,Aug,36434,29640,6794,18.6,"Kauai County, HI"
92,2020,Sep,33599,27348,6251,18.6,"Kauai County, HI"
93,2020,Oct,34450,29008,5442,15.8,"Kauai County, HI"
94,2020,Nov,35482,30498,4984,14.0,"Kauai County, HI"
95,2020,Dec,35474,30668,4806,13.5,"Kauai County, HI"
96,2021,Jan,34938,30095,4843,13.9,"Kauai County, HI"
97,2021,Feb,35039,30404,4635,13.2,"Kauai County, HI"
98,2021,Mar,35205,30900,4305,12.2,"Kauai County, HI"
99,2021,Apr,36252,32183,4069,11.2,"Kauai County, HI"
100,2021,May,36494,33053,3441,9.4,"Kauai County, HI"
101,2021,Jun,37103,33642,3461,9.3,"Kauai County, HI"
102,2021,Jul,37153,34510,2643,7.1,"Kauai County, HI"
103,2021,Aug,37003,34811,2192,5.9,"Kauai County, HI"
104,2021,Sep,36392,34575,1817,5.0,"Kauai County, HI"
105,2021,Oct,36232,34796,1436,4.0,"Kauai County, HI"
106,2021,Nov,36354,35011,1343,3.7,"Kauai County, HI"
107,2021,Dec,36113,34929,1184,3.3,"Kauai County, HI"
108,2022,Jan,36469,35103,1366,3.7,"Kauai County, HI"
109,2022,Feb,36296,34987,1309,3.6,"Kauai County, HI"
110,2022,Mar,36518,35238,1280,3.5,"Kauai County, HI"
111,2022,Apr,36324,35119,1205,3.3,"Kauai County, HI"
112,2022,May,36407,35186,1221,3.4,"Kauai County, HI"
113,2022,Jun,36629,35177,1452,4.0,"Kauai County, HI"
114,2022,Jul,36924,35635,1289,3.5,"Kauai County, HI"
115,2022,Aug,37120,35741,1379,3.7,"Kauai County, HI"
116,2022,Sep,36860,35499,1361,3.7,"Kauai County, HI"
117,2022,Oct,36929,35581,1348,3.7,"Kauai County, HI"
118,2022,Nov,36821,35431,1390,3.8,"Kauai County, HI"
119,2022,Dec,36593,35336,1257,3.4,"Kauai County, HI"
120,2023,Jan,36824,35716,1108,3.0,"Kauai County, HI"
121,2023,Feb,36882,35731,1151,3.1,"Kauai County, HI"
122,2023,Mar,36961,35870,1091,3.0,"Kauai County, HI"
123,2023,Apr,36881,35936,945,2.6,"Kauai County, HI"
124,2023,May,36261,35340,921,2.5,"Kauai County, HI"
125,2023,Jun,36759,35602,1157,3.1,"Kauai County, HI"
126,2023,Jul,36600,35705,895,2.4,"Kauai County, HI"
127,2023,Aug,36621,35675,946,2.6,"Kauai County, HI"
128,2023,Sep,36473,35610,863,2.4,"Kauai County, HI"
129,2023,Oct,36681,35826,855,2.3,"Kauai County, HI"
0,2013,Jan,5158,4347,811,15.7,"Trinity County, CA"
1,2013,Feb,5078,4301,777,15.3,"Trinity County, CA"
2,2013,Mar,5030,4297,733,14.6,"Trinity County, CA"
3,2013,Apr,5053,4391,662,13.1,"Trinity County, CA"
4,2013,May,5275,4694,581,11.0,"Trinity County, CA"
5,2013,Jun,5450,4837,613,11.2,"Trinity County, CA"
6,2013,Jul,5356,4762,594,11.1,"Trinity County, CA"
7,2013,Aug,5460,4895,565,10.3,"Trinity County, CA"
8,2013,Sep,5254,4724,530,10.1,"Trinity County, CA"
9,2013,Oct,5099,4560,539,10.6,"Trinity County, CA"
10,2013,Nov,4975,4423,552,11.1,"Trinity County, CA"
11,2013,Dec,4912,4368,544,11.1,"Trinity County, CA"
12,2014,Jan,4894,4277,617,12.6,"Trinity County, CA"
13,2014,Feb,4916,4288,628,12.8,"Trinity County, CA"
14,2014,Mar,4947,4311,636,12.9,"Trinity County, CA"
15,2014,Apr,5156,4610,546,10.6,"Trinity County, CA"
16,2014,May,5283,4831,452,8.6,"Trinity County, CA"
17,2014,Jun,5448,4998,450,8.3,"Trinity County, CA"
18,2014,Jul,5412,4947,465,8.6,"Trinity County, CA"
19,2014,Aug,5499,5063,436,7.9,"Trinity County, CA"
20,2014,Sep,5335,4941,394,7.4,"Trinity County, CA"
21,2014,Oct,5156,4751,405,7.9,"Trinity County, CA"
22,2014,Nov,4991,4558,433,8.7,"Trinity County, CA"
23,2014,Dec,4894,4440,454,9.3,"Trinity County, CA"
24,2015,Jan,4942,4423,519,10.5,"Trinity County, CA"
25,2015,Feb,4950,4457,493,10.0,"Trinity County, CA"
26,2015,Mar,4956,4465,491,9.9,"Trinity County, CA"
27,2015,Apr,4996,4561,435,8.7,"Trinity County, CA"
28,2015,May,5221,4834,387,7.4,"Trinity County, CA"
29,2015,Jun,5378,5001,377,7.0,"Trinity County, CA"
30,2015,Jul,5367,4986,381,7.1,"Trinity County, CA"
31,2015,Aug,5472,5130,342,6.3,"Trinity County, CA"
32,2015,Sep,5304,4993,311,5.9,"Trinity County, CA"
33,2015,Oct,5125,4801,324,6.3,"Trinity County, CA"
34,2015,Nov,5027,4660,367,7.3,"Trinity County, CA"
35,2015,Dec,4952,4559,393,7.9,"Trinity County, CA"
36,2016,Jan,4821,4359,462,9.6,"Trinity County, CA"
37,2016,Feb,4900,4453,447,9.1,"Trinity County, CA"
38,2016,Mar,5014,4557,457,9.1,"Trinity County, CA"
39,2016,Apr,4873,4496,377,7.7,"Trinity County, CA"
40,2016,May,4992,4685,307,6.1,"Trinity County, CA"
41,2016,Jun,5189,4868,321,6.2,"Trinity County, CA"
42,2016,Jul,5106,4778,328,6.4,"Trinity County, CA"
43,2016,Aug,5269,4955,314,6.0,"Trinity County, CA"
44,2016,Sep,5137,4848,289,5.6,"Trinity County, CA"
45,2016,Oct,5006,4715,291,5.8,"Trinity County, CA"
46,2016,Nov,4838,4511,327,6.8,"Trinity County, CA"
47,2016,Dec,4768,4430,338,7.1,"Trinity County, CA"
48,2017,Jan,4711,4317,394,8.4,"Trinity County, CA"
49,2017,Feb,4811,4409,402,8.4,"Trinity County, CA"
50,2017,Mar,4736,4350,386,8.2,"Trinity County, CA"
51,2017,Apr,4654,4328,326,7.0,"Trinity County, CA"
52,2017,May,4864,4594,270,5.6,"Trinity County, CA"
53,2017,Jun,5078,4794,284,5.6,"Trinity County, CA"
54,2017,Jul,4978,4691,287,5.8,"Trinity County, CA"
55,2017,Aug,5102,4833,269,5.3,"Trinity County, CA"
56,2017,Sep,4871,4645,226,4.6,"Trinity County, CA"
57,2017,Oct,4737,4512,225,4.7,"Trinity County, CA"
58,2017,Nov,4587,4343,244,5.3,"Trinity County, CA"
59,2017,Dec,4508,4226,282,6.3,"Trinity County, CA"
60,2018,Jan,4438,4133,305,6.9,"Trinity County, CA"
61,2018,Feb,4529,4171,358,7.9,"Trinity County, CA"
62,2018,Mar,4502,4142,360,8.0,"Trinity County, CA"
63,2018,Apr,4561,4267,294,6.4,"Trinity County, CA"
64,2018,May,4708,4463,245,5.2,"Trinity County, CA"
65,2018,Jun,4926,4662,264,5.4,"Trinity County, CA"
66,2018,Jul,4872,4631,241,4.9,"Trinity County, CA"
67,2018,Aug,4960,4734,226,4.6,"Trinity County, CA"
68,2018,Sep,4779,4567,212,4.4,"Trinity County, CA"
69,2018,Oct,4691,4468,223,4.8,"Trinity County, CA"
70,2018,Nov,4617,4387,230,5.0,"Trinity County, CA"
71,2018,Dec,4512,4250,262,5.8,"Trinity County, CA"
72,2019,Jan,4543,4203,340,7.5,"Trinity County, CA"
73,2019,Feb,4525,4177,348,7.7,"Trinity County, CA"
74,2019,Mar,4525,4174,351,7.8,"Trinity County, CA"
75,2019,Apr,4601,4330,271,5.9,"Trinity County, CA"
76,2019,May,4756,4542,214,4.5,"Trinity County, CA"
77,2019,Jun,4929,4695,234,4.7,"Trinity County, CA"
78,2019,Jul,4841,4610,231,4.8,"Trinity County, CA"
79,2019,Aug,4864,4650,214,4.4,"Trinity County, CA"
80,2019,Sep,4690,4505,185,3.9,"Trinity County, CA"
81,2019,Oct,4649,4437,212,4.6,"Trinity County, CA"
82,2019,Nov,4497,4265,232,5.2,"Trinity County, CA"
83,2019,Dec,4406,4162,244,5.5,"Trinity County, CA"
84,2020,Jan,4419,4111,308,7.0,"Trinity County, CA"
85,2020,Feb,4478,4158,320,7.1,"Trinity County, CA"
86,2020,Mar,4570,4108,462,10.1,"Trinity County, CA"
87,2020,Apr,4405,3816,589,13.4,"Trinity County, CA"
88,2020,May,4363,3895,468,10.7,"Trinity County, CA"
89,2020,Jun,4661,4250,411,8.8,"Trinity County, CA"
90,2020,Jul,4682,4306,376,8.0,"Trinity County, CA"
91,2020,Aug,4802,4486,316,6.6,"Trinity County, CA"
92,2020,Sep,4718,4415,303,6.4,"Trinity County, CA"
93,2020,Oct,4595,4310,285,6.2,"Trinity County, CA"
94,2020,Nov,4491,4191,300,6.7,"Trinity County, CA"
95,2020,Dec,4411,4062,349,7.9,"Trinity County, CA"
96,2021,Jan,4344,3970,374,8.6,"Trinity County, CA"
97,2021,Feb,4345,3971,374,8.6,"Trinity County, CA"
98,2021,Mar,4369,4006,363,8.3,"Trinity County, CA"
99,2021,Apr,4515,4191,324,7.2,"Trinity County, CA"
100,2021,May,4764,4483,281,5.9,"Trinity County, CA"
101,2021,Jun,4846,4550,296,6.1,"Trinity County, CA"
102,2021,Jul,4651,4371,280,6.0,"Trinity County, CA"
103,2021,Aug,4747,4477,270,5.7,"Trinity County, CA"
104,2021,Sep,4602,4372,230,5.0,"Trinity County, CA"
105,2021,Oct,4618,4389,229,5.0,"Trinity County, CA"
106,2021,Nov,4468,4241,227,5.1,"Trinity County, CA"
107,2021,Dec,4402,4178,224,5.1,"Trinity County, CA"
108,2022,Jan,4449,4169,280,6.3,"Trinity County, CA"
109,2022,Feb,4434,4162,272,6.1,"Trinity County, CA"
110,2022,Mar,4540,4303,237,5.2,"Trinity County, CA"
111,2022,Apr,4454,4262,192,4.3,"Trinity County, CA"
112,2022,May,4558,4393,165,3.6,"Trinity County, CA"
113,2022,Jun,4778,4588,190,4.0,"Trinity County, CA"
114,2022,Jul,4602,4412,190,4.1,"Trinity County, CA"
115,2022,Aug,4727,4542,185,3.9,"Trinity County, CA"
116,2022,Sep,4691,4523,168,3.6,"Trinity County, CA"
117,2022,Oct,4610,4419,191,4.1,"Trinity County, CA"
118,2022,Nov,4557,4335,222,4.9,"Trinity County, CA"
119,2022,Dec,4464,4234,230,5.2,"Trinity County, CA"
120,2023,Jan,4449,4129,320,7.2,"Trinity County, CA"
121,2023,Feb,4442,4126,316,7.1,"Trinity County, CA"
122,2023,Mar,4462,4136,326,7.3,"Trinity County, CA"
123,2023,Apr,4346,4085,261,6.0,"Trinity County, CA"
124,2023,May,4429,4188,241,5.4,"Trinity County, CA"
125,2023,Jun,4569,4324,245,5.4,"Trinity County, CA"
126,2023,Jul,4586,4351,235,5.1,"Trinity County, CA"
127,2023,Aug,4656,4413,243,5.2,"Trinity County, CA"
128,2023,Sep,4471,4251,220,4.9,"Trinity County, CA"
129,2023,Oct,4370,4147,223,5.1,"Trinity County, CA"
0,2013,Jan,156483,143992,12491,8.0,"Collier County, FL"
1,2013,Feb,156503,145195,11308,7.2,"Collier County, FL"
2,2013,Mar,155743,145079,10664,6.8,"Collier County, FL"
3,2013,Apr,155219,144992,10227,6.6,"Collier County, FL"
4,2013,May,155219,144387,10832,7.0,"Collier County, FL"
5,2013,Jun,153209,141048,12161,7.9,"Collier County, FL"
6,2013,Jul,152649,140057,12592,8.2,"Collier County, FL"
7,2013,Aug,152513,139693,12820,8.4,"Collier County, FL"
8,2013,Sep,153876,141494,12382,8.0,"Collier County, FL"
9,2013,Oct,154595,142971,11624,7.5,"Collier County, FL"
10,2013,Nov,157598,147029,10569,6.7,"Collier County, FL"
11,2013,Dec,158634,148833,9801,6.2,"Collier County, FL"
12,2014,Jan,161113,150881,10232,6.4,"Collier County, FL"
13,2014,Feb,162336,152524,9812,6.0,"Collier County, FL"
14,2014,Mar,163018,153417,9601,5.9,"Collier County, FL"
15,2014,Apr,160619,152128,8491,5.3,"Collier County, FL"
16,2014,May,159043,149724,9319,5.9,"Collier County, FL"
17,2014,Jun,156436,146384,10052,6.4,"Collier County, FL"
18,2014,Jul,156252,145178,11074,7.1,"Collier County, FL"
19,2014,Aug,155946,144812,11134,7.1,"Collier County, FL"
20,2014,Sep,156490,146087,10403,6.6,"Collier County, FL"
21,2014,Oct,159878,150108,9770,6.1,"Collier County, FL"
22,2014,Nov,162928,153579,9349,5.7,"Collier County, FL"
23,2014,Dec,163528,154956,8572,5.2,"Collier County, FL"
24,2015,Jan,167197,158015,9182,5.5,"Collier County, FL"
25,2015,Feb,166820,158431,8389,5.0,"Collier County, FL"
26,2015,Mar,166882,158920,7962,4.8,"Collier County, FL"
27,2015,Apr,164815,157143,7672,4.7,"Collier County, FL"
28,2015,May,163811,155481,8330,5.1,"Collier County, FL"
29,2015,Jun,160942,151862,9080,5.6,"Collier County, FL"
30,2015,Jul,159382,149377,10005,6.3,"Collier County, FL"
31,2015,Aug,159937,150209,9728,6.1,"Collier County, FL"
32,2015,Sep,160401,151190,9211,5.7,"Collier County, FL"
33,2015,Oct,164214,155333,8881,5.4,"Collier County, FL"
34,2015,Nov,167790,159425,8365,5.0,"Collier County, FL"
35,2015,Dec,169769,161896,7873,4.6,"Collier County, FL"
36,2016,Jan,171620,163363,8257,4.8,"Collier County, FL"
37,2016,Feb,172223,164642,7581,4.4,"Collier County, FL"
38,2016,Mar,172504,165049,7455,4.3,"Collier County, FL"
39,2016,Apr,171081,163946,7135,4.2,"Collier County, FL"
40,2016,May,169299,162194,7105,4.2,"Collier County, FL"
41,2016,Jun,165606,157505,8101,4.9,"Collier County, FL"
42,2016,Jul,165374,156590,8784,5.3,"Collier County, FL"
43,2016,Aug,165410,156372,9038,5.5,"Collier County, FL"
44,2016,Sep,167097,158094,9003,5.4,"Collier County, FL"
45,2016,Oct,169880,161440,8440,5.0,"Collier County, FL"
46,2016,Nov,172731,164898,7833,4.5,"Collier County, FL"
47,2016,Dec,174271,166929,7342,4.2,"Collier County, FL"
48,2017,Jan,176003,168072,7931,4.5,"Collier County, FL"
49,2017,Feb,176616,169398,7218,4.1,"Collier County, FL"
50,2017,Mar,177035,170294,6741,3.8,"Collier County, FL"
51,2017,Apr,176050,169762,6288,3.6,"Collier County, FL"
52,2017,May,173360,166845,6515,3.8,"Collier County, FL"
53,2017,Jun,169076,161825,7251,4.3,"Collier County, FL"
54,2017,Jul,167652,159762,7890,4.7,"Collier County, FL"
55,2017,Aug,167783,159452,8331,5.0,"Collier County, FL"
56,2017,Sep,160621,152678,7943,4.9,"Collier County, FL"
57,2017,Oct,169432,162035,7397,4.4,"Collier County, FL"
58,2017,Nov,173796,166812,6984,4.0,"Collier County, FL"
59,2017,Dec,175999,169613,6386,3.6,"Collier County, FL"
60,2018,Jan,178119,171301,6818,3.8,"Collier County, FL"
61,2018,Feb,179601,173405,6196,3.4,"Collier County, FL"
62,2018,Mar,179476,173543,5933,3.3,"Collier County, FL"
63,2018,Apr,178597,173067,5530,3.1,"Collier County, FL"
64,2018,May,176331,170843,5488,3.1,"Collier County, FL"
65,2018,Jun,173030,166315,6715,3.9,"Collier County, FL"
66,2018,Jul,171770,164829,6941,4.0,"Collier County, FL"
67,2018,Aug,170983,163736,7247,4.2,"Collier County, FL"
68,2018,Sep,172534,166037,6497,3.8,"Collier County, FL"
69,2018,Oct,176810,170542,6268,3.5,"Collier County, FL"
70,2018,Nov,180087,174280,5807,3.2,"Collier County, FL"
71,2018,Dec,181667,175967,5700,3.1,"Collier County, FL"
72,2019,Jan,182310,175852,6458,3.5,"Collier County, FL"
73,2019,Feb,182545,176999,5546,3.0,"Collier County, FL"
74,2019,Mar,182281,176875,5406,3.0,"Collier County, FL"
75,2019,Apr,179845,174984,4861,2.7,"Collier County, FL"
76,2019,May,177677,172588,5089,2.9,"Collier County, FL"
77,2019,Jun,175154,169106,6048,3.5,"Collier County, FL"
78,2019,Jul,174817,168293,6524,3.7,"Collier County, FL"
79,2019,Aug,174958,168167,6791,3.9,"Collier County, FL"
80,2019,Sep,175941,169853,6088,3.5,"Collier County, FL"
81,2019,Oct,180136,174374,5762,3.2,"Collier County, FL"
82,2019,Nov,183229,177839,5390,2.9,"Collier County, FL"
83,2019,Dec,184530,179651,4879,2.6,"Collier County, FL"
84,2020,Jan,186919,181245,5674,3.0,"Collier County, FL"
85,2020,Feb,186789,181937,4852,2.6,"Collier County, FL"
86,2020,Mar,182770,175615,7155,3.9,"Collier County, FL"
87,2020,Apr,160880,139810,21070,13.1,"Collier County, FL"
88,2020,May,174296,151925,22371,12.8,"Collier County, FL"
89,2020,Jun,174371,155485,18886,10.8,"Collier County, FL"
90,2020,Jul,175700,155712,19988,11.4,"Collier County, FL"
91,2020,Aug,173606,159494,14112,8.1,"Collier County, FL"
92,2020,Sep,173756,161161,12595,7.2,"Collier County, FL"
93,2020,Oct,175183,165070,10113,5.8,"Collier County, FL"
94,2020,Nov,176283,167207,9076,5.1,"Collier County, FL"
95,2020,Dec,178188,169744,8444,4.7,"Collier County, FL"
96,2021,Jan,178852,170726,8126,4.5,"Collier County, FL"
97,2021,Feb,179746,172484,7262,4.0,"Collier County, FL"
98,2021,Mar,180978,173774,7204,4.0,"Collier County, FL"
99,2021,Apr,181560,175060,6500,3.6,"Collier County, FL"
100,2021,May,180887,174573,6314,3.5,"Collier County, FL"
101,2021,Jun,179705,171956,7749,4.3,"Collier County, FL"
102,2021,Jul,179412,171755,7657,4.3,"Collier County, FL"
103,2021,Aug,179642,172200,7442,4.1,"Collier County, FL"
104,2021,Sep,179862,173327,6535,3.6,"Collier County, FL"
105,2021,Oct,183177,177009,6168,3.4,"Collier County, FL"
106,2021,Nov,185153,179482,5671,3.1,"Collier County, FL"
107,2021,Dec,186470,181549,4921,2.6,"Collier County, FL"
108,2022,Jan,188718,182484,6234,3.3,"Collier County, FL"
109,2022,Feb,189241,183858,5383,2.8,"Collier County, FL"
110,2022,Mar,190791,185894,4897,2.6,"Collier County, FL"
111,2022,Apr,190619,186301,4318,2.3,"Collier County, FL"
112,2022,May,190922,186281,4641,2.4,"Collier County, FL"
113,2022,Jun,188591,182784,5807,3.1,"Collier County, FL"
114,2022,Jul,187753,182090,5663,3.0,"Collier County, FL"
115,2022,Aug,188321,182556,5765,3.1,"Collier County, FL"
116,2022,Sep,189469,184273,5196,2.7,"Collier County, FL"
117,2022,Oct,190311,184582,5729,3.0,"Collier County, FL"
118,2022,Nov,189468,184333,5135,2.7,"Collier County, FL"
119,2022,Dec,189333,185035,4298,2.3,"Collier County, FL"
120,2023,Jan,189373,184593,4780,2.5,"Collier County, FL"
121,2023,Feb,191374,186663,4711,2.5,"Collier County, FL"
122,2023,Mar,192331,187630,4701,2.4,"Collier County, FL"
123,2023,Apr,191132,187080,4052,2.1,"Collier County, FL"
124,2023,May,191245,186405,4840,2.5,"Collier County, FL"
125,2023,Jun,189888,184199,5689,3.0,"Collier County, FL"
126,2023,Jul,190525,184366,6159,3.2,"Collier County, FL"
127,2023,Aug,192910,186484,6426,3.3,"Collier County, FL"
128,2023,Sep,192054,185667,6387,3.3,"Collier County, FL"
129,2023,Oct,192797,186737,6060,3.1,"Collier County, FL"
0,2013,Jan,227971,209439,18532,8.1,"Seminole County, FL"
1,2013,Feb,228387,211275,17112,7.5,"Seminole County, FL"
2,2013,Mar,228788,212580,16208,7.1,"Seminole County, FL"
3,2013,Apr,228993,213392,15601,6.8,"Seminole County, FL"
4,2013,May,232695,216628,16067,6.9,"Seminole County, FL"
5,2013,Jun,235027,217788,17239,7.3,"Seminole County, FL"
6,2013,Jul,235784,218871,16913,7.2,"Seminole County, FL"
7,2013,Aug,235553,219233,16320,6.9,"Seminole County, FL"
8,2013,Sep,235902,220184,15718,6.7,"Seminole County, FL"
9,2013,Oct,234130,218655,15475,6.6,"Seminole County, FL"
10,2013,Nov,232675,217890,14785,6.4,"Seminole County, FL"
11,2013,Dec,231811,217809,14002,6.0,"Seminole County, FL"
12,2014,Jan,231213,216398,14815,6.4,"Seminole County, FL"
13,2014,Feb,232306,217864,14442,6.2,"Seminole County, FL"
14,2014,Mar,234049,219826,14223,6.1,"Seminole County, FL"
15,2014,Apr,232483,219499,12984,5.6,"Seminole County, FL"
16,2014,May,236063,222313,13750,5.8,"Seminole County, FL"
17,2014,Jun,237326,222981,14345,6.0,"Seminole County, FL"
18,2014,Jul,238647,223627,15020,6.3,"Seminole County, FL"
19,2014,Aug,238595,224050,14545,6.1,"Seminole County, FL"
20,2014,Sep,238666,225102,13564,5.7,"Seminole County, FL"
21,2014,Oct,237947,224763,13184,5.5,"Seminole County, FL"
22,2014,Nov,235771,222675,13096,5.6,"Seminole County, FL"
23,2014,Dec,234755,222503,12252,5.2,"Seminole County, FL"
24,2015,Jan,232489,219187,13302,5.7,"Seminole County, FL"
25,2015,Feb,232656,220396,12260,5.3,"Seminole County, FL"
26,2015,Mar,233399,221682,11717,5.0,"Seminole County, FL"
27,2015,Apr,234498,223165,11333,4.8,"Seminole County, FL"
28,2015,May,238252,226239,12013,5.0,"Seminole County, FL"
29,2015,Jun,239486,227194,12292,5.1,"Seminole County, FL"
30,2015,Jul,240253,227822,12431,5.2,"Seminole County, FL"
31,2015,Aug,240145,228207,11938,5.0,"Seminole County, FL"
32,2015,Sep,240544,229193,11351,4.7,"Seminole County, FL"
33,2015,Oct,240373,229074,11299,4.7,"Seminole County, FL"
34,2015,Nov,239022,227894,11128,4.7,"Seminole County, FL"
35,2015,Dec,239468,228835,10633,4.4,"Seminole County, FL"
36,2016,Jan,237183,226106,11077,4.7,"Seminole County, FL"
37,2016,Feb,238706,228419,10287,4.3,"Seminole County, FL"
38,2016,Mar,239748,229476,10272,4.3,"Seminole County, FL"
39,2016,Apr,239433,229615,9818,4.1,"Seminole County, FL"
40,2016,May,242240,232501,9739,4.0,"Seminole County, FL"
41,2016,Jun,244269,233240,11029,4.5,"Seminole County, FL"
42,2016,Jul,245881,234668,11213,4.6,"Seminole County, FL"
43,2016,Aug,245738,234659,11079,4.5,"Seminole County, FL"
44,2016,Sep,247111,236194,10917,4.4,"Seminole County, FL"
45,2016,Oct,245964,235462,10502,4.3,"Seminole County, FL"
46,2016,Nov,243830,233770,10060,4.1,"Seminole County, FL"
47,2016,Dec,243632,233904,9728,4.0,"Seminole County, FL"
48,2017,Jan,240142,229554,10588,4.4,"Seminole County, FL"
49,2017,Feb,241596,231881,9715,4.0,"Seminole County, FL"
50,2017,Mar,242612,233440,9172,3.8,"Seminole County, FL"
51,2017,Apr,242963,234326,8637,3.6,"Seminole County, FL"
52,2017,May,244818,235899,8919,3.6,"Seminole County, FL"
53,2017,Jun,247229,237467,9762,3.9,"Seminole County, FL"
54,2017,Jul,247599,237553,10046,4.1,"Seminole County, FL"
55,2017,Aug,246697,236778,9919,4.0,"Seminole County, FL"
56,2017,Sep,248679,239643,9036,3.6,"Seminole County, FL"
57,2017,Oct,247862,239072,8790,3.5,"Seminole County, FL"
58,2017,Nov,246766,238049,8717,3.5,"Seminole County, FL"
59,2017,Dec,246572,238321,8251,3.3,"Seminole County, FL"
60,2018,Jan,243574,234523,9051,3.7,"Seminole County, FL"
61,2018,Feb,245192,236722,8470,3.5,"Seminole County, FL"
62,2018,Mar,245811,237648,8163,3.3,"Seminole County, FL"
63,2018,Apr,246011,238350,7661,3.1,"Seminole County, FL"
64,2018,May,247900,240208,7692,3.1,"Seminole County, FL"
65,2018,Jun,250289,241270,9019,3.6,"Seminole County, FL"
66,2018,Jul,251314,242437,8877,3.5,"Seminole County, FL"
67,2018,Aug,249893,241349,8544,3.4,"Seminole County, FL"
68,2018,Sep,251413,243474,7939,3.2,"Seminole County, FL"
69,2018,Oct,252220,244336,7884,3.1,"Seminole County, FL"
70,2018,Nov,250044,242511,7533,3.0,"Seminole County, FL"
71,2018,Dec,249096,241551,7545,3.0,"Seminole County, FL"
72,2019,Jan,247315,238588,8727,3.5,"Seminole County, FL"
73,2019,Feb,249004,241343,7661,3.1,"Seminole County, FL"
74,2019,Mar,249509,241955,7554,3.0,"Seminole County, FL"
75,2019,Apr,249357,242637,6720,2.7,"Seminole County, FL"
76,2019,May,251574,244377,7197,2.9,"Seminole County, FL"
77,2019,Jun,253830,245612,8218,3.2,"Seminole County, FL"
78,2019,Jul,254905,246515,8390,3.3,"Seminole County, FL"
79,2019,Aug,255006,246890,8116,3.2,"Seminole County, FL"
80,2019,Sep,256065,248669,7396,2.9,"Seminole County, FL"
81,2019,Oct,256129,248699,7430,2.9,"Seminole County, FL"
82,2019,Nov,254318,247317,7001,2.8,"Seminole County, FL"
83,2019,Dec,253999,247502,6497,2.6,"Seminole County, FL"
84,2020,Jan,252752,245171,7581,3.0,"Seminole County, FL"
85,2020,Feb,253679,247184,6495,2.6,"Seminole County, FL"
86,2020,Mar,249318,239605,9713,3.9,"Seminole County, FL"
87,2020,Apr,225662,197635,28027,12.4,"Seminole County, FL"
88,2020,May,227510,195142,32368,14.2,"Seminole County, FL"
89,2020,Jun,229009,202108,26901,11.7,"Seminole County, FL"
90,2020,Jul,237216,209480,27736,11.7,"Seminole County, FL"
91,2020,Aug,234192,215039,19153,8.2,"Seminole County, FL"
92,2020,Sep,235149,217525,17624,7.5,"Seminole County, FL"
93,2020,Oct,236920,222093,14827,6.3,"Seminole County, FL"
94,2020,Nov,237053,223592,13461,5.7,"Seminole County, FL"
95,2020,Dec,236168,223621,12547,5.3,"Seminole County, FL"
96,2021,Jan,234403,221924,12479,5.3,"Seminole County, FL"
97,2021,Feb,235789,224519,11270,4.8,"Seminole County, FL"
98,2021,Mar,237569,226791,10778,4.5,"Seminole County, FL"
99,2021,Apr,239671,229318,10353,4.3,"Seminole County, FL"
100,2021,May,241541,231614,9927,4.1,"Seminole County, FL"
101,2021,Jun,245510,234083,11427,4.7,"Seminole County, FL"
102,2021,Jul,248795,238059,10736,4.3,"Seminole County, FL"
103,2021,Aug,250507,240203,10304,4.1,"Seminole County, FL"
104,2021,Sep,252617,243194,9423,3.7,"Seminole County, FL"
105,2021,Oct,254630,245597,9033,3.5,"Seminole County, FL"
106,2021,Nov,254878,246390,8488,3.3,"Seminole County, FL"
107,2021,Dec,254750,247372,7378,2.9,"Seminole County, FL"
108,2022,Jan,256433,247505,8928,3.5,"Seminole County, FL"
109,2022,Feb,257673,249943,7730,3.0,"Seminole County, FL"
110,2022,Mar,259753,252727,7026,2.7,"Seminole County, FL"
111,2022,Apr,260067,253663,6404,2.5,"Seminole County, FL"
112,2022,May,262535,255978,6557,2.5,"Seminole County, FL"
113,2022,Jun,264943,257368,7575,2.9,"Seminole County, FL"
114,2022,Jul,266173,258918,7255,2.7,"Seminole County, FL"
115,2022,Aug,267498,260207,7291,2.7,"Seminole County, FL"
116,2022,Sep,269031,262403,6628,2.5,"Seminole County, FL"
117,2022,Oct,267998,261311,6687,2.5,"Seminole County, FL"
118,2022,Nov,266762,260277,6485,2.4,"Seminole County, FL"
119,2022,Dec,266782,261086,5696,2.1,"Seminole County, FL"
120,2023,Jan,266600,260099,6501,2.4,"Seminole County, FL"
121,2023,Feb,269020,262498,6522,2.4,"Seminole County, FL"
122,2023,Mar,270966,264340,6626,2.4,"Seminole County, FL"
123,2023,Apr,271311,265373,5938,2.2,"Seminole County, FL"
124,2023,May,272013,265047,6966,2.6,"Seminole County, FL"
125,2023,Jun,275265,267434,7831,2.8,"Seminole County, FL"
126,2023,Jul,276591,268368,8223,3.0,"Seminole County, FL"
127,2023,Aug,278149,269829,8320,3.0,"Seminole County, FL"
128,2023,Sep,278682,270591,8091,2.9,"Seminole County, FL"
129,2023,Oct,277425,269186,8239,3.0,"Seminole County, FL"
0,2013,Jan,76362,65364,10998,14.4,"Shasta County, CA"
1,2013,Feb,75245,64833,10412,13.8,"Shasta County, CA"
2,2013,Mar,75511,65459,10052,13.3,"Shasta County, CA"
3,2013,Apr,74425,65293,9132,12.3,"Shasta County, CA"
4,2013,May,74821,66213,8608,11.5,"Shasta County, CA"
5,2013,Jun,75877,66720,9157,12.1,"Shasta County, CA"
6,2013,Jul,74793,65828,8965,12.0,"Shasta County, CA"
7,2013,Aug,75272,66833,8439,11.2,"Shasta County, CA"
8,2013,Sep,75220,67238,7982,10.6,"Shasta County, CA"
9,2013,Oct,75030,67009,8021,10.7,"Shasta County, CA"
10,2013,Nov,73997,65916,8081,10.9,"Shasta County, CA"
11,2013,Dec,74037,66119,7918,10.7,"Shasta County, CA"
12,2014,Jan,75351,66646,8705,11.6,"Shasta County, CA"
13,2014,Feb,74540,65685,8855,11.9,"Shasta County, CA"
14,2014,Mar,75120,66284,8836,11.8,"Shasta County, CA"
15,2014,Apr,74021,66549,7472,10.1,"Shasta County, CA"
16,2014,May,74504,67573,6931,9.3,"Shasta County, CA"
17,2014,Jun,75145,67998,7147,9.5,"Shasta County, CA"
18,2014,Jul,74654,67384,7270,9.7,"Shasta County, CA"
19,2014,Aug,75129,68300,6829,9.1,"Shasta County, CA"
20,2014,Sep,75222,68981,6241,8.3,"Shasta County, CA"
21,2014,Oct,75233,69044,6189,8.2,"Shasta County, CA"
22,2014,Nov,74216,67887,6329,8.5,"Shasta County, CA"
23,2014,Dec,73755,67294,6461,8.8,"Shasta County, CA"
24,2015,Jan,74748,67651,7097,9.5,"Shasta County, CA"
25,2015,Feb,73748,66941,6807,9.2,"Shasta County, CA"
26,2015,Mar,73857,67219,6638,9.0,"Shasta County, CA"
27,2015,Apr,73668,67792,5876,8.0,"Shasta County, CA"
28,2015,May,74337,68690,5647,7.6,"Shasta County, CA"
29,2015,Jun,74718,68946,5772,7.7,"Shasta County, CA"
30,2015,Jul,74085,68277,5808,7.8,"Shasta County, CA"
31,2015,Aug,74377,69032,5345,7.2,"Shasta County, CA"
32,2015,Sep,74032,69094,4938,6.7,"Shasta County, CA"
33,2015,Oct,74418,69376,5042,6.8,"Shasta County, CA"
34,2015,Nov,73748,68539,5209,7.1,"Shasta County, CA"
35,2015,Dec,73734,68345,5389,7.3,"Shasta County, CA"
36,2016,Jan,74187,68061,6126,8.3,"Shasta County, CA"
37,2016,Feb,73525,67637,5888,8.0,"Shasta County, CA"
38,2016,Mar,74115,67957,6158,8.3,"Shasta County, CA"
39,2016,Apr,73894,68714,5180,7.0,"Shasta County, CA"
40,2016,May,73836,69250,4586,6.2,"Shasta County, CA"
41,2016,Jun,74964,69768,5196,6.9,"Shasta County, CA"
42,2016,Jul,74123,68945,5178,7.0,"Shasta County, CA"
43,2016,Aug,74651,69734,4917,6.6,"Shasta County, CA"
44,2016,Sep,74590,69892,4698,6.3,"Shasta County, CA"
45,2016,Oct,75060,70411,4649,6.2,"Shasta County, CA"
46,2016,Nov,74162,69447,4715,6.4,"Shasta County, CA"
47,2016,Dec,73372,68413,4959,6.8,"Shasta County, CA"
48,2017,Jan,74285,68852,5433,7.3,"Shasta County, CA"
49,2017,Feb,73683,68261,5422,7.4,"Shasta County, CA"
50,2017,Mar,73761,68667,5094,6.9,"Shasta County, CA"
51,2017,Apr,73572,69018,4554,6.2,"Shasta County, CA"
52,2017,May,73570,69618,3952,5.4,"Shasta County, CA"
53,2017,Jun,74294,70083,4211,5.7,"Shasta County, CA"
54,2017,Jul,73930,69627,4303,5.8,"Shasta County, CA"
55,2017,Aug,74339,70201,4138,5.6,"Shasta County, CA"
56,2017,Sep,74343,70668,3675,4.9,"Shasta County, CA"
57,2017,Oct,74379,70784,3595,4.8,"Shasta County, CA"
58,2017,Nov,73616,69980,3636,4.9,"Shasta County, CA"
59,2017,Dec,73170,69367,3803,5.2,"Shasta County, CA"
60,2018,Jan,73793,69513,4280,5.8,"Shasta County, CA"
61,2018,Feb,73872,69468,4404,6.0,"Shasta County, CA"
62,2018,Mar,73890,69530,4360,5.9,"Shasta County, CA"
63,2018,Apr,72886,69156,3730,5.1,"Shasta County, CA"
64,2018,May,73398,70203,3195,4.4,"Shasta County, CA"
65,2018,Jun,73947,70264,3683,5.0,"Shasta County, CA"
66,2018,Jul,73852,70174,3678,5.0,"Shasta County, CA"
67,2018,Aug,73761,70202,3559,4.8,"Shasta County, CA"
68,2018,Sep,73990,70735,3255,4.4,"Shasta County, CA"
69,2018,Oct,74843,71555,3288,4.4,"Shasta County, CA"
70,2018,Nov,74637,71301,3336,4.5,"Shasta County, CA"
71,2018,Dec,73831,70152,3679,5.0,"Shasta County, CA"
72,2019,Jan,73183,68518,4665,6.4,"Shasta County, CA"
73,2019,Feb,72352,67903,4449,6.1,"Shasta County, CA"
74,2019,Mar,73091,68832,4259,5.8,"Shasta County, CA"
75,2019,Apr,71971,68521,3450,4.8,"Shasta County, CA"
76,2019,May,72529,69550,2979,4.1,"Shasta County, CA"
77,2019,Jun,72924,69537,3387,4.6,"Shasta County, CA"
78,2019,Jul,72490,68997,3493,4.8,"Shasta County, CA"
79,2019,Aug,73310,70089,3221,4.4,"Shasta County, CA"
80,2019,Sep,73434,70627,2807,3.8,"Shasta County, CA"
81,2019,Oct,74144,71143,3001,4.0,"Shasta County, CA"
82,2019,Nov,73347,70257,3090,4.2,"Shasta County, CA"
83,2019,Dec,72957,69724,3233,4.4,"Shasta County, CA"
84,2020,Jan,74049,69972,4077,5.5,"Shasta County, CA"
85,2020,Feb,73598,69619,3979,5.4,"Shasta County, CA"
86,2020,Mar,74041,68362,5679,7.7,"Shasta County, CA"
87,2020,Apr,73188,61491,11697,16.0,"Shasta County, CA"
88,2020,May,71324,62014,9310,13.1,"Shasta County, CA"
89,2020,Jun,74403,66587,7816,10.5,"Shasta County, CA"
90,2020,Jul,73265,65911,7354,10.0,"Shasta County, CA"
91,2020,Aug,73610,67513,6097,8.3,"Shasta County, CA"
92,2020,Sep,73851,68035,5816,7.9,"Shasta County, CA"
93,2020,Oct,73999,68658,5341,7.2,"Shasta County, CA"
94,2020,Nov,72793,67276,5517,7.6,"Shasta County, CA"
95,2020,Dec,72714,66920,5794,8.0,"Shasta County, CA"
96,2021,Jan,73771,67633,6138,8.3,"Shasta County, CA"
97,2021,Feb,73028,66818,6210,8.5,"Shasta County, CA"
98,2021,Mar,73417,67391,6026,8.2,"Shasta County, CA"
99,2021,Apr,72809,67295,5514,7.6,"Shasta County, CA"
100,2021,May,72840,67933,4907,6.7,"Shasta County, CA"
101,2021,Jun,73599,68078,5521,7.5,"Shasta County, CA"
102,2021,Jul,72415,67128,5287,7.3,"Shasta County, CA"
103,2021,Aug,73270,68307,4963,6.8,"Shasta County, CA"
104,2021,Sep,72973,68744,4229,5.8,"Shasta County, CA"
105,2021,Oct,73307,69193,4114,5.6,"Shasta County, CA"
106,2021,Nov,72470,68566,3904,5.4,"Shasta County, CA"
107,2021,Dec,72028,68331,3697,5.1,"Shasta County, CA"
108,2022,Jan,73549,69036,4513,6.1,"Shasta County, CA"
109,2022,Feb,72703,68598,4105,5.6,"Shasta County, CA"
110,2022,Mar,73131,69425,3706,5.1,"Shasta County, CA"
111,2022,Apr,72053,68901,3152,4.4,"Shasta County, CA"
112,2022,May,72761,69957,2804,3.9,"Shasta County, CA"
113,2022,Jun,73082,69887,3195,4.4,"Shasta County, CA"
114,2022,Jul,71870,68705,3165,4.4,"Shasta County, CA"
115,2022,Aug,73406,70191,3215,4.4,"Shasta County, CA"
116,2022,Sep,73445,70591,2854,3.9,"Shasta County, CA"
117,2022,Oct,74247,71193,3054,4.1,"Shasta County, CA"
118,2022,Nov,73864,70609,3255,4.4,"Shasta County, CA"
119,2022,Dec,73501,70302,3199,4.4,"Shasta County, CA"
120,2023,Jan,74029,69791,4238,5.7,"Shasta County, CA"
121,2023,Feb,74172,69832,4340,5.9,"Shasta County, CA"
122,2023,Mar,74507,70061,4446,6.0,"Shasta County, CA"
123,2023,Apr,73503,69845,3658,5.0,"Shasta County, CA"
124,2023,May,73342,69768,3574,4.9,"Shasta County, CA"
125,2023,Jun,72860,69196,3664,5.0,"Shasta County, CA"
126,2023,Jul,71718,68203,3515,4.9,"Shasta County, CA"
127,2023,Aug,71415,67693,3722,5.2,"Shasta County, CA"
128,2023,Sep,71698,68245,3453,4.8,"Shasta County, CA"
129,2023,Oct,71963,68409,3554,4.9,"Shasta County, CA"
0,2013,Jan,6607,5973,634,9.6,"Gilchrist County, FL"
1,2013,Feb,6578,6021,557,8.5,"Gilchrist County, FL"
2,2013,Mar,6578,6055,523,8.0,"Gilchrist County, FL"
3,2013,Apr,6583,6080,503,7.6,"Gilchrist County, FL"
4,2013,May,6556,6030,526,8.0,"Gilchrist County, FL"
5,2013,Jun,6542,5966,576,8.8,"Gilchrist County, FL"
6,2013,Jul,6550,5985,565,8.6,"Gilchrist County, FL"
7,2013,Aug,6569,6038,531,8.1,"Gilchrist County, FL"
8,2013,Sep,6778,6241,537,7.9,"Gilchrist County, FL"
9,2013,Oct,6730,6199,531,7.9,"Gilchrist County, FL"
10,2013,Nov,6660,6141,519,7.8,"Gilchrist County, FL"
11,2013,Dec,6564,6068,496,7.6,"Gilchrist County, FL"
12,2014,Jan,6537,6015,522,8.0,"Gilchrist County, FL"
13,2014,Feb,6554,6066,488,7.4,"Gilchrist County, FL"
14,2014,Mar,6603,6116,487,7.4,"Gilchrist County, FL"
15,2014,Apr,6522,6095,427,6.5,"Gilchrist County, FL"
16,2014,May,6522,6074,448,6.9,"Gilchrist County, FL"
17,2014,Jun,6461,5996,465,7.2,"Gilchrist County, FL"
18,2014,Jul,6496,6017,479,7.4,"Gilchrist County, FL"
19,2014,Aug,6461,6001,460,7.1,"Gilchrist County, FL"
20,2014,Sep,6694,6259,435,6.5,"Gilchrist County, FL"
21,2014,Oct,6647,6229,418,6.3,"Gilchrist County, FL"
22,2014,Nov,6579,6153,426,6.5,"Gilchrist County, FL"
23,2014,Dec,6495,6106,389,6.0,"Gilchrist County, FL"
24,2015,Jan,6461,6047,414,6.4,"Gilchrist County, FL"
25,2015,Feb,6467,6091,376,5.8,"Gilchrist County, FL"
26,2015,Mar,6479,6114,365,5.6,"Gilchrist County, FL"
27,2015,Apr,6518,6166,352,5.4,"Gilchrist County, FL"
28,2015,May,6508,6133,375,5.8,"Gilchrist County, FL"
29,2015,Jun,6420,6033,387,6.0,"Gilchrist County, FL"
30,2015,Jul,6484,6086,398,6.1,"Gilchrist County, FL"
31,2015,Aug,6444,6061,383,5.9,"Gilchrist County, FL"
32,2015,Sep,6699,6326,373,5.6,"Gilchrist County, FL"
33,2015,Oct,6664,6305,359,5.4,"Gilchrist County, FL"
34,2015,Nov,6600,6239,361,5.5,"Gilchrist County, FL"
35,2015,Dec,6551,6213,338,5.2,"Gilchrist County, FL"
36,2016,Jan,6603,6244,359,5.4,"Gilchrist County, FL"
37,2016,Feb,6680,6352,328,4.9,"Gilchrist County, FL"
38,2016,Mar,6698,6373,325,4.9,"Gilchrist County, FL"
39,2016,Apr,6689,6370,319,4.8,"Gilchrist County, FL"
40,2016,May,6619,6312,307,4.6,"Gilchrist County, FL"
41,2016,Jun,6603,6253,350,5.3,"Gilchrist County, FL"
42,2016,Jul,6653,6303,350,5.3,"Gilchrist County, FL"
43,2016,Aug,6597,6255,342,5.2,"Gilchrist County, FL"
44,2016,Sep,6898,6536,362,5.2,"Gilchrist County, FL"
45,2016,Oct,6864,6509,355,5.2,"Gilchrist County, FL"
46,2016,Nov,6760,6424,336,5.0,"Gilchrist County, FL"
47,2016,Dec,6716,6392,324,4.8,"Gilchrist County, FL"
48,2017,Jan,6776,6413,363,5.4,"Gilchrist County, FL"
49,2017,Feb,6814,6479,335,4.9,"Gilchrist County, FL"
50,2017,Mar,6798,6491,307,4.5,"Gilchrist County, FL"
51,2017,Apr,6785,6502,283,4.2,"Gilchrist County, FL"
52,2017,May,6690,6406,284,4.2,"Gilchrist County, FL"
53,2017,Jun,6694,6375,319,4.8,"Gilchrist County, FL"
54,2017,Jul,6740,6425,315,4.7,"Gilchrist County, FL"
55,2017,Aug,6641,6329,312,4.7,"Gilchrist County, FL"
56,2017,Sep,6910,6622,288,4.2,"Gilchrist County, FL"
57,2017,Oct,6874,6585,289,4.2,"Gilchrist County, FL"
58,2017,Nov,6772,6478,294,4.3,"Gilchrist County, FL"
59,2017,Dec,6717,6450,267,4.0,"Gilchrist County, FL"
60,2018,Jan,6923,6607,316,4.6,"Gilchrist County, FL"
61,2018,Feb,6973,6695,278,4.0,"Gilchrist County, FL"
62,2018,Mar,6971,6702,269,3.9,"Gilchrist County, FL"
63,2018,Apr,6966,6717,249,3.6,"Gilchrist County, FL"
64,2018,May,6852,6618,234,3.4,"Gilchrist County, FL"
65,2018,Jun,6897,6605,292,4.2,"Gilchrist County, FL"
66,2018,Jul,6948,6673,275,4.0,"Gilchrist County, FL"
67,2018,Aug,6882,6604,278,4.0,"Gilchrist County, FL"
68,2018,Sep,7172,6916,256,3.6,"Gilchrist County, FL"
69,2018,Oct,7154,6893,261,3.6,"Gilchrist County, FL"
70,2018,Nov,7038,6786,252,3.6,"Gilchrist County, FL"
71,2018,Dec,7022,6763,259,3.7,"Gilchrist County, FL"
72,2019,Jan,7205,6915,290,4.0,"Gilchrist County, FL"
73,2019,Feb,7232,6982,250,3.5,"Gilchrist County, FL"
74,2019,Mar,7219,6967,252,3.5,"Gilchrist County, FL"
75,2019,Apr,7217,6992,225,3.1,"Gilchrist County, FL"
76,2019,May,7146,6910,236,3.3,"Gilchrist County, FL"
77,2019,Jun,7156,6877,279,3.9,"Gilchrist County, FL"
78,2019,Jul,7213,6929,284,3.9,"Gilchrist County, FL"
79,2019,Aug,7188,6923,265,3.7,"Gilchrist County, FL"
80,2019,Sep,7455,7216,239,3.2,"Gilchrist County, FL"
81,2019,Oct,7418,7171,247,3.3,"Gilchrist County, FL"
82,2019,Nov,7349,7117,232,3.2,"Gilchrist County, FL"
83,2019,Dec,7296,7079,217,3.0,"Gilchrist County, FL"
84,2020,Jan,7343,7092,251,3.4,"Gilchrist County, FL"
85,2020,Feb,7377,7170,207,2.8,"Gilchrist County, FL"
86,2020,Mar,7275,6974,301,4.1,"Gilchrist County, FL"
87,2020,Apr,6453,6018,435,6.7,"Gilchrist County, FL"
88,2020,May,6740,6297,443,6.6,"Gilchrist County, FL"
89,2020,Jun,6787,6349,438,6.5,"Gilchrist County, FL"
90,2020,Jul,6938,6416,522,7.5,"Gilchrist County, FL"
91,2020,Aug,6930,6562,368,5.3,"Gilchrist County, FL"
92,2020,Sep,7165,6798,367,5.1,"Gilchrist County, FL"
93,2020,Oct,7228,6889,339,4.7,"Gilchrist County, FL"
94,2020,Nov,7171,6826,345,4.8,"Gilchrist County, FL"
95,2020,Dec,7167,6821,346,4.8,"Gilchrist County, FL"
96,2021,Jan,7159,6818,341,4.8,"Gilchrist County, FL"
97,2021,Feb,7252,6936,316,4.4,"Gilchrist County, FL"
98,2021,Mar,7257,6971,286,3.9,"Gilchrist County, FL"
99,2021,Apr,7247,6990,257,3.5,"Gilchrist County, FL"
100,2021,May,7227,6966,261,3.6,"Gilchrist County, FL"
101,2021,Jun,7229,6907,322,4.5,"Gilchrist County, FL"
102,2021,Jul,7239,6935,304,4.2,"Gilchrist County, FL"
103,2021,Aug,7187,6896,291,4.0,"Gilchrist County, FL"
104,2021,Sep,7428,7174,254,3.4,"Gilchrist County, FL"
105,2021,Oct,7393,7142,251,3.4,"Gilchrist County, FL"
106,2021,Nov,7384,7146,238,3.2,"Gilchrist County, FL"
107,2021,Dec,7303,7084,219,3.0,"Gilchrist County, FL"
108,2022,Jan,7379,7098,281,3.8,"Gilchrist County, FL"
109,2022,Feb,7388,7137,251,3.4,"Gilchrist County, FL"
110,2022,Mar,7403,7179,224,3.0,"Gilchrist County, FL"
111,2022,Apr,7405,7206,199,2.7,"Gilchrist County, FL"
112,2022,May,7341,7133,208,2.8,"Gilchrist County, FL"
113,2022,Jun,7344,7102,242,3.3,"Gilchrist County, FL"
114,2022,Jul,7338,7100,238,3.2,"Gilchrist County, FL"
115,2022,Aug,7283,7049,234,3.2,"Gilchrist County, FL"
116,2022,Sep,7580,7365,215,2.8,"Gilchrist County, FL"
117,2022,Oct,7526,7316,210,2.8,"Gilchrist County, FL"
118,2022,Nov,7482,7272,210,2.8,"Gilchrist County, FL"
119,2022,Dec,7428,7251,177,2.4,"Gilchrist County, FL"
120,2023,Jan,7479,7269,210,2.8,"Gilchrist County, FL"
121,2023,Feb,7543,7341,202,2.7,"Gilchrist County, FL"
122,2023,Mar,7586,7379,207,2.7,"Gilchrist County, FL"
123,2023,Apr,7605,7412,193,2.5,"Gilchrist County, FL"
124,2023,May,7522,7281,241,3.2,"Gilchrist County, FL"
125,2023,Jun,7546,7291,255,3.4,"Gilchrist County, FL"
126,2023,Jul,7548,7297,251,3.3,"Gilchrist County, FL"
127,2023,Aug,7540,7280,260,3.4,"Gilchrist County, FL"
128,2023,Sep,7797,7522,275,3.5,"Gilchrist County, FL"
129,2023,Oct,7781,7511,270,3.5,"Gilchrist County, FL"
0,2013,Jan,434550,395079,39471,9.1,"Ventura County, CA"
1,2013,Feb,436809,400174,36635,8.4,"Ventura County, CA"
2,2013,Mar,436175,401135,35040,8.0,"Ventura County, CA"
3,2013,Apr,433613,401562,32051,7.4,"Ventura County, CA"
4,2013,May,433390,401274,32116,7.4,"Ventura County, CA"
5,2013,Jun,431702,396175,35527,8.2,"Ventura County, CA"
6,2013,Jul,430256,394011,36245,8.4,"Ventura County, CA"
7,2013,Aug,428049,392634,35415,8.3,"Ventura County, CA"
8,2013,Sep,429511,395477,34034,7.9,"Ventura County, CA"
9,2013,Oct,430603,396987,33616,7.8,"Ventura County, CA"
10,2013,Nov,432726,400226,32500,7.5,"Ventura County, CA"
11,2013,Dec,430761,399648,31113,7.2,"Ventura County, CA"
12,2014,Jan,430609,398195,32414,7.5,"Ventura County, CA"
13,2014,Feb,433260,401531,31729,7.3,"Ventura County, CA"
14,2014,Mar,435586,404324,31262,7.2,"Ventura County, CA"
15,2014,Apr,429522,402910,26612,6.2,"Ventura County, CA"
16,2014,May,428820,402161,26659,6.2,"Ventura County, CA"
17,2014,Jun,427027,398764,28263,6.6,"Ventura County, CA"
18,2014,Jul,426493,395950,30543,7.2,"Ventura County, CA"
19,2014,Aug,424656,394455,30201,7.1,"Ventura County, CA"
20,2014,Sep,424723,396567,28156,6.6,"Ventura County, CA"
21,2014,Oct,430221,402875,27346,6.4,"Ventura County, CA"
22,2014,Nov,431008,403538,27470,6.4,"Ventura County, CA"
23,2014,Dec,428222,402488,25734,6.0,"Ventura County, CA"
24,2015,Jan,429362,401862,27500,6.4,"Ventura County, CA"
25,2015,Feb,431156,405448,25708,6.0,"Ventura County, CA"
26,2015,Mar,431830,406852,24978,5.8,"Ventura County, CA"
27,2015,Apr,429089,406389,22700,5.3,"Ventura County, CA"
28,2015,May,428847,405914,22933,5.3,"Ventura County, CA"
29,2015,Jun,426247,402044,24203,5.7,"Ventura County, CA"
30,2015,Jul,423371,397788,25583,6.0,"Ventura County, CA"
31,2015,Aug,420970,396094,24876,5.9,"Ventura County, CA"
32,2015,Sep,422801,399331,23470,5.6,"Ventura County, CA"
33,2015,Oct,426990,403861,23129,5.4,"Ventura County, CA"
34,2015,Nov,428115,404802,23313,5.4,"Ventura County, CA"
35,2015,Dec,428046,405338,22708,5.3,"Ventura County, CA"
36,2016,Jan,424390,400963,23427,5.5,"Ventura County, CA"
37,2016,Feb,427638,404873,22765,5.3,"Ventura County, CA"
38,2016,Mar,430567,407940,22627,5.3,"Ventura County, CA"
39,2016,Apr,426628,405892,20736,4.9,"Ventura County, CA"
40,2016,May,426418,407113,19305,4.5,"Ventura County, CA"
41,2016,Jun,426008,403530,22478,5.3,"Ventura County, CA"
42,2016,Jul,424239,400717,23522,5.5,"Ventura County, CA"
43,2016,Aug,421321,397437,23884,5.7,"Ventura County, CA"
44,2016,Sep,423497,400428,23069,5.4,"Ventura County, CA"
45,2016,Oct,425024,402468,22556,5.3,"Ventura County, CA"
46,2016,Nov,424343,402682,21661,5.1,"Ventura County, CA"
47,2016,Dec,424070,402997,21073,5.0,"Ventura County, CA"
48,2017,Jan,422937,399923,23014,5.4,"Ventura County, CA"
49,2017,Feb,425578,404184,21394,5.0,"Ventura County, CA"
50,2017,Mar,426449,406393,20056,4.7,"Ventura County, CA"
51,2017,Apr,424784,406789,17995,4.2,"Ventura County, CA"
52,2017,May,424127,407254,16873,4.0,"Ventura County, CA"
53,2017,Jun,423278,404161,19117,4.5,"Ventura County, CA"
54,2017,Jul,422764,402500,20264,4.8,"Ventura County, CA"
55,2017,Aug,419837,399400,20437,4.9,"Ventura County, CA"
56,2017,Sep,423876,405289,18587,4.4,"Ventura County, CA"
57,2017,Oct,423436,405680,17756,4.2,"Ventura County, CA"
58,2017,Nov,424288,406509,17779,4.2,"Ventura County, CA"
59,2017,Dec,422764,405466,17298,4.1,"Ventura County, CA"
60,2018,Jan,420485,401863,18622,4.4,"Ventura County, CA"
61,2018,Feb,425670,408404,17266,4.1,"Ventura County, CA"
62,2018,Mar,425222,409044,16178,3.8,"Ventura County, CA"
63,2018,Apr,423930,409438,14492,3.4,"Ventura County, CA"
64,2018,May,424670,411296,13374,3.1,"Ventura County, CA"
65,2018,Jun,421748,405443,16305,3.9,"Ventura County, CA"
66,2018,Jul,422424,405877,16547,3.9,"Ventura County, CA"
67,2018,Aug,418470,401540,16930,4.0,"Ventura County, CA"
68,2018,Sep,421420,405524,15896,3.8,"Ventura County, CA"
69,2018,Oct,424336,408388,15948,3.8,"Ventura County, CA"
70,2018,Nov,424595,408387,16208,3.8,"Ventura County, CA"
71,2018,Dec,424173,407519,16654,3.9,"Ventura County, CA"
72,2019,Jan,421981,403041,18940,4.5,"Ventura County, CA"
73,2019,Feb,425409,408812,16597,3.9,"Ventura County, CA"
74,2019,Mar,425047,408848,16199,3.8,"Ventura County, CA"
75,2019,Apr,421290,408016,13274,3.2,"Ventura County, CA"
76,2019,May,421789,409054,12735,3.0,"Ventura County, CA"
77,2019,Jun,419551,404441,15110,3.6,"Ventura County, CA"
78,2019,Jul,422512,406281,16231,3.8,"Ventura County, CA"
79,2019,Aug,418890,402707,16183,3.9,"Ventura County, CA"
80,2019,Sep,421126,406867,14259,3.4,"Ventura County, CA"
81,2019,Oct,423131,408499,14632,3.5,"Ventura County, CA"
82,2019,Nov,422917,407702,15215,3.6,"Ventura County, CA"
83,2019,Dec,423753,408825,14928,3.5,"Ventura County, CA"
84,2020,Jan,421534,404849,16685,4.0,"Ventura County, CA"
85,2020,Feb,426955,411312,15643,3.7,"Ventura County, CA"
86,2020,Mar,422436,400004,22432,5.3,"Ventura County, CA"
87,2020,Apr,407729,347581,60148,14.8,"Ventura County, CA"
88,2020,May,402270,346336,55934,13.9,"Ventura County, CA"
89,2020,Jun,414303,365307,48996,11.8,"Ventura County, CA"
90,2020,Jul,409986,363676,46310,11.3,"Ventura County, CA"
91,2020,Aug,405486,367679,37807,9.3,"Ventura County, CA"
92,2020,Sep,405170,369915,35255,8.7,"Ventura County, CA"
93,2020,Oct,406268,375474,30794,7.6,"Ventura County, CA"
94,2020,Nov,404285,374136,30149,7.5,"Ventura County, CA"
95,2020,Dec,404031,373294,30737,7.6,"Ventura County, CA"
96,2021,Jan,400479,368790,31689,7.9,"Ventura County, CA"
97,2021,Feb,405200,375191,30009,7.4,"Ventura County, CA"
98,2021,Mar,407836,379485,28351,7.0,"Ventura County, CA"
99,2021,Apr,405662,378567,27095,6.7,"Ventura County, CA"
100,2021,May,407047,382138,24909,6.1,"Ventura County, CA"
101,2021,Jun,407794,379894,27900,6.8,"Ventura County, CA"
102,2021,Jul,408045,381161,26884,6.6,"Ventura County, CA"
103,2021,Aug,407101,381416,25685,6.3,"Ventura County, CA"
104,2021,Sep,407602,385661,21941,5.4,"Ventura County, CA"
105,2021,Oct,410502,389573,20929,5.1,"Ventura County, CA"
106,2021,Nov,411255,391874,19381,4.7,"Ventura County, CA"
107,2021,Dec,411050,393078,17972,4.4,"Ventura County, CA"
108,2022,Jan,410540,390493,20047,4.9,"Ventura County, CA"
109,2022,Feb,415052,397394,17658,4.3,"Ventura County, CA"
110,2022,Mar,416822,401172,15650,3.8,"Ventura County, CA"
111,2022,Apr,412061,398623,13438,3.3,"Ventura County, CA"
112,2022,May,414031,401782,12249,3.0,"Ventura County, CA"
113,2022,Jun,411945,397571,14374,3.5,"Ventura County, CA"
114,2022,Jul,409993,395324,14669,3.6,"Ventura County, CA"
115,2022,Aug,411362,396024,15338,3.7,"Ventura County, CA"
116,2022,Sep,413850,399698,14152,3.4,"Ventura County, CA"
117,2022,Oct,416335,401397,14938,3.6,"Ventura County, CA"
118,2022,Nov,415270,399646,15624,3.8,"Ventura County, CA"
119,2022,Dec,416426,401924,14502,3.5,"Ventura County, CA"
120,2023,Jan,413374,395993,17381,4.2,"Ventura County, CA"
121,2023,Feb,418229,400965,17264,4.1,"Ventura County, CA"
122,2023,Mar,420234,403207,17027,4.1,"Ventura County, CA"
123,2023,Apr,417060,402178,14882,3.6,"Ventura County, CA"
124,2023,May,415848,400391,15457,3.7,"Ventura County, CA"
125,2023,Jun,413070,395667,17403,4.2,"Ventura County, CA"
126,2023,Jul,414290,396837,17453,4.2,"Ventura County, CA"
127,2023,Aug,412945,393739,19206,4.7,"Ventura County, CA"
128,2023,Sep,418372,399963,18409,4.4,"Ventura County, CA"
129,2023,Oct,418710,399741,18969,4.5,"Ventura County, CA"
0,2013,Jan,5785,5183,602,10.4,"Dixie County, FL"
1,2013,Feb,5735,5194,541,9.4,"Dixie County, FL"
2,2013,Mar,5701,5190,511,9.0,"Dixie County, FL"
3,2013,Apr,5805,5317,488,8.4,"Dixie County, FL"
4,2013,May,5912,5398,514,8.7,"Dixie County, FL"
5,2013,Jun,5832,5273,559,9.6,"Dixie County, FL"
6,2013,Jul,5841,5300,541,9.3,"Dixie County, FL"
7,2013,Aug,5897,5374,523,8.9,"Dixie County, FL"
8,2013,Sep,6075,5574,501,8.2,"Dixie County, FL"
9,2013,Oct,5879,5381,498,8.5,"Dixie County, FL"
10,2013,Nov,5779,5303,476,8.2,"Dixie County, FL"
11,2013,Dec,5765,5308,457,7.9,"Dixie County, FL"
12,2014,Jan,5627,5143,484,8.6,"Dixie County, FL"
13,2014,Feb,5569,5115,454,8.2,"Dixie County, FL"
14,2014,Mar,5554,5097,457,8.2,"Dixie County, FL"
15,2014,Apr,5497,5081,416,7.6,"Dixie County, FL"
16,2014,May,5589,5163,426,7.6,"Dixie County, FL"
17,2014,Jun,5483,5049,434,7.9,"Dixie County, FL"
18,2014,Jul,5493,5053,440,8.0,"Dixie County, FL"
19,2014,Aug,5536,5101,435,7.9,"Dixie County, FL"
20,2014,Sep,5661,5270,391,6.9,"Dixie County, FL"
21,2014,Oct,5602,5219,383,6.8,"Dixie County, FL"
22,2014,Nov,5507,5119,388,7.0,"Dixie County, FL"
23,2014,Dec,5468,5106,362,6.6,"Dixie County, FL"
24,2015,Jan,5518,5123,395,7.2,"Dixie County, FL"
25,2015,Feb,5521,5157,364,6.6,"Dixie County, FL"
26,2015,Mar,5540,5193,347,6.3,"Dixie County, FL"
27,2015,Apr,5660,5325,335,5.9,"Dixie County, FL"
28,2015,May,5752,5389,363,6.3,"Dixie County, FL"
29,2015,Jun,5561,5174,387,7.0,"Dixie County, FL"
30,2015,Jul,5518,5128,390,7.1,"Dixie County, FL"
31,2015,Aug,5541,5178,363,6.6,"Dixie County, FL"
32,2015,Sep,5785,5453,332,5.7,"Dixie County, FL"
33,2015,Oct,5713,5385,328,5.7,"Dixie County, FL"
34,2015,Nov,5587,5271,316,5.7,"Dixie County, FL"
35,2015,Dec,5608,5298,310,5.5,"Dixie County, FL"
36,2016,Jan,5639,5311,328,5.8,"Dixie County, FL"
37,2016,Feb,5620,5317,303,5.4,"Dixie County, FL"
38,2016,Mar,5669,5364,305,5.4,"Dixie County, FL"
39,2016,Apr,5696,5399,297,5.2,"Dixie County, FL"
40,2016,May,5712,5425,287,5.0,"Dixie County, FL"
41,2016,Jun,5583,5261,322,5.8,"Dixie County, FL"
42,2016,Jul,5531,5206,325,5.9,"Dixie County, FL"
43,2016,Aug,5627,5319,308,5.5,"Dixie County, FL"
44,2016,Sep,5827,5506,321,5.5,"Dixie County, FL"
45,2016,Oct,5779,5459,320,5.5,"Dixie County, FL"
46,2016,Nov,5660,5345,315,5.6,"Dixie County, FL"
47,2016,Dec,5681,5378,303,5.3,"Dixie County, FL"
48,2017,Jan,5701,5373,328,5.8,"Dixie County, FL"
49,2017,Feb,5773,5473,300,5.2,"Dixie County, FL"
50,2017,Mar,5786,5509,277,4.8,"Dixie County, FL"
51,2017,Apr,5774,5518,256,4.4,"Dixie County, FL"
52,2017,May,5791,5544,247,4.3,"Dixie County, FL"
53,2017,Jun,5556,5278,278,5.0,"Dixie County, FL"
54,2017,Jul,5455,5170,285,5.2,"Dixie County, FL"
55,2017,Aug,5655,5365,290,5.1,"Dixie County, FL"
56,2017,Sep,5870,5610,260,4.4,"Dixie County, FL"
57,2017,Oct,5784,5515,269,4.7,"Dixie County, FL"
58,2017,Nov,5654,5390,264,4.7,"Dixie County, FL"
59,2017,Dec,5650,5396,254,4.5,"Dixie County, FL"
60,2018,Jan,5693,5409,284,5.0,"Dixie County, FL"
61,2018,Feb,5722,5463,259,4.5,"Dixie County, FL"
62,2018,Mar,5706,5463,243,4.3,"Dixie County, FL"
63,2018,Apr,5703,5476,227,4.0,"Dixie County, FL"
64,2018,May,5798,5569,229,3.9,"Dixie County, FL"
65,2018,Jun,5582,5305,277,5.0,"Dixie County, FL"
66,2018,Jul,5509,5229,280,5.1,"Dixie County, FL"
67,2018,Aug,5703,5455,248,4.3,"Dixie County, FL"
68,2018,Sep,5996,5769,227,3.8,"Dixie County, FL"
69,2018,Oct,5951,5720,231,3.9,"Dixie County, FL"
70,2018,Nov,5777,5554,223,3.9,"Dixie County, FL"
71,2018,Dec,5757,5530,227,3.9,"Dixie County, FL"
72,2019,Jan,5819,5560,259,4.5,"Dixie County, FL"
73,2019,Feb,5820,5600,220,3.8,"Dixie County, FL"
74,2019,Mar,5829,5616,213,3.7,"Dixie County, FL"
75,2019,Apr,5778,5582,196,3.4,"Dixie County, FL"
76,2019,May,5826,5627,199,3.4,"Dixie County, FL"
77,2019,Jun,5643,5399,244,4.3,"Dixie County, FL"
78,2019,Jul,5564,5307,257,4.6,"Dixie County, FL"
79,2019,Aug,5785,5528,257,4.4,"Dixie County, FL"
80,2019,Sep,6091,5877,214,3.5,"Dixie County, FL"
81,2019,Oct,5971,5758,213,3.6,"Dixie County, FL"
82,2019,Nov,5840,5635,205,3.5,"Dixie County, FL"
83,2019,Dec,5847,5636,211,3.6,"Dixie County, FL"
84,2020,Jan,5926,5694,232,3.9,"Dixie County, FL"
85,2020,Feb,5913,5711,202,3.4,"Dixie County, FL"
86,2020,Mar,5799,5521,278,4.8,"Dixie County, FL"
87,2020,Apr,5364,5010,354,6.6,"Dixie County, FL"
88,2020,May,5791,5348,443,7.6,"Dixie County, FL"
89,2020,Jun,5604,5183,421,7.5,"Dixie County, FL"
90,2020,Jul,5712,5204,508,8.9,"Dixie County, FL"
91,2020,Aug,5813,5459,354,6.1,"Dixie County, FL"
92,2020,Sep,6182,5823,359,5.8,"Dixie County, FL"
93,2020,Oct,6169,5863,306,5.0,"Dixie County, FL"
94,2020,Nov,5997,5681,316,5.3,"Dixie County, FL"
95,2020,Dec,5982,5670,312,5.2,"Dixie County, FL"
96,2021,Jan,5848,5522,326,5.6,"Dixie County, FL"
97,2021,Feb,5939,5640,299,5.0,"Dixie County, FL"
98,2021,Mar,5887,5604,283,4.8,"Dixie County, FL"
99,2021,Apr,5870,5617,253,4.3,"Dixie County, FL"
100,2021,May,5909,5671,238,4.0,"Dixie County, FL"
101,2021,Jun,5859,5564,295,5.0,"Dixie County, FL"
102,2021,Jul,5805,5519,286,4.9,"Dixie County, FL"
103,2021,Aug,5816,5531,285,4.9,"Dixie County, FL"
104,2021,Sep,5894,5652,242,4.1,"Dixie County, FL"
105,2021,Oct,5823,5580,243,4.2,"Dixie County, FL"
106,2021,Nov,5729,5502,227,4.0,"Dixie County, FL"
107,2021,Dec,5722,5538,184,3.2,"Dixie County, FL"
108,2022,Jan,5736,5496,240,4.2,"Dixie County, FL"
109,2022,Feb,5764,5544,220,3.8,"Dixie County, FL"
110,2022,Mar,5840,5635,205,3.5,"Dixie County, FL"
111,2022,Apr,5842,5667,175,3.0,"Dixie County, FL"
112,2022,May,5931,5750,181,3.1,"Dixie County, FL"
113,2022,Jun,5813,5607,206,3.5,"Dixie County, FL"
114,2022,Jul,5782,5594,188,3.3,"Dixie County, FL"
115,2022,Aug,5922,5739,183,3.1,"Dixie County, FL"
116,2022,Sep,6006,5824,182,3.0,"Dixie County, FL"
117,2022,Oct,5935,5759,176,3.0,"Dixie County, FL"
118,2022,Nov,5815,5638,177,3.0,"Dixie County, FL"
119,2022,Dec,5840,5681,159,2.7,"Dixie County, FL"
120,2023,Jan,5858,5670,188,3.2,"Dixie County, FL"
121,2023,Feb,5898,5716,182,3.1,"Dixie County, FL"
122,2023,Mar,5926,5744,182,3.1,"Dixie County, FL"
123,2023,Apr,5895,5731,164,2.8,"Dixie County, FL"
124,2023,May,5976,5787,189,3.2,"Dixie County, FL"
125,2023,Jun,5823,5609,214,3.7,"Dixie County, FL"
126,2023,Jul,5836,5612,224,3.8,"Dixie County, FL"
127,2023,Aug,5990,5754,236,3.9,"Dixie County, FL"
128,2023,Sep,6180,5914,266,4.3,"Dixie County, FL"
129,2023,Oct,6110,5859,251,4.1,"Dixie County, FL"
